Open,Last update,Platform,Symbol,Timeframe,Account balance at open,Size,Expected close,Expiry,Close,Status,Side,Opening price,Closing price,Take profit,Stop loss,Leverage,TP price %,SL price %,Expected profit,Risk %,R/R ratio,PnL
04/11/2018 00:00:00,15/06/2023 18:52:25,Upscale-Upscale-Gemini_BTCUSD_1h_17_12_17_to_10_03_23.csv,BTC_USD,WEEK,100000.0,13.923,25/11/2018 00:00:00,25/11/2018 00:00:00,11/11/2018 00:00:00,TAKE_PROFIT_HIT,SHORT,6350.0,5919.04,5919.04,6493.65,0.884,7.28,2.21,6000.26,2,3.0,6000.26
14/03/2021 03:00:00,15/06/2023 18:52:25,Upscale-Upscale-Gemini_BTCUSD_1h_17_12_17_to_10_03_23.csv,BTC_USD,WEEK,106000.26,0.624,11/04/2021 03:00:00,04/04/2021 03:00:00,21/03/2021 03:00:00,STOP_LOSS_HIT,LONG,57642.0,54242.59,67840.24,54242.59,0.339,15.03,6.27,6363.7,2,3.0,-2121.23
24/04/2022 03:00:00,15/06/2023 18:52:25,Upscale-Upscale-Gemini_BTCUSD_1h_17_12_17_to_10_03_23.csv,BTC_USD,WEEK,103879.03,4.57,22/05/2022 03:00:00,15/05/2022 03:00:00,01/05/2022 03:00:00,STOP_LOSS_HIT,SHORT,37827.0,38281.59,36463.23,38281.59,1.664,3.74,1.19,6232.43,2,3.0,-2077.48
28/10/2018 00:00:00,15/06/2023 18:52:25,Upscale-Upscale-Gemini_BTCUSD_1h_17_12_17_to_10_03_23.csv,BTC_USD,WEEK,101801.55,12.256,25/11/2018 00:00:00,18/11/2018 00:00:00,04/11/2018 00:00:00,STOP_LOSS_HIT,SHORT,6332.0,6498.12,5833.65,6498.12,0.762,8.54,2.56,6107.78,2,3.0,-2035.97
03/01/2021 03:00:00,15/06/2023 18:52:25,Upscale-Upscale-Gemini_BTCUSD_1h_17_12_17_to_10_03_23.csv,BTC_USD,WEEK,99765.58,0.844,31/01/2021 03:00:00,24/01/2021 03:00:00,10/01/2021 03:00:00,STOP_LOSS_HIT,LONG,41092.0,38727.97,48184.1,38727.97,0.348,14.72,6.1,5985.73,2,3.0,-1995.24
24/07/2022 03:00:00,15/06/2023 18:52:25,Upscale-Upscale-Gemini_BTCUSD_1h_17_12_17_to_10_03_23.csv,BTC_USD,WEEK,97770.34,12.294,14/08/2022 03:00:00,14/08/2022 03:00:00,31/07/2022 03:00:00,STOP_LOSS_HIT,LONG,23806.0,23646.95,24283.15,23646.95,2.993,1.96,0.67,5866.08,2,3.0,-1955.36
22/01/2023 03:00:00,15/06/2023 18:52:25,Upscale-Upscale-Gemini_BTCUSD_1h_17_12_17_to_10_03_23.csv,BTC_USD,WEEK,95814.98,1.6,19/02/2023 03:00:00,12/02/2023 03:00:00,05/02/2023 03:00:00,STOP_LOSS_HIT,LONG,23148.0,21950.34,26741.0,21950.34,0.387,13.44,5.46,5748.8,2,3.0,-1916.26
03/02/2019 00:00:00,15/06/2023 18:52:25,Upscale-Upscale-Gemini_BTCUSD_1h_17_12_17_to_10_03_23.csv,BTC_USD,WEEK,93898.72,59.922,24/02/2019 00:00:00,24/02/2019 00:00:00,10/02/2019 00:00:00,STOP_LOSS_HIT,LONG,3624.0,3592.66,3718.01,3592.66,2.313,2.53,0.87,5633.27,2,3.0,-1877.96
10/06/2018 00:00:00,15/06/2023 18:52:25,Upscale-Upscale-Gemini_BTCUSD_1h_17_12_17_to_10_03_23.csv,BTC_USD,WEEK,92020.76,38.984,24/06/2018 00:00:00,01/07/2018 00:00:00,17/06/2018 00:00:00,STOP_LOSS_HIT,SHORT,6487.0,6534.21,6345.36,6534.21,2.748,2.23,0.72,5521.69,2,3.0,-1840.43
15/04/2018 00:00:00,15/06/2023 18:52:25,Upscale-Upscale-Gemini_BTCUSD_1h_17_12_17_to_10_03_23.csv,BTC_USD,WEEK,90180.33,16.382,06/05/2018 00:00:00,06/05/2018 00:00:00,22/04/2018 00:00:00,STOP_LOSS_HIT,LONG,8920.0,8809.9,9250.3,8809.9,1.62,3.57,1.25,5410.97,2,3.0,-1803.66
03/05/2020 03:00:00,15/06/2023 18:52:25,Upscale-Upscale-Gemini_BTCUSD_1h_17_12_17_to_10_03_23.csv,BTC_USD,WEEK,88376.67,3.329,31/05/2020 03:00:00,24/05/2020 03:00:00,24/05/2020 03:00:00,EXPIRED,LONG,8672.0,9642.0,10264.91,8141.03,0.327,15.52,6.52,5302.8,2,3.0,3229.13
14/07/2019 00:00:00,15/06/2023 18:52:25,Upscale-Upscale-Gemini_BTCUSD_1h_17_12_17_to_10_03_23.csv,BTC_USD,WEEK,91605.8,6.894,11/08/2019 00:00:00,04/08/2019 00:00:00,21/07/2019 00:00:00,STOP_LOSS_HIT,LONG,10753.0,10487.25,11550.26,10487.25,0.809,6.9,2.53,5496.31,2,3.0,-1832.08
08/09/2019 00:00:00,15/06/2023 18:52:25,Upscale-Upscale-Gemini_BTCUSD_1h_17_12_17_to_10_03_23.csv,BTC_USD,WEEK,89773.72,13.357,06/10/2019 00:00:00,29/09/2019 00:00:00,15/09/2019 00:00:00,TAKE_PROFIT_HIT,SHORT,10360.0,9956.75,9956.75,10494.42,1.541,4.05,1.28,5386.21,2,3.0,5386.21
17/07/2022 03:00:00,15/06/2023 18:52:25,Upscale-Upscale-Gemini_BTCUSD_1h_17_12_17_to_10_03_23.csv,BTC_USD,WEEK,95159.93,12.061,14/08/2022 03:00:00,07/08/2022 03:00:00,24/07/2022 03:00:00,STOP_LOSS_HIT,LONG,22479.0,22321.2,22952.4,22321.2,2.849,2.06,0.71,5709.68,2,3.0,-1903.23
01/11/2020 03:00:00,15/06/2023 18:52:25,Upscale-Upscale-Gemini_BTCUSD_1h_17_12_17_to_10_03_23.csv,BTC_USD,WEEK,93256.7,2.261,29/11/2020 03:00:00,22/11/2020 03:00:00,15/11/2020 03:00:00,TAKE_PROFIT_HIT,LONG,15036.0,17510.32,17510.32,14211.23,0.365,14.13,5.8,5594.44,2,3.0,5594.44
07/08/2022 03:00:00,15/06/2023 18:52:25,Upscale-Upscale-Gemini_BTCUSD_1h_17_12_17_to_10_03_23.csv,BTC_USD,WEEK,98851.14,4.335,04/09/2022 03:00:00,28/08/2022 03:00:00,14/08/2022 03:00:00,STOP_LOSS_HIT,LONG,24620.0,24163.98,25988.07,24163.98,1.08,5.26,1.89,5930.58,2,3.0,-1976.85
07/08/2022 03:00:00,15/06/2023 18:52:25,Upscale-Upscale-Gemini_BTCUSD_1h_17_12_17_to_10_03_23.csv,BTC_USD,WEEK,96874.29,4.249,04/09/2022 03:00:00,28/08/2022 03:00:00,14/08/2022 03:00:00,STOP_LOSS_HIT,LONG,24620.0,24163.98,25988.07,24163.98,1.08,5.26,1.89,5812.93,2,3.0,-1937.63
07/06/2020 03:00:00,15/06/2023 18:52:25,Upscale-Upscale-Gemini_BTCUSD_1h_17_12_17_to_10_03_23.csv,BTC_USD,WEEK,94936.66,23.631,28/06/2020 03:00:00,28/06/2020 03:00:00,14/06/2020 03:00:00,STOP_LOSS_HIT,SHORT,9446.0,9526.35,9204.95,9526.35,2.351,2.62,0.84,5696.25,2,3.0,-1898.75
26/07/2020 03:00:00,15/06/2023 18:52:25,Upscale-Upscale-Gemini_BTCUSD_1h_17_12_17_to_10_03_23.csv,BTC_USD,WEEK,93037.91,7.273,02/08/2020 03:00:00,16/08/2020 03:00:00,02/08/2020 03:00:00,STOP_LOSS_HIT,LONG,11938.0,11682.16,12705.53,11682.16,0.933,6.04,2.19,5582.25,2,3.0,-1860.72
27/12/2020 03:00:00,15/06/2023 18:52:25,Upscale-Upscale-Gemini_BTCUSD_1h_17_12_17_to_10_03_23.csv,BTC_USD,WEEK,91177.19,0.946,24/01/2021 03:00:00,17/01/2021 03:00:00,03/01/2021 03:00:00,STOP_LOSS_HIT,LONG,32761.0,30834.05,38541.85,30834.05,0.34,15.0,6.25,5468.68,2,3.0,-1822.89
09/06/2019 00:00:00,15/06/2023 18:52:25,Upscale-Upscale-Gemini_BTCUSD_1h_17_12_17_to_10_03_23.csv,BTC_USD,WEEK,89354.3,3.162,30/06/2019 00:00:00,30/06/2019 00:00:00,16/06/2019 00:00:00,TAKE_PROFIT_HIT,LONG,8853.0,10548.29,10548.29,8287.9,0.313,16.07,6.82,5360.51,2,3.0,5360.51
19/09/2021 03:00:00,15/06/2023 18:52:25,Upscale-Upscale-Gemini_BTCUSD_1h_17_12_17_to_10_03_23.csv,BTC_USD,WEEK,94714.81,1.799,17/10/2021 03:00:00,10/10/2021 03:00:00,26/09/2021 03:00:00,STOP_LOSS_HIT,LONG,42091.0,41038.3,45249.1,41038.3,0.799,6.98,2.57,5681.42,2,3.0,-1893.81
17/05/2020 03:00:00,15/06/2023 18:52:25,Upscale-Upscale-Gemini_BTCUSD_1h_17_12_17_to_10_03_23.csv,BTC_USD,WEEK,92821.0,3.726,14/06/2020 03:00:00,07/06/2020 03:00:00,24/05/2020 03:00:00,STOP_LOSS_HIT,LONG,9209.0,8710.78,10703.66,8710.78,0.37,13.96,5.72,5569.1,2,3.0,-1856.37
03/04/2022 03:00:00,15/06/2023 18:52:25,Upscale-Upscale-Gemini_BTCUSD_1h_17_12_17_to_10_03_23.csv,BTC_USD,WEEK,90964.63,0.924,01/05/2022 03:00:00,24/04/2022 03:00:00,10/04/2022 03:00:00,STOP_LOSS_HIT,LONG,42861.0,40891.62,48769.14,40891.62,0.435,12.11,4.82,5459.12,2,3.0,-1819.71
16/05/2021 03:00:00,15/06/2023 18:52:25,Upscale-Upscale-Gemini_BTCUSD_1h_17_12_17_to_10_03_23.csv,BTC_USD,WEEK,89144.92,2.984,30/05/2021 03:00:00,06/06/2021 03:00:00,23/05/2021 03:00:00,STOP_LOSS_HIT,SHORT,37492.0,38089.43,35699.72,38089.43,1.255,5.02,1.57,5348.16,2,3.0,-1782.73
14/06/2020 03:00:00,15/06/2023 18:52:25,Upscale-Upscale-Gemini_BTCUSD_1h_17_12_17_to_10_03_23.csv,BTC_USD,WEEK,87362.19,25.908,12/07/2020 03:00:00,05/07/2020 03:00:00,21/06/2020 03:00:00,STOP_LOSS_HIT,LONG,9367.0,9299.56,9569.33,9299.56,2.778,2.11,0.73,5241.97,2,3.0,-1747.24
10/10/2021 03:00:00,15/06/2023 18:52:25,Upscale-Upscale-Gemini_BTCUSD_1h_17_12_17_to_10_03_23.csv,BTC_USD,WEEK,85614.95,0.51,07/11/2021 03:00:00,31/10/2021 03:00:00,24/10/2021 03:00:00,STOP_LOSS_HIT,LONG,61102.0,57747.23,71166.31,57747.23,0.364,14.14,5.81,5132.8,2,3.0,-1710.93
02/05/2021 03:00:00,15/06/2023 18:52:25,Upscale-Upscale-Gemini_BTCUSD_1h_17_12_17_to_10_03_23.csv,BTC_USD,WEEK,83904.02,0.831,30/05/2021 03:00:00,23/05/2021 03:00:00,09/05/2021 03:00:00,TAKE_PROFIT_HIT,SHORT,58729.0,52670.05,52670.05,60748.65,0.582,11.5,3.32,5034.99,2,3.0,5034.99
16/02/2020 03:00:00,15/06/2023 18:52:25,Upscale-Upscale-Gemini_BTCUSD_1h_17_12_17_to_10_03_23.csv,BTC_USD,WEEK,88939.01,11.88,08/03/2020 03:00:00,08/03/2020 03:00:00,23/02/2020 03:00:00,STOP_LOSS_HIT,LONG,9701.0,9551.27,10150.18,9551.27,1.296,4.43,1.57,5336.26,2,3.0,-1778.79
14/04/2019 00:00:00,15/06/2023 18:52:25,Upscale-Upscale-Gemini_BTCUSD_1h_17_12_17_to_10_03_23.csv,BTC_USD,WEEK,87160.22,7.074,12/05/2019 00:00:00,05/05/2019 00:00:00,21/04/2019 00:00:00,STOP_LOSS_HIT,LONG,5321.0,5074.56,6060.32,5074.56,0.432,12.2,4.86,5229.95,2,3.0,-1743.32
19/07/2020 03:00:00,15/06/2023 18:52:25,Upscale-Upscale-Gemini_BTCUSD_1h_17_12_17_to_10_03_23.csv,BTC_USD,WEEK,85416.9,9.995,02/08/2020 03:00:00,09/08/2020 03:00:00,26/07/2020 03:00:00,TAKE_PROFIT_HIT,LONG,9685.0,10197.76,10197.76,9514.08,1.133,5.03,1.8,5125.04,2,3.0,5125.04
13/03/2022 03:00:00,15/06/2023 18:52:25,Upscale-Upscale-Gemini_BTCUSD_1h_17_12_17_to_10_03_23.csv,BTC_USD,WEEK,90541.94,3.658,03/04/2022 03:00:00,03/04/2022 03:00:00,20/03/2022 03:00:00,STOP_LOSS_HIT,LONG,41851.0,41356.03,43335.92,41356.03,1.691,3.43,1.2,5431.84,2,3.0,-1810.6
21/10/2018 00:00:00,15/06/2023 18:52:25,Upscale-Upscale-Gemini_BTCUSD_1h_17_12_17_to_10_03_23.csv,BTC_USD,WEEK,88731.34,27.837,18/11/2018 00:00:00,11/11/2018 00:00:00,28/10/2018 00:00:00,TAKE_PROFIT_HIT,SHORT,6410.0,6218.74,6218.74,6473.75,2.011,3.08,0.98,5324.1,2,3.0,5324.1
07/04/2019 00:00:00,15/06/2023 18:52:25,Upscale-Upscale-Gemini_BTCUSD_1h_17_12_17_to_10_03_23.csv,BTC_USD,WEEK,94055.44,6.902,05/05/2019 00:00:00,28/04/2019 00:00:00,28/04/2019 00:00:00,EXPIRED,LONG,5069.0,5770.0,5886.59,4796.47,0.372,13.89,5.68,5643.01,2,3.0,4838.3
05/05/2019 00:00:00,15/06/2023 18:52:25,Upscale-Upscale-Gemini_BTCUSD_1h_17_12_17_to_10_03_23.csv,BTC_USD,WEEK,98893.74,3.5,02/06/2019 00:00:00,26/05/2019 00:00:00,12/05/2019 00:00:00,STOP_LOSS_HIT,LONG,7228.0,6662.94,8923.19,6662.94,0.256,19.0,8.48,5933.17,2,3.0,-1977.71
20/12/2020 03:00:00,15/06/2023 18:52:25,Upscale-Upscale-Gemini_BTCUSD_1h_17_12_17_to_10_03_23.csv,BTC_USD,WEEK,96916.03,0.985,17/01/2021 03:00:00,10/01/2021 03:00:00,27/12/2020 03:00:00,TAKE_PROFIT_HIT,LONG,26571.0,32477.3,32477.3,24602.24,0.27,18.19,8.0,5817.71,2,3.0,5817.71
10/03/2019 00:00:00,15/06/2023 18:52:25,Upscale-Upscale-Gemini_BTCUSD_1h_17_12_17_to_10_03_23.csv,BTC_USD,WEEK,102733.74,11.339,07/04/2019 00:00:00,31/03/2019 00:00:00,31/03/2019 00:00:00,TAKE_PROFIT_HIT,LONG,3990.0,4533.59,4533.59,3808.8,0.44,11.99,4.76,6163.77,2,3.0,6163.77
13/05/2018 00:00:00,15/06/2023 18:52:25,Upscale-Upscale-Gemini_BTCUSD_1h_17_12_17_to_10_03_23.csv,BTC_USD,WEEK,108897.51,14.806,27/05/2018 00:00:00,03/06/2018 00:00:00,20/05/2018 00:00:00,STOP_LOSS_HIT,SHORT,8240.0,8387.1,7798.7,8387.1,1.12,5.66,1.75,6533.89,2,3.0,-2177.96
20/03/2022 03:00:00,15/06/2023 18:52:25,Upscale-Upscale-Gemini_BTCUSD_1h_17_12_17_to_10_03_23.csv,BTC_USD,WEEK,106719.55,5.75,03/04/2022 03:00:00,10/04/2022 03:00:00,27/03/2022 03:00:00,STOP_LOSS_HIT,LONG,44715.0,44343.78,45828.66,44343.78,2.409,2.43,0.84,6403.55,2,3.0,-2134.52
19/05/2019 00:00:00,15/06/2023 18:52:25,Upscale-Upscale-Gemini_BTCUSD_1h_17_12_17_to_10_03_23.csv,BTC_USD,WEEK,104585.03,7.214,16/06/2019 00:00:00,09/06/2019 00:00:00,26/05/2019 00:00:00,TAKE_PROFIT_HIT,LONG,8075.0,8944.91,8944.91,7785.03,0.557,9.73,3.72,6275.53,2,3.0,6275.53
27/12/2020 03:00:00,15/06/2023 18:52:25,Upscale-Upscale-Gemini_BTCUSD_1h_17_12_17_to_10_03_23.csv,BTC_USD,WEEK,110860.56,1.151,24/01/2021 03:00:00,17/01/2021 03:00:00,03/01/2021 03:00:00,STOP_LOSS_HIT,LONG,32761.0,30834.05,38541.85,30834.05,0.34,15.0,6.25,6653.76,2,3.0,-2217.92
09/10/2022 03:00:00,15/06/2023 18:52:25,Upscale-Upscale-Gemini_BTCUSD_1h_17_12_17_to_10_03_23.csv,BTC_USD,WEEK,108642.64,16.304,06/11/2022 03:00:00,30/10/2022 03:00:00,16/10/2022 03:00:00,STOP_LOSS_HIT,LONG,19116.0,18982.73,19515.82,18982.73,2.869,2.05,0.7,6518.67,2,3.0,-2172.83
17/03/2019 00:00:00,15/06/2023 18:52:25,Upscale-Upscale-Gemini_BTCUSD_1h_17_12_17_to_10_03_23.csv,BTC_USD,WEEK,106469.81,12.248,14/04/2019 00:00:00,07/04/2019 00:00:00,31/03/2019 00:00:00,TAKE_PROFIT_HIT,LONG,3982.0,4503.54,4503.54,3808.15,0.458,11.58,4.57,6387.82,2,3.0,6387.82
22/07/2018 00:00:00,15/06/2023 18:52:25,Upscale-Upscale-Gemini_BTCUSD_1h_17_12_17_to_10_03_23.csv,BTC_USD,WEEK,112857.63,6.274,19/08/2018 00:00:00,12/08/2018 00:00:00,29/07/2018 00:00:00,STOP_LOSS_HIT,LONG,8235.0,7875.23,9314.3,7875.23,0.458,11.59,4.57,6771.53,2,3.0,-2257.2
17/11/2019 01:00:00,15/06/2023 18:52:25,Upscale-Upscale-Gemini_BTCUSD_1h_17_12_17_to_10_03_23.csv,BTC_USD,WEEK,110600.43,17.671,15/12/2019 01:00:00,08/12/2019 02:00:00,24/11/2019 02:00:00,STOP_LOSS_HIT,LONG,7269.0,7143.82,7644.55,7143.82,1.161,4.91,1.75,6636.34,2,3.0,-2212.06
10/11/2019 00:00:00,15/06/2023 18:52:25,Upscale-Upscale-Gemini_BTCUSD_1h_17_12_17_to_10_03_23.csv,BTC_USD,WEEK,108388.37,14.951,24/11/2019 00:00:00,01/12/2019 02:00:00,17/11/2019 01:00:00,TAKE_PROFIT_HIT,SHORT,8494.0,8059.04,8059.04,8638.99,1.172,5.4,1.68,6503.09,2,3.0,6503.09
09/10/2022 03:00:00,15/06/2023 18:52:25,Upscale-Upscale-Gemini_BTCUSD_1h_17_12_17_to_10_03_23.csv,BTC_USD,WEEK,114891.46,17.242,06/11/2022 03:00:00,30/10/2022 03:00:00,16/10/2022 03:00:00,STOP_LOSS_HIT,LONG,19116.0,18982.73,19515.82,18982.73,2.869,2.05,0.7,6893.7,2,3.0,-2297.84
01/08/2021 03:00:00,15/06/2023 18:52:25,Upscale-Upscale-Gemini_BTCUSD_1h_17_12_17_to_10_03_23.csv,BTC_USD,WEEK,112593.62,0.888,29/08/2021 03:00:00,22/08/2021 03:00:00,22/08/2021 03:00:00,EXPIRED,LONG,43978.0,48614.0,51588.28,41441.24,0.347,14.75,6.12,6757.93,2,3.0,4116.77
12/05/2019 00:00:00,15/06/2023 18:52:25,Upscale-Upscale-Gemini_BTCUSD_1h_17_12_17_to_10_03_23.csv,BTC_USD,WEEK,116710.39,5.761,09/06/2019 00:00:00,02/06/2019 00:00:00,26/05/2019 00:00:00,TAKE_PROFIT_HIT,LONG,7263.0,8478.57,8478.57,6857.81,0.359,14.34,5.91,7002.9,2,3.0,7002.9
08/09/2019 00:00:00,15/06/2023 18:52:25,Upscale-Upscale-Gemini_BTCUSD_1h_17_12_17_to_10_03_23.csv,BTC_USD,WEEK,123713.29,18.407,06/10/2019 00:00:00,29/09/2019 00:00:00,15/09/2019 00:00:00,TAKE_PROFIT_HIT,SHORT,10360.0,9956.75,9956.75,10494.42,1.541,4.05,1.28,7422.62,2,3.0,7422.62
30/08/2020 03:00:00,15/06/2023 18:52:25,Upscale-Upscale-Gemini_BTCUSD_1h_17_12_17_to_10_03_23.csv,BTC_USD,WEEK,131135.91,31.691,06/09/2020 03:00:00,20/09/2020 03:00:00,06/09/2020 03:00:00,STOP_LOSS_HIT,SHORT,10152.0,10234.76,9903.73,10234.76,2.453,2.51,0.81,7867.92,2,3.0,-2622.75
27/01/2019 00:00:00,15/06/2023 18:52:25,Upscale-Upscale-Gemini_BTCUSD_1h_17_12_17_to_10_03_23.csv,BTC_USD,WEEK,128513.16,90.854,24/02/2019 00:00:00,17/02/2019 00:00:00,03/02/2019 00:00:00,STOP_LOSS_HIT,LONG,3469.0,3440.71,3553.87,3440.71,2.452,2.39,0.82,7710.78,2,3.0,-2570.26
27/12/2020 03:00:00,15/06/2023 18:52:25,Upscale-Upscale-Gemini_BTCUSD_1h_17_12_17_to_10_03_23.csv,BTC_USD,WEEK,125942.9,1.307,24/01/2021 03:00:00,17/01/2021 03:00:00,03/01/2021 03:00:00,STOP_LOSS_HIT,LONG,32761.0,30834.05,38541.85,30834.05,0.34,15.0,6.25,7555.57,2,3.0,-2518.52
30/08/2020 03:00:00,15/06/2023 18:52:25,Upscale-Upscale-Gemini_BTCUSD_1h_17_12_17_to_10_03_23.csv,BTC_USD,WEEK,123424.38,29.827,06/09/2020 03:00:00,20/09/2020 03:00:00,06/09/2020 03:00:00,STOP_LOSS_HIT,SHORT,10152.0,10234.76,9903.73,10234.76,2.453,2.51,0.81,7405.15,2,3.0,-2468.48
29/03/2020 03:00:00,15/06/2023 18:52:25,Upscale-Upscale-Gemini_BTCUSD_1h_17_12_17_to_10_03_23.csv,BTC_USD,WEEK,120955.9,39.502,26/04/2020 03:00:00,19/04/2020 03:00:00,05/04/2020 03:00:00,STOP_LOSS_HIT,LONG,6856.0,6794.76,7039.72,6794.76,2.239,2.61,0.9,7257.31,2,3.0,-2419.1
07/03/2021 03:00:00,15/06/2023 18:52:25,Upscale-Upscale-Gemini_BTCUSD_1h_17_12_17_to_10_03_23.csv,BTC_USD,WEEK,118536.8,0.555,04/04/2021 03:00:00,28/03/2021 03:00:00,14/03/2021 03:00:00,STOP_LOSS_HIT,LONG,61063.0,56787.98,73888.08,56787.98,0.286,17.36,7.53,7117.92,2,3.0,-2372.64
21/07/2019 00:00:00,15/06/2023 18:52:25,Upscale-Upscale-Gemini_BTCUSD_1h_17_12_17_to_10_03_23.csv,BTC_USD,WEEK,116164.16,11.799,18/08/2019 00:00:00,11/08/2019 00:00:00,28/07/2019 00:00:00,STOP_LOSS_HIT,SHORT,9478.0,9674.91,8887.26,9674.91,0.963,6.65,2.04,6970.14,2,3.0,-2323.34
30/01/2022 03:00:00,15/06/2023 18:52:25,Upscale-Upscale-Gemini_BTCUSD_1h_17_12_17_to_10_03_23.csv,BTC_USD,WEEK,113840.82,9.271,13/02/2022 03:00:00,20/02/2022 03:00:00,06/02/2022 03:00:00,STOP_LOSS_HIT,LONG,41550.0,41304.41,42286.78,41304.41,3.384,1.74,0.59,6830.69,2,3.0,-2276.86
10/05/2020 03:00:00,15/06/2023 18:52:25,Upscale-Upscale-Gemini_BTCUSD_1h_17_12_17_to_10_03_23.csv,BTC_USD,WEEK,111563.96,8.478,07/06/2020 03:00:00,31/05/2020 03:00:00,17/05/2020 03:00:00,STOP_LOSS_HIT,LONG,9522.0,9258.81,10311.58,9258.81,0.724,7.66,2.84,6694.06,2,3.0,-2231.32
11/08/2019 00:00:00,15/06/2023 18:52:25,Upscale-Upscale-Gemini_BTCUSD_1h_17_12_17_to_10_03_23.csv,BTC_USD,WEEK,109332.64,12.705,01/09/2019 00:00:00,01/09/2019 00:00:00,18/08/2019 00:00:00,STOP_LOSS_HIT,SHORT,10199.0,10371.11,9682.68,10371.11,1.185,5.33,1.66,6559.85,2,3.0,-2186.66
19/01/2020 03:00:00,15/06/2023 18:52:25,Upscale-Upscale-Gemini_BTCUSD_1h_17_12_17_to_10_03_23.csv,BTC_USD,WEEK,107145.98,5.097,16/02/2020 03:00:00,09/02/2020 03:00:00,26/01/2020 03:00:00,TAKE_PROFIT_HIT,LONG,8302.0,9563.38,9563.38,7881.54,0.395,13.19,5.33,6429.25,2,3.0,6429.25
05/07/2020 03:00:00,15/06/2023 18:52:25,Upscale-Upscale-Gemini_BTCUSD_1h_17_12_17_to_10_03_23.csv,BTC_USD,WEEK,113575.23,14.582,02/08/2020 03:00:00,26/07/2020 03:00:00,12/07/2020 03:00:00,STOP_LOSS_HIT,LONG,9272.0,9116.23,9739.31,9116.23,1.19,4.8,1.71,6814.31,2,3.0,-2271.44
12/01/2020 03:00:00,15/06/2023 18:52:25,Upscale-Upscale-Gemini_BTCUSD_1h_17_12_17_to_10_03_23.csv,BTC_USD,WEEK,111303.79,6.803,09/02/2020 03:00:00,02/02/2020 03:00:00,19/01/2020 03:00:00,STOP_LOSS_HIT,LONG,9151.0,8823.8,10132.61,8823.8,0.559,9.69,3.71,6677.89,2,3.0,-2225.94
12/08/2018 00:00:00,15/06/2023 18:52:25,Upscale-Upscale-Gemini_BTCUSD_1h_17_12_17_to_10_03_23.csv,BTC_USD,WEEK,109077.85,15.616,02/09/2018 00:00:00,02/09/2018 00:00:00,19/08/2018 00:00:00,STOP_LOSS_HIT,LONG,6390.0,6250.3,6809.09,6250.3,0.915,6.15,2.24,6544.51,2,3.0,-2181.56
20/05/2018 00:00:00,15/06/2023 18:52:25,Upscale-Upscale-Gemini_BTCUSD_1h_17_12_17_to_10_03_23.csv,BTC_USD,WEEK,106896.29,19.542,17/06/2018 00:00:00,10/06/2018 00:00:00,27/05/2018 00:00:00,STOP_LOSS_HIT,SHORT,7333.0,7442.4,7004.8,7442.4,1.341,4.69,1.47,6413.68,2,3.0,-2137.89
14/07/2019 00:00:00,15/06/2023 18:52:25,Upscale-Upscale-Gemini_BTCUSD_1h_17_12_17_to_10_03_23.csv,BTC_USD,WEEK,104758.4,7.884,11/08/2019 00:00:00,04/08/2019 00:00:00,21/07/2019 00:00:00,STOP_LOSS_HIT,LONG,10753.0,10487.25,11550.26,10487.25,0.809,6.9,2.53,6285.6,2,3.0,-2095.17
07/11/2021 03:00:00,15/06/2023 18:52:25,Upscale-Upscale-Gemini_BTCUSD_1h_17_12_17_to_10_03_23.csv,BTC_USD,WEEK,102663.23,1.19,05/12/2021 03:00:00,28/11/2021 03:00:00,14/11/2021 03:00:00,TAKE_PROFIT_HIT,SHORT,64675.0,59497.91,59497.91,66400.7,0.75,8.7,2.6,6160.74,2,3.0,6160.74
27/01/2019 00:00:00,15/06/2023 18:52:25,Upscale-Upscale-Gemini_BTCUSD_1h_17_12_17_to_10_03_23.csv,BTC_USD,WEEK,108823.97,76.934,24/02/2019 00:00:00,17/02/2019 00:00:00,03/02/2019 00:00:00,STOP_LOSS_HIT,LONG,3469.0,3440.71,3553.87,3440.71,2.452,2.39,0.82,6529.39,2,3.0,-2176.46
13/05/2018 00:00:00,15/06/2023 18:52:25,Upscale-Upscale-Gemini_BTCUSD_1h_17_12_17_to_10_03_23.csv,BTC_USD,WEEK,106647.51,14.5,27/05/2018 00:00:00,03/06/2018 00:00:00,20/05/2018 00:00:00,STOP_LOSS_HIT,SHORT,8240.0,8387.1,7798.7,8387.1,1.12,5.66,1.75,6398.85,2,3.0,-2132.95
12/05/2019 00:00:00,15/06/2023 18:52:25,Upscale-Upscale-Gemini_BTCUSD_1h_17_12_17_to_10_03_23.csv,BTC_USD,WEEK,104514.56,5.159,09/06/2019 00:00:00,02/06/2019 00:00:00,26/05/2019 00:00:00,TAKE_PROFIT_HIT,LONG,7263.0,8478.57,8478.57,6857.81,0.359,14.34,5.91,6271.13,2,3.0,6271.13
20/03/2022 03:00:00,15/06/2023 18:52:25,Upscale-Upscale-Gemini_BTCUSD_1h_17_12_17_to_10_03_23.csv,BTC_USD,WEEK,110785.69,5.969,03/04/2022 03:00:00,10/04/2022 03:00:00,27/03/2022 03:00:00,STOP_LOSS_HIT,LONG,44715.0,44343.78,45828.66,44343.78,2.409,2.43,0.84,6647.44,2,3.0,-2215.81
17/05/2020 03:00:00,15/06/2023 18:52:25,Upscale-Upscale-Gemini_BTCUSD_1h_17_12_17_to_10_03_23.csv,BTC_USD,WEEK,108569.88,4.358,14/06/2020 03:00:00,07/06/2020 03:00:00,24/05/2020 03:00:00,STOP_LOSS_HIT,LONG,9209.0,8710.78,10703.66,8710.78,0.37,13.96,5.72,6513.73,2,3.0,-2171.24
09/05/2021 03:00:00,15/06/2023 18:52:25,Upscale-Upscale-Gemini_BTCUSD_1h_17_12_17_to_10_03_23.csv,BTC_USD,WEEK,106398.64,0.919,30/05/2021 03:00:00,30/05/2021 03:00:00,16/05/2021 03:00:00,TAKE_PROFIT_HIT,SHORT,48161.0,41214.0,41214.0,50476.67,0.416,16.86,4.59,6384.29,2,3.0,6384.29
10/04/2022 03:00:00,15/06/2023 18:52:25,Upscale-Upscale-Gemini_BTCUSD_1h_17_12_17_to_10_03_23.csv,BTC_USD,WEEK,112782.93,5.66,08/05/2022 03:00:00,01/05/2022 03:00:00,17/04/2022 03:00:00,STOP_LOSS_HIT,LONG,40197.0,39798.49,41392.53,39798.49,2.017,2.89,1.0,6766.7,2,3.0,-2255.57
04/11/2018 00:00:00,15/06/2023 18:52:25,Upscale-Upscale-Gemini_BTCUSD_1h_17_12_17_to_10_03_23.csv,BTC_USD,WEEK,110527.36,15.388,25/11/2018 00:00:00,25/11/2018 00:00:00,11/11/2018 00:00:00,TAKE_PROFIT_HIT,SHORT,6350.0,5919.04,5919.04,6493.65,0.884,7.28,2.21,6631.61,2,3.0,6631.61
27/09/2020 03:00:00,15/06/2023 18:52:25,Upscale-Upscale-Gemini_BTCUSD_1h_17_12_17_to_10_03_23.csv,BTC_USD,WEEK,117158.97,17.964,25/10/2020 03:00:00,18/10/2020 03:00:00,04/10/2020 03:00:00,TAKE_PROFIT_HIT,LONG,10563.0,10954.31,10954.31,10432.56,1.62,3.57,1.25,7029.49,2,3.0,7029.49
06/12/2020 03:00:00,15/06/2023 18:52:25,Upscale-Upscale-Gemini_BTCUSD_1h_17_12_17_to_10_03_23.csv,BTC_USD,WEEK,124188.46,2.12,03/01/2021 03:00:00,27/12/2020 03:00:00,13/12/2020 03:00:00,TAKE_PROFIT_HIT,LONG,18828.0,22343.02,22343.02,17656.33,0.321,15.73,6.64,7451.84,2,3.0,7451.84
04/10/2020 03:00:00,15/06/2023 18:52:25,Upscale-Upscale-Gemini_BTCUSD_1h_17_12_17_to_10_03_23.csv,BTC_USD,WEEK,131640.3,16.542,01/11/2020 03:00:00,25/10/2020 03:00:00,11/10/2020 03:00:00,STOP_LOSS_HIT,LONG,11359.0,11199.84,11836.48,11199.84,1.427,4.03,1.42,7898.47,2,3.0,-2632.82
31/10/2021 03:00:00,15/06/2023 18:52:25,Upscale-Upscale-Gemini_BTCUSD_1h_17_12_17_to_10_03_23.csv,BTC_USD,WEEK,129007.48,1.672,28/11/2021 03:00:00,21/11/2021 03:00:00,07/11/2021 03:00:00,TAKE_PROFIT_HIT,LONG,61991.0,66621.41,66621.41,60447.53,0.803,6.95,2.55,7742.05,2,3.0,7742.05
10/02/2019 00:00:00,15/06/2023 18:52:25,Upscale-Upscale-Gemini_BTCUSD_1h_17_12_17_to_10_03_23.csv,BTC_USD,WEEK,136749.53,37.569,10/03/2019 00:00:00,03/03/2019 00:00:00,17/02/2019 00:00:00,TAKE_PROFIT_HIT,LONG,3582.0,3800.41,3800.41,3509.2,0.984,5.75,2.07,8205.45,2,3.0,8205.45
31/10/2021 03:00:00,15/06/2023 18:52:25,Upscale-Upscale-Gemini_BTCUSD_1h_17_12_17_to_10_03_23.csv,BTC_USD,WEEK,144954.98,1.878,28/11/2021 03:00:00,21/11/2021 03:00:00,07/11/2021 03:00:00,TAKE_PROFIT_HIT,LONG,61991.0,66621.41,66621.41,60447.53,0.803,6.95,2.55,8695.91,2,3.0,8695.91
08/11/2020 03:00:00,15/06/2023 18:52:25,Upscale-Upscale-Gemini_BTCUSD_1h_17_12_17_to_10_03_23.csv,BTC_USD,WEEK,153650.89,3.957,06/12/2020 03:00:00,29/11/2020 03:00:00,15/11/2020 03:00:00,TAKE_PROFIT_HIT,LONG,16003.0,18332.91,18332.91,15226.36,0.412,12.71,5.1,9219.45,2,3.0,9219.45
14/03/2021 03:00:00,15/06/2023 18:52:25,Upscale-Upscale-Gemini_BTCUSD_1h_17_12_17_to_10_03_23.csv,BTC_USD,WEEK,162870.34,0.958,11/04/2021 03:00:00,04/04/2021 03:00:00,21/03/2021 03:00:00,STOP_LOSS_HIT,LONG,57642.0,54242.59,67840.24,54242.59,0.339,15.03,6.27,9769.91,2,3.0,-3256.63
27/03/2022 03:00:00,15/06/2023 18:52:25,Upscale-Upscale-Gemini_BTCUSD_1h_17_12_17_to_10_03_23.csv,BTC_USD,WEEK,159613.71,1.662,24/04/2022 03:00:00,17/04/2022 03:00:00,03/04/2022 03:00:00,STOP_LOSS_HIT,LONG,45803.0,43882.21,51565.37,43882.21,0.477,11.17,4.38,9577.06,2,3.0,-3192.35
10/04/2022 03:00:00,15/06/2023 18:52:26,Upscale-Upscale-Gemini_BTCUSD_1h_17_12_17_to_10_03_23.csv,BTC_USD,WEEK,156421.36,7.85,08/05/2022 03:00:00,01/05/2022 03:00:00,17/04/2022 03:00:00,STOP_LOSS_HIT,LONG,40197.0,39798.49,41392.53,39798.49,2.017,2.89,1.0,9384.91,2,3.0,-3128.3
06/05/2018 00:00:00,15/06/2023 18:52:26,Upscale-Upscale-Gemini_BTCUSD_1h_17_12_17_to_10_03_23.csv,BTC_USD,WEEK,153293.06,10.762,03/06/2018 00:00:00,27/05/2018 00:00:00,13/05/2018 00:00:00,STOP_LOSS_HIT,LONG,8466.0,8181.13,9320.62,8181.13,0.594,9.17,3.48,9197.42,2,3.0,-3065.77
09/05/2021 03:00:00,15/06/2023 18:52:26,Upscale-Upscale-Gemini_BTCUSD_1h_17_12_17_to_10_03_23.csv,BTC_USD,WEEK,150227.29,1.297,30/05/2021 03:00:00,30/05/2021 03:00:00,16/05/2021 03:00:00,TAKE_PROFIT_HIT,SHORT,48161.0,41214.0,41214.0,50476.67,0.416,16.86,4.59,9010.26,2,3.0,9010.26
20/03/2022 03:00:00,15/06/2023 18:52:26,Upscale-Upscale-Gemini_BTCUSD_1h_17_12_17_to_10_03_23.csv,BTC_USD,WEEK,159237.55,8.579,03/04/2022 03:00:00,10/04/2022 03:00:00,27/03/2022 03:00:00,STOP_LOSS_HIT,LONG,44715.0,44343.78,45828.66,44343.78,2.409,2.43,0.84,9554.09,2,3.0,-3184.7
28/07/2019 00:00:00,15/06/2023 18:52:26,Upscale-Upscale-Gemini_BTCUSD_1h_17_12_17_to_10_03_23.csv,BTC_USD,WEEK,156052.85,22.228,11/08/2019 00:00:00,18/08/2019 00:00:00,04/08/2019 00:00:00,STOP_LOSS_HIT,LONG,10817.0,10676.59,11238.25,10676.59,1.541,3.75,1.32,9363.55,2,3.0,-3121.03
05/04/2020 03:00:00,15/06/2023 18:52:26,Upscale-Upscale-Gemini_BTCUSD_1h_17_12_17_to_10_03_23.csv,BTC_USD,WEEK,152931.82,23.672,03/05/2020 03:00:00,26/04/2020 03:00:00,12/04/2020 03:00:00,STOP_LOSS_HIT,LONG,6826.0,6696.79,7213.64,6696.79,1.057,5.37,1.93,9176.21,2,3.0,-3058.66
27/01/2019 00:00:00,15/06/2023 18:52:26,Upscale-Upscale-Gemini_BTCUSD_1h_17_12_17_to_10_03_23.csv,BTC_USD,WEEK,149873.16,105.955,24/02/2019 00:00:00,17/02/2019 00:00:00,03/02/2019 00:00:00,STOP_LOSS_HIT,LONG,3469.0,3440.71,3553.87,3440.71,2.452,2.39,0.82,8992.4,2,3.0,-2997.47
15/07/2018 00:00:00,15/06/2023 18:52:26,Upscale-Upscale-Gemini_BTCUSD_1h_17_12_17_to_10_03_23.csv,BTC_USD,WEEK,146875.69,26.714,29/07/2018 00:00:00,05/08/2018 00:00:00,22/07/2018 00:00:00,TAKE_PROFIT_HIT,LONG,7409.0,7738.88,7738.88,7299.04,1.348,4.26,1.51,8812.41,2,3.0,8812.41
02/02/2020 03:00:00,15/06/2023 18:52:26,Upscale-Upscale-Gemini_BTCUSD_1h_17_12_17_to_10_03_23.csv,BTC_USD,WEEK,155688.1,4.896,01/03/2020 03:00:00,23/02/2020 03:00:00,16/02/2020 03:00:00,STOP_LOSS_HIT,LONG,9976.0,9340.08,11883.76,9340.08,0.314,16.05,6.81,9340.39,2,3.0,-3113.46
23/10/2022 03:00:00,15/06/2023 18:52:26,Upscale-Upscale-Gemini_BTCUSD_1h_17_12_17_to_10_03_23.csv,BTC_USD,WEEK,152574.64,15.846,13/11/2022 03:00:00,13/11/2022 03:00:00,30/10/2022 03:00:00,STOP_LOSS_HIT,SHORT,20758.0,20950.57,20180.3,20950.57,2.156,2.86,0.92,9154.23,2,3.0,-3051.46
17/04/2022 03:00:00,15/06/2023 18:52:26,Upscale-Upscale-Gemini_BTCUSD_1h_17_12_17_to_10_03_23.csv,BTC_USD,WEEK,149523.18,2.468,15/05/2022 03:00:00,08/05/2022 03:00:00,24/04/2022 03:00:00,STOP_LOSS_HIT,SHORT,39549.0,40760.47,35914.6,40760.47,0.653,10.12,2.97,8969.7,2,3.0,-2989.91
21/08/2022 03:00:00,15/06/2023 18:52:26,Upscale-Upscale-Gemini_BTCUSD_1h_17_12_17_to_10_03_23.csv,BTC_USD,WEEK,146533.27,2.626,18/09/2022 03:00:00,11/09/2022 03:00:00,04/09/2022 03:00:00,STOP_LOSS_HIT,LONG,20010.0,18894.05,23357.86,18894.05,0.359,14.33,5.91,8791.48,2,3.0,-2930.48
29/12/2019 03:00:00,15/06/2023 18:52:26,Upscale-Upscale-Gemini_BTCUSD_1h_17_12_17_to_10_03_23.csv,BTC_USD,WEEK,143602.79,30.73,19/01/2020 03:00:00,19/01/2020 03:00:00,05/01/2020 03:00:00,STOP_LOSS_HIT,LONG,7438.0,7344.54,7718.39,7344.54,1.592,3.63,1.27,8616.38,2,3.0,-2872.03
12/07/2020 03:00:00,15/06/2023 18:52:26,Upscale-Upscale-Gemini_BTCUSD_1h_17_12_17_to_10_03_23.csv,BTC_USD,WEEK,140730.76,15.678,02/08/2020 03:00:00,02/08/2020 03:00:00,19/07/2020 03:00:00,TAKE_PROFIT_HIT,LONG,9165.0,9703.59,9703.59,8985.47,1.021,5.55,2.0,8444.01,2,3.0,8444.01
31/03/2019 00:00:00,15/06/2023 18:52:26,Upscale-Upscale-Gemini_BTCUSD_1h_17_12_17_to_10_03_23.csv,BTC_USD,WEEK,149174.77,32.905,21/04/2019 00:00:00,21/04/2019 00:00:00,07/04/2019 00:00:00,STOP_LOSS_HIT,LONG,5045.0,4954.33,5317.0,4954.33,1.113,5.12,1.83,8950.16,2,3.0,-2983.5
04/10/2020 03:00:00,15/06/2023 18:52:26,Upscale-Upscale-Gemini_BTCUSD_1h_17_12_17_to_10_03_23.csv,BTC_USD,WEEK,146191.27,18.37,01/11/2020 03:00:00,25/10/2020 03:00:00,11/10/2020 03:00:00,STOP_LOSS_HIT,LONG,11359.0,11199.84,11836.48,11199.84,1.427,4.03,1.42,8771.31,2,3.0,-2923.77
22/07/2018 00:00:00,15/06/2023 18:52:26,Upscale-Upscale-Gemini_BTCUSD_1h_17_12_17_to_10_03_23.csv,BTC_USD,WEEK,143267.5,7.964,19/08/2018 00:00:00,12/08/2018 00:00:00,29/07/2018 00:00:00,STOP_LOSS_HIT,LONG,8235.0,7875.23,9314.3,7875.23,0.458,11.59,4.57,8595.55,2,3.0,-2865.21
17/10/2021 03:00:00,15/06/2023 18:52:26,Upscale-Upscale-Gemini_BTCUSD_1h_17_12_17_to_10_03_23.csv,BTC_USD,WEEK,140402.29,0.823,14/11/2021 03:00:00,07/11/2021 03:00:00,24/10/2021 03:00:00,STOP_LOSS_HIT,LONG,61198.0,57787.45,71429.67,57787.45,0.359,14.32,5.9,8420.66,2,3.0,-2806.88
11/11/2018 00:00:00,15/06/2023 18:52:26,Upscale-Upscale-Gemini_BTCUSD_1h_17_12_17_to_10_03_23.csv,BTC_USD,WEEK,137595.41,15.764,09/12/2018 00:00:00,02/12/2018 00:00:00,18/11/2018 00:00:00,TAKE_PROFIT_HIT,SHORT,5504.0,4980.29,4980.29,5678.57,0.631,10.52,3.07,8255.76,2,3.0,8255.76
29/07/2018 00:00:00,15/06/2023 18:52:26,Upscale-Upscale-Gemini_BTCUSD_1h_17_12_17_to_10_03_23.csv,BTC_USD,WEEK,145851.17,7.699,26/08/2018 00:00:00,19/08/2018 00:00:00,05/08/2018 00:00:00,STOP_LOSS_HIT,LONG,7015.0,6636.13,8151.62,6636.13,0.37,13.94,5.71,8750.84,2,3.0,-2916.92
25/04/2021 03:00:00,15/06/2023 18:52:26,Upscale-Upscale-Gemini_BTCUSD_1h_17_12_17_to_10_03_23.csv,BTC_USD,WEEK,142934.25,4.724,23/05/2021 03:00:00,16/05/2021 03:00:00,02/05/2021 03:00:00,STOP_LOSS_HIT,SHORT,57704.0,58309.16,55888.54,58309.16,1.907,3.25,1.04,8576.23,2,3.0,-2858.78
27/09/2020 03:00:00,15/06/2023 18:52:26,Upscale-Upscale-Gemini_BTCUSD_1h_17_12_17_to_10_03_23.csv,BTC_USD,WEEK,140075.47,21.477,25/10/2020 03:00:00,18/10/2020 03:00:00,04/10/2020 03:00:00,TAKE_PROFIT_HIT,LONG,10563.0,10954.31,10954.31,10432.56,1.62,3.57,1.25,8404.16,2,3.0,8404.16
10/07/2022 03:00:00,15/06/2023 18:52:26,Upscale-Upscale-Gemini_BTCUSD_1h_17_12_17_to_10_03_23.csv,BTC_USD,WEEK,148479.63,23.525,31/07/2022 03:00:00,31/07/2022 03:00:00,17/07/2022 03:00:00,STOP_LOSS_HIT,LONG,21157.0,21030.77,21535.68,21030.77,3.352,1.76,0.6,8908.45,2,3.0,-2969.56
06/12/2020 03:00:00,15/06/2023 18:52:26,Upscale-Upscale-Gemini_BTCUSD_1h_17_12_17_to_10_03_23.csv,BTC_USD,WEEK,145510.07,2.484,03/01/2021 03:00:00,27/12/2020 03:00:00,13/12/2020 03:00:00,TAKE_PROFIT_HIT,LONG,18828.0,22343.02,22343.02,17656.33,0.321,15.73,6.64,8731.31,2,3.0,8731.31
25/07/2021 03:00:00,15/06/2023 18:52:26,Upscale-Upscale-Gemini_BTCUSD_1h_17_12_17_to_10_03_23.csv,BTC_USD,WEEK,154241.38,2.036,22/08/2021 03:00:00,15/08/2021 03:00:00,01/08/2021 03:00:00,STOP_LOSS_HIT,LONG,41840.0,40324.71,46385.89,40324.71,0.552,9.8,3.76,9255.43,2,3.0,-3085.13
19/09/2021 03:00:00,15/06/2023 18:52:26,Upscale-Upscale-Gemini_BTCUSD_1h_17_12_17_to_10_03_23.csv,BTC_USD,WEEK,151156.25,2.872,17/10/2021 03:00:00,10/10/2021 03:00:00,26/09/2021 03:00:00,STOP_LOSS_HIT,LONG,42091.0,41038.3,45249.1,41038.3,0.8,6.98,2.57,9070.06,2,3.0,-3023.35
17/01/2021 03:00:00,15/06/2023 18:52:26,Upscale-Upscale-Gemini_BTCUSD_1h_17_12_17_to_10_03_23.csv,BTC_USD,WEEK,148132.9,1.698,14/02/2021 03:00:00,07/02/2021 03:00:00,24/01/2021 03:00:00,STOP_LOSS_HIT,LONG,32138.0,30393.16,37372.53,30393.16,0.368,14.01,5.74,8888.23,2,3.0,-2962.74
11/04/2021 03:00:00,15/06/2023 18:52:26,Upscale-Upscale-Gemini_BTCUSD_1h_17_12_17_to_10_03_23.csv,BTC_USD,WEEK,145170.16,1.229,09/05/2021 03:00:00,02/05/2021 03:00:00,18/04/2021 03:00:00,STOP_LOSS_HIT,LONG,58856.0,56494.1,65941.71,56494.1,0.498,10.75,4.18,8708.34,2,3.0,-2902.78
17/04/2022 03:00:00,15/06/2023 18:52:26,Upscale-Upscale-Gemini_BTCUSD_1h_17_12_17_to_10_03_23.csv,BTC_USD,WEEK,142267.38,2.349,15/05/2022 03:00:00,08/05/2022 03:00:00,24/04/2022 03:00:00,STOP_LOSS_HIT,SHORT,39549.0,40760.47,35914.6,40760.47,0.653,10.12,2.97,8537.21,2,3.0,-2845.74
26/07/2020 03:00:00,15/06/2023 18:52:26,Upscale-Upscale-Gemini_BTCUSD_1h_17_12_17_to_10_03_23.csv,BTC_USD,WEEK,139421.64,10.899,02/08/2020 03:00:00,16/08/2020 03:00:00,02/08/2020 03:00:00,STOP_LOSS_HIT,LONG,11938.0,11682.16,12705.53,11682.16,0.933,6.04,2.19,8365.31,2,3.0,-2788.4
18/04/2021 03:00:00,15/06/2023 18:52:26,Upscale-Upscale-Gemini_BTCUSD_1h_17_12_17_to_10_03_23.csv,BTC_USD,WEEK,136633.24,4.139,16/05/2021 03:00:00,09/05/2021 03:00:00,25/04/2021 03:00:00,STOP_LOSS_HIT,SHORT,50354.0,51014.17,48373.5,51014.17,1.525,4.09,1.29,8197.29,2,3.0,-2732.44
08/07/2018 00:00:00,15/06/2023 18:52:26,Upscale-Upscale-Gemini_BTCUSD_1h_17_12_17_to_10_03_23.csv,BTC_USD,WEEK,133900.8,33.484,29/07/2018 00:00:00,29/07/2018 00:00:00,15/07/2018 00:00:00,TAKE_PROFIT_HIT,LONG,6250.0,6489.95,6489.95,6170.02,1.563,3.7,1.3,8034.49,2,3.0,8034.49
24/05/2020 03:00:00,15/06/2023 18:52:26,Upscale-Upscale-Gemini_BTCUSD_1h_17_12_17_to_10_03_23.csv,BTC_USD,WEEK,141935.29,16.166,21/06/2020 03:00:00,14/06/2020 03:00:00,31/05/2020 03:00:00,STOP_LOSS_HIT,LONG,9642.0,9466.4,10168.8,9466.4,1.098,5.18,1.85,8516.25,2,3.0,-2838.75
10/11/2019 00:00:00,15/06/2023 18:52:26,Upscale-Upscale-Gemini_BTCUSD_1h_17_12_17_to_10_03_23.csv,BTC_USD,WEEK,139096.54,19.187,24/11/2019 00:00:00,01/12/2019 02:00:00,17/11/2019 01:00:00,TAKE_PROFIT_HIT,SHORT,8494.0,8059.04,8059.04,8638.99,1.172,5.4,1.68,8345.58,2,3.0,8345.58
27/09/2020 03:00:00,15/06/2023 18:52:26,Upscale-Upscale-Gemini_BTCUSD_1h_17_12_17_to_10_03_23.csv,BTC_USD,WEEK,147442.12,22.607,25/10/2020 03:00:00,18/10/2020 03:00:00,04/10/2020 03:00:00,TAKE_PROFIT_HIT,LONG,10563.0,10954.31,10954.31,10432.56,1.62,3.57,1.25,8846.35,2,3.0,8846.35
01/11/2020 03:00:00,15/06/2023 18:52:26,Upscale-Upscale-Gemini_BTCUSD_1h_17_12_17_to_10_03_23.csv,BTC_USD,WEEK,156288.47,3.79,29/11/2020 03:00:00,22/11/2020 03:00:00,15/11/2020 03:00:00,TAKE_PROFIT_HIT,LONG,15036.0,17510.32,17510.32,14211.23,0.365,14.13,5.8,9377.67,2,3.0,9377.67
28/11/2021 03:00:00,15/06/2023 18:52:26,Upscale-Upscale-Gemini_BTCUSD_1h_17_12_17_to_10_03_23.csv,BTC_USD,WEEK,165666.14,6.669,19/12/2021 03:00:00,19/12/2021 03:00:00,05/12/2021 03:00:00,STOP_LOSS_HIT,SHORT,49141.0,49637.81,47650.56,49637.81,1.978,3.13,1.0,9939.74,2,3.0,-3313.23
11/04/2021 03:00:00,15/06/2023 18:52:26,Upscale-Upscale-Gemini_BTCUSD_1h_17_12_17_to_10_03_23.csv,BTC_USD,WEEK,162352.91,1.375,09/05/2021 03:00:00,02/05/2021 03:00:00,18/04/2021 03:00:00,STOP_LOSS_HIT,LONG,58856.0,56494.1,65941.71,56494.1,0.498,10.75,4.18,9742.85,2,3.0,-3247.61
17/11/2019 01:00:00,15/06/2023 18:52:26,Upscale-Upscale-Gemini_BTCUSD_1h_17_12_17_to_10_03_23.csv,BTC_USD,WEEK,159105.3,25.42,15/12/2019 01:00:00,08/12/2019 02:00:00,24/11/2019 02:00:00,STOP_LOSS_HIT,LONG,7269.0,7143.82,7644.55,7143.82,1.161,4.91,1.75,9546.48,2,3.0,-3182.08
15/08/2021 03:00:00,15/06/2023 18:52:26,Upscale-Upscale-Gemini_BTCUSD_1h_17_12_17_to_10_03_23.csv,BTC_USD,WEEK,155923.22,1.434,12/09/2021 03:00:00,05/09/2021 03:00:00,22/08/2021 03:00:00,STOP_LOSS_HIT,LONG,48878.0,46703.76,55400.73,46703.76,0.45,11.77,4.66,9353.59,2,3.0,-3117.86
14/07/2019 00:00:00,15/06/2023 18:52:26,Upscale-Upscale-Gemini_BTCUSD_1h_17_12_17_to_10_03_23.csv,BTC_USD,WEEK,152805.36,11.5,11/08/2019 00:00:00,04/08/2019 00:00:00,21/07/2019 00:00:00,STOP_LOSS_HIT,LONG,10753.0,10487.25,11550.26,10487.25,0.809,6.9,2.53,9168.49,2,3.0,-3056.12
08/01/2023 03:00:00,15/06/2023 18:52:26,Upscale-Upscale-Gemini_BTCUSD_1h_17_12_17_to_10_03_23.csv,BTC_USD,WEEK,149749.24,5.494,05/02/2023 03:00:00,29/01/2023 03:00:00,15/01/2023 03:00:00,TAKE_PROFIT_HIT,LONG,20684.0,22319.49,22319.49,20138.84,0.759,7.33,2.71,8985.38,2,3.0,8985.38
29/12/2019 03:00:00,15/06/2023 18:52:26,Upscale-Upscale-Gemini_BTCUSD_1h_17_12_17_to_10_03_23.csv,BTC_USD,WEEK,158734.62,33.968,19/01/2020 03:00:00,19/01/2020 03:00:00,05/01/2020 03:00:00,STOP_LOSS_HIT,LONG,7438.0,7344.54,7718.39,7344.54,1.592,3.63,1.27,9524.29,2,3.0,-3174.65
28/07/2019 00:00:00,15/06/2023 18:52:26,Upscale-Upscale-Gemini_BTCUSD_1h_17_12_17_to_10_03_23.csv,BTC_USD,WEEK,155559.97,22.158,11/08/2019 00:00:00,18/08/2019 00:00:00,04/08/2019 00:00:00,STOP_LOSS_HIT,LONG,10817.0,10676.59,11238.25,10676.59,1.541,3.75,1.32,9334.06,2,3.0,-3111.2
25/07/2021 03:00:00,15/06/2023 18:52:26,Upscale-Upscale-Gemini_BTCUSD_1h_17_12_17_to_10_03_23.csv,BTC_USD,WEEK,152448.77,2.012,22/08/2021 03:00:00,15/08/2021 03:00:00,01/08/2021 03:00:00,STOP_LOSS_HIT,LONG,41840.0,40324.71,46385.89,40324.71,0.552,9.8,3.76,9146.33,2,3.0,-3048.76
08/01/2023 03:00:00,15/06/2023 18:52:26,Upscale-Upscale-Gemini_BTCUSD_1h_17_12_17_to_10_03_23.csv,BTC_USD,WEEK,149400.01,5.481,05/02/2023 03:00:00,29/01/2023 03:00:00,15/01/2023 03:00:00,TAKE_PROFIT_HIT,LONG,20684.0,22319.49,22319.49,20138.84,0.759,7.33,2.71,8964.12,2,3.0,8964.12
11/04/2021 03:00:00,15/06/2023 18:52:26,Upscale-Upscale-Gemini_BTCUSD_1h_17_12_17_to_10_03_23.csv,BTC_USD,WEEK,158364.13,1.341,09/05/2021 03:00:00,02/05/2021 03:00:00,18/04/2021 03:00:00,STOP_LOSS_HIT,LONG,58856.0,56494.1,65941.71,56494.1,0.498,10.75,4.18,9501.94,2,3.0,-3167.31
20/12/2020 03:00:00,15/06/2023 18:52:26,Upscale-Upscale-Gemini_BTCUSD_1h_17_12_17_to_10_03_23.csv,BTC_USD,WEEK,155196.82,1.577,17/01/2021 03:00:00,10/01/2021 03:00:00,27/12/2020 03:00:00,TAKE_PROFIT_HIT,LONG,26571.0,32477.3,32477.3,24602.24,0.27,18.19,8.0,9314.24,2,3.0,9314.24
05/01/2020 03:00:00,15/06/2023 18:52:26,Upscale-Upscale-Gemini_BTCUSD_1h_17_12_17_to_10_03_23.csv,BTC_USD,WEEK,164511.06,14.723,19/01/2020 03:00:00,26/01/2020 03:00:00,12/01/2020 03:00:00,TAKE_PROFIT_HIT,LONG,8080.0,8750.41,8750.41,7856.53,0.723,7.66,2.84,9870.45,2,3.0,9870.45
26/04/2020 03:00:00,15/06/2023 18:52:26,Upscale-Upscale-Gemini_BTCUSD_1h_17_12_17_to_10_03_23.csv,BTC_USD,WEEK,174381.51,12.488,17/05/2020 03:00:00,17/05/2020 03:00:00,03/05/2020 03:00:00,STOP_LOSS_HIT,LONG,9082.0,8802.73,9919.81,8802.73,0.65,8.45,3.17,10462.57,2,3.0,-3487.52
04/03/2018 00:00:00,15/06/2023 18:52:26,Upscale-Upscale-Gemini_BTCUSD_1h_17_12_17_to_10_03_23.csv,BTC_USD,WEEK,170893.99,24.068,01/04/2018 00:00:00,25/03/2018 00:00:00,11/03/2018 00:00:00,STOP_LOSS_HIT,SHORT,8769.0,8911.01,8342.98,8911.01,1.235,5.11,1.59,10253.45,2,3.0,-3417.9
02/09/2018 00:00:00,15/06/2023 18:52:26,Upscale-Upscale-Gemini_BTCUSD_1h_17_12_17_to_10_03_23.csv,BTC_USD,WEEK,167476.09,37.985,09/09/2018 00:00:00,23/09/2018 00:00:00,09/09/2018 00:00:00,STOP_LOSS_HIT,SHORT,6185.0,6273.18,5920.46,6273.18,1.403,4.47,1.41,10048.55,2,3.0,-3349.52
02/02/2020 03:00:00,15/06/2023 18:52:26,Upscale-Upscale-Gemini_BTCUSD_1h_17_12_17_to_10_03_23.csv,BTC_USD,WEEK,164126.57,5.162,01/03/2020 03:00:00,23/02/2020 03:00:00,16/02/2020 03:00:00,STOP_LOSS_HIT,LONG,9976.0,9340.08,11883.76,9340.08,0.314,16.05,6.81,9847.86,2,3.0,-3282.62
06/12/2020 03:00:00,15/06/2023 18:52:26,Upscale-Upscale-Gemini_BTCUSD_1h_17_12_17_to_10_03_23.csv,BTC_USD,WEEK,160843.95,2.746,03/01/2021 03:00:00,27/12/2020 03:00:00,13/12/2020 03:00:00,TAKE_PROFIT_HIT,LONG,18828.0,22343.02,22343.02,17656.33,0.321,15.73,6.64,9652.24,2,3.0,9652.24
23/06/2019 00:00:00,15/06/2023 18:52:26,Upscale-Upscale-Gemini_BTCUSD_1h_17_12_17_to_10_03_23.csv,BTC_USD,WEEK,170496.19,4.669,21/07/2019 00:00:00,14/07/2019 00:00:00,30/06/2019 00:00:00,STOP_LOSS_HIT,LONG,11886.0,11155.62,14077.13,11155.62,0.325,15.57,6.55,10230.39,2,3.0,-3410.14
18/07/2021 03:00:00,15/06/2023 18:52:26,Upscale-Upscale-Gemini_BTCUSD_1h_17_12_17_to_10_03_23.csv,BTC_USD,WEEK,167086.05,5.108,15/08/2021 03:00:00,08/08/2021 03:00:00,25/07/2021 03:00:00,TAKE_PROFIT_HIT,LONG,34215.0,36177.76,36177.76,33560.75,1.046,5.43,1.95,10025.78,2,3.0,10025.78
11/10/2020 03:00:00,15/06/2023 18:52:26,Upscale-Upscale-Gemini_BTCUSD_1h_17_12_17_to_10_03_23.csv,BTC_USD,WEEK,177111.83,25.702,08/11/2020 03:00:00,01/11/2020 03:00:00,18/10/2020 03:00:00,TAKE_PROFIT_HIT,LONG,11380.0,11793.47,11793.47,11242.18,1.651,3.51,1.23,10627.01,2,3.0,10627.01
19/09/2021 03:00:00,15/06/2023 18:52:26,Upscale-Upscale-Gemini_BTCUSD_1h_17_12_17_to_10_03_23.csv,BTC_USD,WEEK,187738.84,3.567,17/10/2021 03:00:00,10/10/2021 03:00:00,26/09/2021 03:00:00,STOP_LOSS_HIT,LONG,42091.0,41038.3,45249.1,41038.3,0.8,6.98,2.57,11264.94,2,3.0,-3754.98
27/02/2022 03:00:00,15/06/2023 18:52:26,Upscale-Upscale-Gemini_BTCUSD_1h_17_12_17_to_10_03_23.csv,BTC_USD,WEEK,183983.86,9.696,27/03/2022 03:00:00,20/03/2022 03:00:00,06/03/2022 03:00:00,STOP_LOSS_HIT,LONG,39521.0,39141.51,40659.48,39141.51,2.083,2.8,0.97,11038.7,2,3.0,-3679.54
24/02/2019 00:00:00,15/06/2023 18:52:26,Upscale-Upscale-Gemini_BTCUSD_1h_17_12_17_to_10_03_23.csv,BTC_USD,WEEK,180304.32,16.181,24/03/2019 00:00:00,17/03/2019 00:00:00,17/03/2019 00:00:00,EXPIRED,LONG,3812.0,3982.0,4480.59,3589.14,0.342,14.92,6.21,10818.45,2,3.0,2750.77
05/07/2020 03:00:00,15/06/2023 18:52:26,Upscale-Upscale-Gemini_BTCUSD_1h_17_12_17_to_10_03_23.csv,BTC_USD,WEEK,183055.09,23.503,02/08/2020 03:00:00,26/07/2020 03:00:00,12/07/2020 03:00:00,STOP_LOSS_HIT,LONG,9272.0,9116.23,9739.31,9116.23,1.19,4.8,1.71,10983.19,2,3.0,-3661.06
24/05/2020 03:00:00,15/06/2023 18:52:26,Upscale-Upscale-Gemini_BTCUSD_1h_17_12_17_to_10_03_23.csv,BTC_USD,WEEK,179394.03,20.432,21/06/2020 03:00:00,14/06/2020 03:00:00,31/05/2020 03:00:00,STOP_LOSS_HIT,LONG,9642.0,9466.4,10168.8,9466.4,1.098,5.18,1.85,10763.58,2,3.0,-3587.86
11/04/2021 03:00:00,15/06/2023 18:52:26,Upscale-Upscale-Gemini_BTCUSD_1h_17_12_17_to_10_03_23.csv,BTC_USD,WEEK,175806.17,1.489,09/05/2021 03:00:00,02/05/2021 03:00:00,18/04/2021 03:00:00,STOP_LOSS_HIT,LONG,58856.0,56494.1,65941.71,56494.1,0.498,10.75,4.18,10550.62,2,3.0,-3516.87
07/04/2019 00:00:00,15/06/2023 18:52:26,Upscale-Upscale-Gemini_BTCUSD_1h_17_12_17_to_10_03_23.csv,BTC_USD,WEEK,172289.3,12.644,05/05/2019 00:00:00,28/04/2019 00:00:00,28/04/2019 00:00:00,EXPIRED,LONG,5069.0,5770.0,5886.59,4796.47,0.372,13.89,5.68,10337.61,2,3.0,8863.44
19/01/2020 03:00:00,15/06/2023 18:52:26,Upscale-Upscale-Gemini_BTCUSD_1h_17_12_17_to_10_03_23.csv,BTC_USD,WEEK,181152.74,8.617,16/02/2020 03:00:00,09/02/2020 03:00:00,26/01/2020 03:00:00,TAKE_PROFIT_HIT,LONG,8302.0,9563.38,9563.38,7881.54,0.395,13.19,5.33,10869.31,2,3.0,10869.31
01/03/2020 03:00:00,15/06/2023 18:52:26,Upscale-Upscale-Gemini_BTCUSD_1h_17_12_17_to_10_03_23.csv,BTC_USD,WEEK,192022.05,15.596,15/03/2020 03:00:00,22/03/2020 03:00:00,08/03/2020 03:00:00,TAKE_PROFIT_HIT,SHORT,8733.0,7994.24,7994.24,8979.25,0.709,9.24,2.74,11521.7,2,3.0,11521.7
