Open,Last update,Platform,Symbol,Timeframe,Account balance at open,Size,Expected close,Expiry,Close,Status,Side,Opening price,Closing price,Take profit,Stop loss,Leverage,TP price %,SL price %,Expected profit,Risk %,R/R ratio,PnL
22/03/2022 13:00:00,15/06/2023 18:39:28,Gemini_BTCUSD_d_17_12_17_to_10_03_23.csv,BTC_USD,DAY,100000.0,5.82,25/03/2022 13:00:00,25/03/2022 13:00:00,23/03/2022 04:00:00,STOP_LOSS_HIT,LONG,42396.0,42052.37,43426.89,42052.37,2.467,2.37,0.82,5999.78,2,3.0,-1999.93
26/11/2022 00:00:00,15/06/2023 18:39:28,Gemini_BTCUSD_d_17_12_17_to_10_03_23.csv,BTC_USD,DAY,98000.07,5.412,02/12/2022 00:00:00,29/11/2022 00:00:00,27/11/2022 04:00:00,STOP_LOSS_HIT,LONG,16454.0,16091.83,17540.51,16091.83,0.909,6.19,2.25,5880.19,2,3.0,-1960.06
15/02/2019 04:00:00,15/06/2023 18:39:28,Gemini_BTCUSD_d_17_12_17_to_10_03_23.csv,BTC_USD,DAY,96040.01,76.374,21/02/2019 04:00:00,21/02/2019 04:00:00,17/02/2019 04:00:00,STOP_LOSS_HIT,LONG,3587.0,3561.85,3662.46,3561.85,2.852,2.06,0.71,5763.18,2,3.0,-1920.81
07/10/2021 04:00:00,15/06/2023 18:39:28,Gemini_BTCUSD_d_17_12_17_to_10_03_23.csv,BTC_USD,DAY,94119.2,2.463,14/10/2021 04:00:00,13/10/2021 04:00:00,08/10/2021 04:00:00,TAKE_PROFIT_HIT,LONG,53827.0,56120.12,56120.12,53062.63,1.409,4.09,1.44,5647.95,2,3.0,5647.95
04/02/2020 04:00:00,15/06/2023 18:39:28,Gemini_BTCUSD_d_17_12_17_to_10_03_23.csv,BTC_USD,DAY,99767.15,7.914,11/02/2020 04:00:00,10/02/2020 04:00:00,08/02/2020 04:00:00,TAKE_PROFIT_HIT,LONG,9208.0,9964.39,9964.39,8955.87,0.73,7.59,2.82,5986.07,2,3.0,5986.07
05/11/2021 04:00:00,15/06/2023 18:39:28,Gemini_BTCUSD_d_17_12_17_to_10_03_23.csv,BTC_USD,DAY,105753.22,5.176,09/11/2021 04:00:00,11/11/2021 04:00:00,06/11/2021 04:00:00,STOP_LOSS_HIT,LONG,61172.0,60763.41,62397.79,60763.41,2.994,1.96,0.67,6344.69,2,3.0,-2114.86
18/03/2022 04:00:00,15/06/2023 18:39:28,Gemini_BTCUSD_d_17_12_17_to_10_03_23.csv,BTC_USD,DAY,103638.36,2.352,25/03/2022 04:00:00,21/03/2022 04:00:00,18/03/2022 13:00:00,STOP_LOSS_HIT,LONG,41816.0,40934.78,44459.66,40934.78,0.949,5.95,2.15,6217.89,2,3.0,-2072.63
02/08/2018 04:00:00,15/06/2023 18:39:28,Gemini_BTCUSD_d_17_12_17_to_10_03_23.csv,BTC_USD,DAY,101565.73,34.238,09/08/2018 04:00:00,08/08/2018 04:00:00,04/08/2018 04:00:00,TAKE_PROFIT_HIT,SHORT,7645.0,7467.01,7467.01,7704.33,2.577,2.38,0.77,6094.02,2,3.0,6094.02
28/09/2018 04:00:00,15/06/2023 18:39:28,Gemini_BTCUSD_d_17_12_17_to_10_03_23.csv,BTC_USD,DAY,107659.75,21.763,01/10/2018 04:00:00,04/10/2018 04:00:00,29/09/2018 04:00:00,STOP_LOSS_HIT,LONG,6692.0,6593.06,6988.83,6593.06,1.353,4.25,1.5,6459.91,2,3.0,-2153.23
31/07/2021 04:00:00,15/06/2023 18:39:28,Gemini_BTCUSD_d_17_12_17_to_10_03_23.csv,BTC_USD,DAY,105506.52,3.274,07/08/2021 04:00:00,06/08/2021 04:00:00,01/08/2021 04:00:00,STOP_LOSS_HIT,LONG,42461.0,41816.43,44394.72,41816.43,1.318,4.36,1.54,6331.0,2,3.0,-2110.32
21/09/2018 04:00:00,15/06/2023 18:39:28,Gemini_BTCUSD_d_17_12_17_to_10_03_23.csv,BTC_USD,DAY,103396.2,12.176,27/09/2018 04:00:00,27/09/2018 04:00:00,24/09/2018 04:00:00,STOP_LOSS_HIT,LONG,6734.0,6564.16,7243.51,6564.16,0.793,7.03,2.59,6203.79,2,3.0,-2067.97
24/02/2022 13:00:00,15/06/2023 18:39:28,Gemini_BTCUSD_d_17_12_17_to_10_03_23.csv,BTC_USD,DAY,101328.23,5.025,26/02/2022 13:00:00,27/02/2022 13:00:00,25/02/2022 04:00:00,STOP_LOSS_HIT,LONG,39372.0,38968.67,40582.01,38968.67,1.953,2.98,1.04,6080.3,2,3.0,-2026.73
17/04/2018 04:00:00,15/06/2023 18:39:28,Gemini_BTCUSD_d_17_12_17_to_10_03_23.csv,BTC_USD,DAY,99301.5,46.796,18/04/2018 04:00:00,23/04/2018 04:00:00,18/04/2018 04:00:00,STOP_LOSS_HIT,LONG,7935.0,7892.56,8062.31,7892.56,3.739,1.58,0.54,5957.6,2,3.0,-1986.02
23/09/2022 00:00:00,15/06/2023 18:39:28,Gemini_BTCUSD_d_17_12_17_to_10_03_23.csv,BTC_USD,DAY,97315.48,18.02,26/09/2022 00:00:00,26/09/2022 00:00:00,23/09/2022 04:00:00,STOP_LOSS_HIT,LONG,19291.0,19182.99,19615.03,19182.99,3.572,1.65,0.56,5839.02,2,3.0,-1946.34
11/01/2021 04:00:00,15/06/2023 18:39:28,Gemini_BTCUSD_d_17_12_17_to_10_03_23.csv,BTC_USD,DAY,95369.14,3.896,18/01/2021 04:00:00,17/01/2021 04:00:00,12/01/2021 04:00:00,STOP_LOSS_HIT,LONG,35000.0,34510.44,36468.69,34510.44,1.43,4.03,1.42,5722.02,2,3.0,-1907.33
17/03/2019 04:00:00,15/06/2023 18:39:28,Gemini_BTCUSD_d_17_12_17_to_10_03_23.csv,BTC_USD,DAY,93461.81,97.053,21/03/2019 04:00:00,23/03/2019 04:00:00,18/03/2019 04:00:00,STOP_LOSS_HIT,LONG,3987.0,3967.74,4044.78,3967.74,4.14,1.43,0.49,5607.72,2,3.0,-1869.24
04/03/2018 04:00:00,15/06/2023 18:39:28,Gemini_BTCUSD_d_17_12_17_to_10_03_23.csv,BTC_USD,DAY,91592.57,7.778,11/03/2018 04:00:00,10/03/2018 04:00:00,06/03/2018 04:00:00,TAKE_PROFIT_HIT,SHORT,11551.0,10844.43,10844.43,11786.53,0.981,6.52,2.0,5495.7,2,3.0,5495.7
04/05/2019 04:00:00,15/06/2023 18:39:28,Gemini_BTCUSD_d_17_12_17_to_10_03_23.csv,BTC_USD,DAY,97088.27,15.903,07/05/2019 04:00:00,10/05/2019 04:00:00,05/05/2019 04:00:00,STOP_LOSS_HIT,LONG,5762.0,5639.9,6128.29,5639.9,0.944,5.98,2.16,5825.11,2,3.0,-1941.76
18/01/2022 04:00:00,15/06/2023 18:39:28,Gemini_BTCUSD_d_17_12_17_to_10_03_23.csv,BTC_USD,DAY,95146.51,4.414,25/01/2022 04:00:00,21/01/2022 04:00:00,18/01/2022 13:00:00,STOP_LOSS_HIT,SHORT,41713.0,42144.11,40419.68,42144.11,1.935,3.2,1.02,5708.71,2,3.0,-1902.92
21/05/2022 04:00:00,15/06/2023 18:39:28,Gemini_BTCUSD_d_17_12_17_to_10_03_23.csv,BTC_USD,DAY,93243.59,10.535,24/05/2022 04:00:00,24/05/2022 04:00:00,21/05/2022 13:00:00,STOP_LOSS_HIT,SHORT,29328.0,29505.01,28796.99,29505.01,3.314,1.84,0.6,5594.19,2,3.0,-1864.8
09/08/2022 04:00:00,15/06/2023 18:39:28,Gemini_BTCUSD_d_17_12_17_to_10_03_23.csv,BTC_USD,DAY,91378.79,3.796,14/08/2022 04:00:00,12/08/2022 04:00:00,10/08/2022 04:00:00,TAKE_PROFIT_HIT,LONG,22869.0,24313.38,24313.38,22387.54,0.95,5.94,2.15,5482.87,2,3.0,5482.87
20/04/2022 04:00:00,15/06/2023 18:39:28,Gemini_BTCUSD_d_17_12_17_to_10_03_23.csv,BTC_USD,DAY,96861.66,2.551,21/04/2022 04:00:00,23/04/2022 04:00:00,20/04/2022 13:00:00,STOP_LOSS_HIT,LONG,41711.0,40951.48,43989.58,40951.48,1.099,5.18,1.85,5812.66,2,3.0,-1937.54
26/06/2022 04:00:00,15/06/2023 18:39:28,Gemini_BTCUSD_d_17_12_17_to_10_03_23.csv,BTC_USD,DAY,94924.12,11.796,30/06/2022 04:00:00,29/06/2022 04:00:00,26/06/2022 13:00:00,STOP_LOSS_HIT,LONG,21166.0,21005.05,21648.85,21005.05,2.63,2.23,0.77,5695.7,2,3.0,-1898.57
02/11/2021 04:00:00,15/06/2023 18:39:28,Gemini_BTCUSD_d_17_12_17_to_10_03_23.csv,BTC_USD,DAY,93025.55,4.031,09/11/2021 04:00:00,08/11/2021 04:00:00,03/11/2021 04:00:00,STOP_LOSS_HIT,LONG,63258.0,62796.41,64642.78,62796.41,2.741,2.14,0.74,5582.05,2,3.0,-1860.67
15/11/2021 04:00:00,15/06/2023 18:39:28,Gemini_BTCUSD_d_17_12_17_to_10_03_23.csv,BTC_USD,DAY,91164.88,3.474,22/11/2021 04:00:00,21/11/2021 04:00:00,16/11/2021 04:00:00,STOP_LOSS_HIT,SHORT,60944.0,61468.81,59369.57,61468.81,2.322,2.65,0.85,5469.57,2,3.0,-1823.19
20/04/2018 04:00:00,15/06/2023 18:39:28,Gemini_BTCUSD_d_17_12_17_to_10_03_23.csv,BTC_USD,DAY,89341.69,6.637,27/04/2018 04:00:00,26/04/2018 04:00:00,24/04/2018 04:00:00,TAKE_PROFIT_HIT,LONG,8869.0,9676.62,9676.62,8599.79,0.659,8.35,3.13,5360.17,2,3.0,5360.17
12/05/2019 04:00:00,15/06/2023 18:39:28,Gemini_BTCUSD_d_17_12_17_to_10_03_23.csv,BTC_USD,DAY,94701.86,13.224,16/05/2019 04:00:00,18/05/2019 04:00:00,13/05/2019 04:00:00,TAKE_PROFIT_HIT,LONG,7009.0,7438.69,7438.69,6865.77,0.979,5.78,2.09,5682.22,2,3.0,5682.22
09/06/2018 04:00:00,15/06/2023 18:39:28,Gemini_BTCUSD_d_17_12_17_to_10_03_23.csv,BTC_USD,DAY,100384.08,16.657,16/06/2018 04:00:00,15/06/2018 04:00:00,10/06/2018 04:00:00,TAKE_PROFIT_HIT,SHORT,7273.0,6911.41,6911.41,7393.53,1.207,5.23,1.63,6023.0,2,3.0,6023.0
28/09/2022 00:00:00,15/06/2023 18:39:28,Gemini_BTCUSD_d_17_12_17_to_10_03_23.csv,BTC_USD,DAY,106407.08,23.675,02/10/2022 00:00:00,01/10/2022 00:00:00,28/09/2022 04:00:00,STOP_LOSS_HIT,LONG,19412.0,19322.11,19681.68,19322.11,4.319,1.37,0.47,6384.67,2,3.0,-2128.15
23/02/2018 04:00:00,15/06/2023 18:39:28,Gemini_BTCUSD_d_17_12_17_to_10_03_23.csv,BTC_USD,DAY,104278.93,23.792,02/03/2018 04:00:00,01/03/2018 04:00:00,24/02/2018 04:00:00,STOP_LOSS_HIT,LONG,10410.0,10322.34,10672.98,10322.34,2.375,2.46,0.85,6256.82,2,3.0,-2085.61
28/04/2020 04:00:00,15/06/2023 18:39:28,Gemini_BTCUSD_d_17_12_17_to_10_03_23.csv,BTC_USD,DAY,102193.32,12.138,05/05/2020 04:00:00,04/05/2020 04:00:00,29/04/2020 04:00:00,TAKE_PROFIT_HIT,LONG,7828.0,8333.18,8333.18,7659.61,0.93,6.06,2.2,6131.87,2,3.0,6131.87
16/04/2021 04:00:00,15/06/2023 18:39:28,Gemini_BTCUSD_d_17_12_17_to_10_03_23.csv,BTC_USD,DAY,108325.19,3.094,20/04/2021 04:00:00,22/04/2021 04:00:00,17/04/2021 04:00:00,TAKE_PROFIT_HIT,SHORT,62450.0,60349.26,60349.26,63150.25,1.784,3.48,1.11,6499.69,2,3.0,6499.69
04/07/2019 04:00:00,15/06/2023 18:39:28,Gemini_BTCUSD_d_17_12_17_to_10_03_23.csv,BTC_USD,DAY,114824.88,22.333,10/07/2019 04:00:00,10/07/2019 04:00:00,05/07/2019 04:00:00,STOP_LOSS_HIT,LONG,11134.0,11031.17,11442.49,11031.17,2.166,2.7,0.93,6889.51,2,3.0,-2296.5
03/08/2018 04:00:00,15/06/2023 18:39:28,Gemini_BTCUSD_d_17_12_17_to_10_03_23.csv,BTC_USD,DAY,112528.38,41.386,09/08/2018 04:00:00,09/08/2018 04:00:00,04/08/2018 04:00:00,TAKE_PROFIT_HIT,SHORT,7645.0,7481.87,7481.87,7699.38,2.812,2.18,0.71,6751.3,2,3.0,6751.3
21/08/2020 04:00:00,15/06/2023 18:39:28,Gemini_BTCUSD_d_17_12_17_to_10_03_23.csv,BTC_USD,DAY,119279.68,23.418,28/08/2020 04:00:00,27/08/2020 04:00:00,22/08/2020 04:00:00,STOP_LOSS_HIT,SHORT,11477.0,11578.87,11171.39,11578.87,2.253,2.74,0.88,7156.77,2,3.0,-2385.59
26/02/2022 04:00:00,15/06/2023 18:39:28,Gemini_BTCUSD_d_17_12_17_to_10_03_23.csv,BTC_USD,DAY,116894.09,5.267,01/03/2022 04:00:00,01/03/2022 04:00:00,26/02/2022 13:00:00,STOP_LOSS_HIT,SHORT,38632.0,39075.85,37300.47,39075.85,1.741,3.57,1.14,7013.17,2,3.0,-2337.76
30/03/2022 04:00:00,15/06/2023 18:39:28,Gemini_BTCUSD_d_17_12_17_to_10_03_23.csv,BTC_USD,DAY,114556.33,2.884,05/04/2022 04:00:00,02/04/2022 04:00:00,31/03/2022 04:00:00,STOP_LOSS_HIT,LONG,47108.0,46313.53,49491.43,46313.53,1.186,4.82,1.72,6873.81,2,3.0,-2291.25
24/04/2019 04:00:00,15/06/2023 18:39:28,Gemini_BTCUSD_d_17_12_17_to_10_03_23.csv,BTC_USD,DAY,112265.08,21.335,29/04/2019 04:00:00,30/04/2019 04:00:00,25/04/2019 04:00:00,STOP_LOSS_HIT,LONG,5439.0,5333.76,5754.73,5333.76,1.034,5.49,1.97,6736.1,2,3.0,-2245.3
18/01/2022 13:00:00,15/06/2023 18:39:28,Gemini_BTCUSD_d_17_12_17_to_10_03_23.csv,BTC_USD,DAY,110019.78,5.328,25/01/2022 13:00:00,21/01/2022 13:00:00,19/01/2022 04:00:00,STOP_LOSS_HIT,SHORT,42120.0,42532.99,40881.04,42532.99,2.04,3.03,0.97,6601.18,2,3.0,-2200.41
12/04/2021 04:00:00,15/06/2023 18:39:28,Gemini_BTCUSD_d_17_12_17_to_10_03_23.csv,BTC_USD,DAY,107819.37,2.701,16/04/2021 04:00:00,18/04/2021 04:00:00,13/04/2021 04:00:00,TAKE_PROFIT_HIT,LONG,60416.0,62811.34,62811.34,59617.56,1.513,3.81,1.34,6469.81,2,3.0,6469.81
17/12/2018 04:00:00,15/06/2023 18:39:29,Gemini_BTCUSD_d_17_12_17_to_10_03_23.csv,BTC_USD,DAY,114289.18,34.234,24/12/2018 04:00:00,23/12/2018 04:00:00,18/12/2018 04:00:00,STOP_LOSS_HIT,LONG,3532.0,3465.23,3732.3,3465.23,1.058,5.37,1.93,6857.07,2,3.0,-2285.8
13/03/2023 00:00:00,15/06/2023 18:39:29,Gemini_BTCUSD_d_17_12_17_to_10_03_23.csv,BTC_USD,DAY,112003.38,5.648,20/03/2023 00:00:00,19/03/2023 00:00:00,14/03/2023 00:00:00,TAKE_PROFIT_HIT,LONG,24237.0,25426.74,25426.74,23840.42,1.222,4.68,1.66,6719.65,2,3.0,6719.65
22/10/2022 04:00:00,15/06/2023 18:39:29,Gemini_BTCUSD_d_17_12_17_to_10_03_23.csv,BTC_USD,DAY,118723.03,21.496,29/10/2022 04:00:00,25/10/2022 04:00:00,23/10/2022 00:00:00,STOP_LOSS_HIT,LONG,19199.0,19088.54,19530.39,19088.54,3.476,1.7,0.58,7123.56,2,3.0,-2374.45
28/07/2022 00:00:00,15/06/2023 18:39:29,Gemini_BTCUSD_d_17_12_17_to_10_03_23.csv,BTC_USD,DAY,116348.58,4.86,31/07/2022 00:00:00,31/07/2022 00:00:00,28/07/2022 04:00:00,STOP_LOSS_HIT,LONG,23860.0,23381.18,25296.47,23381.18,0.997,5.68,2.05,6981.24,2,3.0,-2327.07
15/03/2022 13:00:00,15/06/2023 18:39:29,Gemini_BTCUSD_d_17_12_17_to_10_03_23.csv,BTC_USD,DAY,114021.51,5.444,22/03/2022 13:00:00,18/03/2022 13:00:00,16/03/2022 04:00:00,STOP_LOSS_HIT,LONG,40391.0,39972.13,41647.61,39972.13,1.928,3.02,1.05,6840.98,2,3.0,-2280.33
05/02/2021 04:00:00,15/06/2023 18:39:29,Gemini_BTCUSD_d_17_12_17_to_10_03_23.csv,BTC_USD,DAY,111741.18,3.037,12/02/2021 04:00:00,11/02/2021 04:00:00,06/02/2021 04:00:00,STOP_LOSS_HIT,LONG,39416.0,38680.02,41623.94,38680.02,1.071,5.3,1.9,6705.51,2,3.0,-2235.17
16/08/2021 04:00:00,15/06/2023 18:39:29,Gemini_BTCUSD_d_17_12_17_to_10_03_23.csv,BTC_USD,DAY,109506.01,6.703,23/08/2021 04:00:00,22/08/2021 04:00:00,17/08/2021 04:00:00,STOP_LOSS_HIT,LONG,46435.0,46108.28,47415.17,46108.28,2.842,2.07,0.71,6570.08,2,3.0,-2190.0
05/09/2021 04:00:00,15/06/2023 18:39:29,Gemini_BTCUSD_d_17_12_17_to_10_03_23.csv,BTC_USD,DAY,107316.01,4.238,12/09/2021 04:00:00,11/09/2021 04:00:00,06/09/2021 04:00:00,STOP_LOSS_HIT,SHORT,51638.0,52144.48,50118.58,52144.48,2.039,3.03,0.97,6439.3,2,3.0,-2146.46
10/01/2020 04:00:00,15/06/2023 18:39:29,Gemini_BTCUSD_d_17_12_17_to_10_03_23.csv,BTC_USD,DAY,105169.55,22.153,16/01/2020 04:00:00,16/01/2020 04:00:00,11/01/2020 04:00:00,STOP_LOSS_HIT,LONG,8161.0,8066.05,8445.85,8066.05,1.719,3.37,1.18,6310.28,2,3.0,-2103.43
02/01/2018 04:00:00,15/06/2023 18:39:29,Gemini_BTCUSD_d_17_12_17_to_10_03_23.csv,BTC_USD,DAY,103066.12,8.739,07/01/2018 04:00:00,08/01/2018 04:00:00,03/01/2018 04:00:00,STOP_LOSS_HIT,LONG,14912.0,14676.12,15619.65,14676.12,1.264,4.53,1.61,6184.15,2,3.0,-2061.36
09/01/2019 04:00:00,15/06/2023 18:39:29,Gemini_BTCUSD_d_17_12_17_to_10_03_23.csv,BTC_USD,DAY,101004.76,46.87,14/01/2019 04:00:00,15/01/2019 04:00:00,10/01/2019 04:00:00,STOP_LOSS_HIT,LONG,4013.0,3969.9,4142.3,3969.9,1.862,3.12,1.09,6060.29,2,3.0,-2020.1
05/09/2019 04:00:00,15/06/2023 18:39:29,Gemini_BTCUSD_d_17_12_17_to_10_03_23.csv,BTC_USD,DAY,98984.66,17.379,12/09/2019 04:00:00,11/09/2019 04:00:00,06/09/2019 04:00:00,STOP_LOSS_HIT,SHORT,10664.0,10777.91,10322.26,10777.91,1.872,3.31,1.06,5939.1,2,3.0,-1979.64
01/01/2021 04:00:00,15/06/2023 18:39:29,Gemini_BTCUSD_d_17_12_17_to_10_03_23.csv,BTC_USD,DAY,97005.02,2.18,08/01/2021 04:00:00,07/01/2021 04:00:00,02/01/2021 04:00:00,TAKE_PROFIT_HIT,LONG,29441.0,32111.08,32111.08,28550.97,0.662,8.32,3.12,5820.77,2,3.0,5820.77
13/12/2020 04:00:00,15/06/2023 18:39:29,Gemini_BTCUSD_d_17_12_17_to_10_03_23.csv,BTC_USD,DAY,102825.79,4.773,20/12/2020 04:00:00,19/12/2020 04:00:00,16/12/2020 04:00:00,TAKE_PROFIT_HIT,LONG,19268.0,20560.68,20560.68,18837.11,0.894,6.29,2.29,6169.96,2,3.0,6169.96
29/10/2022 04:00:00,15/06/2023 18:39:29,Gemini_BTCUSD_d_17_12_17_to_10_03_23.csv,BTC_USD,DAY,108995.75,5.504,05/11/2022 04:00:00,01/11/2022 04:00:00,31/10/2022 00:00:00,STOP_LOSS_HIT,LONG,20783.0,20386.94,21971.18,20386.94,1.049,5.41,1.94,6539.74,2,3.0,-2179.91
29/01/2022 13:00:00,15/06/2023 18:39:29,Gemini_BTCUSD_d_17_12_17_to_10_03_23.csv,BTC_USD,DAY,106815.84,2.776,05/02/2022 13:00:00,01/02/2022 13:00:00,30/01/2022 04:00:00,STOP_LOSS_HIT,LONG,37961.0,37191.36,40269.94,37191.36,0.987,5.73,2.07,6409.62,2,3.0,-2136.52
31/01/2020 04:00:00,15/06/2023 18:39:29,Gemini_BTCUSD_d_17_12_17_to_10_03_23.csv,BTC_USD,DAY,104679.32,20.586,07/02/2020 04:00:00,06/02/2020 04:00:00,01/02/2020 04:00:00,STOP_LOSS_HIT,LONG,9417.0,9315.3,9722.11,9315.3,1.852,3.14,1.09,6280.99,2,3.0,-2093.6
06/09/2021 04:00:00,15/06/2023 18:39:29,Gemini_BTCUSD_d_17_12_17_to_10_03_23.csv,BTC_USD,DAY,102585.72,2.676,07/09/2021 04:00:00,12/09/2021 04:00:00,07/09/2021 04:00:00,STOP_LOSS_HIT,LONG,52663.0,51896.35,54962.96,51896.35,1.374,4.18,1.48,6154.69,2,3.0,-2051.56
08/07/2019 04:00:00,15/06/2023 18:39:29,Gemini_BTCUSD_d_17_12_17_to_10_03_23.csv,BTC_USD,DAY,100534.16,13.262,10/07/2019 04:00:00,14/07/2019 04:00:00,09/07/2019 04:00:00,STOP_LOSS_HIT,LONG,12680.0,12528.39,13134.83,12528.39,1.673,3.46,1.21,6031.96,2,3.0,-2010.65
17/12/2020 04:00:00,15/06/2023 18:39:29,Gemini_BTCUSD_d_17_12_17_to_10_03_23.csv,BTC_USD,DAY,98523.51,3.831,20/12/2020 04:00:00,23/12/2020 04:00:00,21/12/2020 04:00:00,STOP_LOSS_HIT,LONG,22840.0,22325.64,24383.1,22325.64,0.888,6.33,2.3,5911.62,2,3.0,-1970.51
31/05/2022 04:00:00,15/06/2023 18:39:29,Gemini_BTCUSD_d_17_12_17_to_10_03_23.csv,BTC_USD,DAY,96553.0,3.092,04/06/2022 04:00:00,03/06/2022 04:00:00,01/06/2022 04:00:00,STOP_LOSS_HIT,LONG,31598.0,30973.49,33471.54,30973.49,1.012,5.6,2.02,5792.99,2,3.0,-1930.98
31/03/2020 04:00:00,15/06/2023 18:39:29,Gemini_BTCUSD_d_17_12_17_to_10_03_23.csv,BTC_USD,DAY,94622.02,19.214,07/04/2020 04:00:00,06/04/2020 04:00:00,01/04/2020 04:00:00,STOP_LOSS_HIT,LONG,6384.0,6285.51,6679.47,6285.51,1.296,4.42,1.57,5677.16,2,3.0,-1892.39
13/01/2021 04:00:00,15/06/2023 18:39:29,Gemini_BTCUSD_d_17_12_17_to_10_03_23.csv,BTC_USD,DAY,92729.63,5.728,15/01/2021 04:00:00,19/01/2021 04:00:00,14/01/2021 04:00:00,TAKE_PROFIT_HIT,LONG,37041.0,38012.25,38012.25,36717.25,2.288,2.56,0.88,5563.32,2,3.0,5563.32
27/07/2022 04:00:00,15/06/2023 18:39:29,Gemini_BTCUSD_d_17_12_17_to_10_03_23.csv,BTC_USD,DAY,98292.95,7.791,30/07/2022 04:00:00,30/07/2022 04:00:00,28/07/2022 00:00:00,STOP_LOSS_HIT,LONG,23126.0,22873.66,23883.02,22873.66,1.833,3.17,1.1,5897.94,2,3.0,-1965.98
04/02/2020 04:00:00,15/06/2023 18:39:29,Gemini_BTCUSD_d_17_12_17_to_10_03_23.csv,BTC_USD,DAY,96326.97,7.641,11/02/2020 04:00:00,10/02/2020 04:00:00,08/02/2020 04:00:00,TAKE_PROFIT_HIT,LONG,9208.0,9964.39,9964.39,8955.87,0.73,7.59,2.82,5779.58,2,3.0,5779.58
04/12/2018 04:00:00,15/06/2023 18:39:29,Gemini_BTCUSD_d_17_12_17_to_10_03_23.csv,BTC_USD,DAY,102106.55,60.364,07/12/2018 04:00:00,10/12/2018 04:00:00,05/12/2018 04:00:00,STOP_LOSS_HIT,SHORT,3835.0,3868.83,3733.51,3868.83,2.267,2.72,0.87,6126.34,2,3.0,-2042.11
21/06/2019 04:00:00,15/06/2023 18:39:29,Gemini_BTCUSD_d_17_12_17_to_10_03_23.csv,BTC_USD,DAY,100064.44,9.156,27/06/2019 04:00:00,27/06/2019 04:00:00,22/06/2019 04:00:00,STOP_LOSS_HIT,LONG,10591.0,10372.43,11246.71,10372.43,0.969,5.83,2.11,6003.68,2,3.0,-2001.23
30/06/2019 04:00:00,15/06/2023 18:39:29,Gemini_BTCUSD_d_17_12_17_to_10_03_23.csv,BTC_USD,DAY,98063.21,15.602,02/07/2019 04:00:00,06/07/2019 04:00:00,01/07/2019 04:00:00,TAKE_PROFIT_HIT,SHORT,11077.0,10699.86,10699.86,11202.71,1.762,3.52,1.12,5884.14,2,3.0,5884.14
07/01/2023 00:00:00,15/06/2023 18:39:29,Gemini_BTCUSD_d_17_12_17_to_10_03_23.csv,BTC_USD,DAY,103947.35,3.901,14/01/2023 00:00:00,13/01/2023 00:00:00,12/01/2023 00:00:00,TAKE_PROFIT_HIT,LONG,16947.0,18545.68,18545.68,16414.11,0.636,8.62,3.25,6236.45,2,3.0,6236.45
10/08/2022 00:00:00,15/06/2023 18:39:29,Gemini_BTCUSD_d_17_12_17_to_10_03_23.csv,BTC_USD,DAY,110183.8,8.771,14/08/2022 00:00:00,13/08/2022 00:00:00,10/08/2022 04:00:00,STOP_LOSS_HIT,LONG,23963.0,23711.75,24716.77,23711.75,1.908,3.05,1.06,6611.32,2,3.0,-2203.71
01/12/2021 04:00:00,15/06/2023 18:39:29,Gemini_BTCUSD_d_17_12_17_to_10_03_23.csv,BTC_USD,DAY,107980.09,2.94,05/12/2021 04:00:00,07/12/2021 04:00:00,02/12/2021 04:00:00,STOP_LOSS_HIT,SHORT,56362.0,57096.58,54158.28,57096.58,1.535,4.07,1.29,6478.94,2,3.0,-2159.67
21/06/2022 13:00:00,15/06/2023 18:39:29,Gemini_BTCUSD_d_17_12_17_to_10_03_23.csv,BTC_USD,DAY,105820.42,12.623,28/06/2022 13:00:00,24/06/2022 13:00:00,22/06/2022 04:00:00,STOP_LOSS_HIT,LONG,20365.0,20197.34,20867.97,20197.34,2.429,2.41,0.83,6348.99,2,3.0,-2116.37
05/07/2019 04:00:00,15/06/2023 18:39:29,Gemini_BTCUSD_d_17_12_17_to_10_03_23.csv,BTC_USD,DAY,103704.05,12.336,10/07/2019 04:00:00,11/07/2019 04:00:00,06/07/2019 04:00:00,STOP_LOSS_HIT,LONG,11520.0,11351.87,12024.4,11351.87,1.37,4.19,1.48,6222.28,2,3.0,-2074.05
28/06/2019 04:00:00,15/06/2023 18:39:29,Gemini_BTCUSD_d_17_12_17_to_10_03_23.csv,BTC_USD,DAY,101630.0,13.85,04/07/2019 04:00:00,04/07/2019 04:00:00,29/06/2019 04:00:00,TAKE_PROFIT_HIT,LONG,11462.0,11902.28,11902.28,11315.24,1.562,3.7,1.3,6097.88,2,3.0,6097.88
11/04/2021 04:00:00,15/06/2023 18:39:29,Gemini_BTCUSD_d_17_12_17_to_10_03_23.csv,BTC_USD,DAY,107727.88,1.787,17/04/2021 04:00:00,17/04/2021 04:00:00,14/04/2021 04:00:00,TAKE_PROFIT_HIT,LONG,60326.0,63942.08,63942.08,59120.64,1.001,5.66,2.04,6461.93,2,3.0,6461.93
30/08/2020 04:00:00,15/06/2023 18:39:29,Gemini_BTCUSD_d_17_12_17_to_10_03_23.csv,BTC_USD,DAY,114189.81,22.487,06/09/2020 04:00:00,05/09/2020 04:00:00,01/09/2020 04:00:00,STOP_LOSS_HIT,SHORT,11684.0,11785.56,11379.33,11785.56,2.301,2.68,0.86,6851.11,2,3.0,-2283.78
09/08/2019 04:00:00,15/06/2023 18:39:29,Gemini_BTCUSD_d_17_12_17_to_10_03_23.csv,BTC_USD,DAY,111906.03,17.788,14/08/2019 04:00:00,15/08/2019 04:00:00,10/08/2019 04:00:00,TAKE_PROFIT_HIT,SHORT,11832.0,11454.54,11454.54,11957.82,1.881,3.3,1.05,6714.26,2,3.0,6714.26
17/03/2023 00:00:00,15/06/2023 18:39:29,Gemini_BTCUSD_d_17_12_17_to_10_03_23.csv,BTC_USD,DAY,118620.29,6.494,18/03/2023 00:00:00,23/03/2023 00:00:00,18/03/2023 00:00:00,STOP_LOSS_HIT,LONG,27451.0,27085.65,28547.06,27085.65,1.503,3.84,1.35,7117.81,2,3.0,-2372.58
17/03/2022 04:00:00,15/06/2023 18:39:29,Gemini_BTCUSD_d_17_12_17_to_10_03_23.csv,BTC_USD,DAY,116247.71,2.977,21/03/2022 04:00:00,20/03/2022 04:00:00,20/03/2022 04:00:00,EXPIRED,LONG,40556.0,40861.0,42898.83,39775.06,1.039,5.46,1.96,6974.6,2,3.0,907.99
03/02/2021 04:00:00,15/06/2023 18:39:29,Gemini_BTCUSD_d_17_12_17_to_10_03_23.csv,BTC_USD,DAY,117155.7,3.478,09/02/2021 04:00:00,09/02/2021 04:00:00,04/02/2021 04:00:00,STOP_LOSS_HIT,LONG,37552.0,36878.4,39572.82,36878.4,1.115,5.11,1.83,7028.41,2,3.0,-2342.78
06/09/2019 04:00:00,15/06/2023 18:39:29,Gemini_BTCUSD_d_17_12_17_to_10_03_23.csv,BTC_USD,DAY,114812.92,14.902,12/09/2019 04:00:00,12/09/2019 04:00:00,07/09/2019 04:00:00,STOP_LOSS_HIT,SHORT,10346.0,10500.09,9883.74,10500.09,1.343,4.68,1.47,6888.6,2,3.0,-2296.25
01/03/2022 13:00:00,15/06/2023 18:39:29,Gemini_BTCUSD_d_17_12_17_to_10_03_23.csv,BTC_USD,DAY,112516.67,3.356,06/03/2022 13:00:00,04/03/2022 13:00:00,02/03/2022 04:00:00,STOP_LOSS_HIT,LONG,44035.0,43364.44,46046.68,43364.44,1.313,4.37,1.55,6751.2,2,3.0,-2250.4
04/07/2019 04:00:00,15/06/2023 18:39:29,Gemini_BTCUSD_d_17_12_17_to_10_03_23.csv,BTC_USD,DAY,110266.27,21.446,10/07/2019 04:00:00,10/07/2019 04:00:00,05/07/2019 04:00:00,STOP_LOSS_HIT,LONG,11134.0,11031.17,11442.49,11031.17,2.165,2.7,0.93,6615.88,2,3.0,-2205.29
09/07/2020 04:00:00,15/06/2023 18:39:29,Gemini_BTCUSD_d_17_12_17_to_10_03_23.csv,BTC_USD,DAY,108060.98,33.168,10/07/2020 04:00:00,15/07/2020 04:00:00,10/07/2020 04:00:00,STOP_LOSS_HIT,LONG,9219.0,9153.84,9414.47,9153.84,2.83,2.08,0.71,6483.35,2,3.0,-2161.23
13/03/2021 04:00:00,15/06/2023 18:39:29,Gemini_BTCUSD_d_17_12_17_to_10_03_23.csv,BTC_USD,DAY,105899.75,2.426,15/03/2021 04:00:00,19/03/2021 04:00:00,14/03/2021 04:00:00,STOP_LOSS_HIT,LONG,61355.0,60482.11,63973.68,60482.11,1.406,4.09,1.44,6352.92,2,3.0,-2117.63
16/04/2021 04:00:00,15/06/2023 18:39:29,Gemini_BTCUSD_d_17_12_17_to_10_03_23.csv,BTC_USD,DAY,103782.12,2.964,20/04/2021 04:00:00,22/04/2021 04:00:00,17/04/2021 04:00:00,TAKE_PROFIT_HIT,SHORT,62450.0,60349.26,60349.26,63150.25,1.784,3.48,1.11,6226.59,2,3.0,6226.59
23/11/2022 00:00:00,15/06/2023 18:39:29,Gemini_BTCUSD_d_17_12_17_to_10_03_23.csv,BTC_USD,DAY,110008.71,9.174,26/11/2022 00:00:00,26/11/2022 00:00:00,23/11/2022 04:00:00,STOP_LOSS_HIT,LONG,16600.0,16360.17,17319.5,16360.17,1.384,4.15,1.47,6600.69,2,3.0,-2200.2
10/12/2022 00:00:00,15/06/2023 18:39:29,Gemini_BTCUSD_d_17_12_17_to_10_03_23.csv,BTC_USD,DAY,107808.51,20.195,14/12/2022 00:00:00,13/12/2022 00:00:00,11/12/2022 00:00:00,STOP_LOSS_HIT,SHORT,17140.0,17246.77,16819.68,17246.77,3.211,1.9,0.62,6468.86,2,3.0,-2156.22
18/10/2020 04:00:00,15/06/2023 18:39:29,Gemini_BTCUSD_d_17_12_17_to_10_03_23.csv,BTC_USD,DAY,105652.29,8.816,25/10/2020 04:00:00,24/10/2020 04:00:00,20/10/2020 04:00:00,TAKE_PROFIT_HIT,LONG,11426.0,12145.06,12145.06,11186.31,0.953,5.92,2.14,6339.23,2,3.0,6339.23
13/05/2021 04:00:00,15/06/2023 18:39:29,Gemini_BTCUSD_d_17_12_17_to_10_03_23.csv,BTC_USD,DAY,111991.52,4.246,20/05/2021 04:00:00,19/05/2021 04:00:00,14/05/2021 04:00:00,STOP_LOSS_HIT,SHORT,49221.0,49748.46,47638.64,49748.46,1.866,3.32,1.06,6718.7,2,3.0,-2239.6
22/02/2021 04:00:00,15/06/2023 18:39:29,Gemini_BTCUSD_d_17_12_17_to_10_03_23.csv,BTC_USD,DAY,109751.92,3.228,28/02/2021 04:00:00,28/02/2021 04:00:00,23/02/2021 04:00:00,TAKE_PROFIT_HIT,SHORT,51847.0,49807.19,49807.19,52526.94,1.525,4.1,1.29,6584.51,2,3.0,6584.51
03/04/2020 04:00:00,15/06/2023 18:39:29,Gemini_BTCUSD_d_17_12_17_to_10_03_23.csv,BTC_USD,DAY,116336.43,21.923,07/04/2020 04:00:00,09/04/2020 04:00:00,06/04/2020 04:00:00,TAKE_PROFIT_HIT,LONG,6703.0,7021.39,7021.39,6596.87,1.263,4.53,1.61,6980.06,2,3.0,6980.06
04/11/2020 04:00:00,15/06/2023 18:39:29,Gemini_BTCUSD_d_17_12_17_to_10_03_23.csv,BTC_USD,DAY,123316.49,9.925,11/11/2020 04:00:00,10/11/2020 04:00:00,05/11/2020 04:00:00,TAKE_PROFIT_HIT,LONG,14336.0,15081.5,15081.5,14087.5,1.154,4.94,1.76,7399.09,2,3.0,7399.09
15/01/2021 04:00:00,15/06/2023 18:39:29,Gemini_BTCUSD_d_17_12_17_to_10_03_23.csv,BTC_USD,DAY,130715.58,4.247,22/01/2021 04:00:00,21/01/2021 04:00:00,16/01/2021 04:00:00,STOP_LOSS_HIT,SHORT,36549.0,37164.6,34702.22,37164.6,1.187,5.32,1.66,7843.27,2,3.0,-2614.45
09/12/2022 00:00:00,15/06/2023 18:39:29,Gemini_BTCUSD_d_17_12_17_to_10_03_23.csv,BTC_USD,DAY,128101.13,10.314,12/12/2022 00:00:00,12/12/2022 00:00:00,11/12/2022 04:00:00,STOP_LOSS_HIT,LONG,17134.0,16885.61,17879.17,16885.61,1.38,4.17,1.47,7685.68,2,3.0,-2561.89
02/09/2020 04:00:00,15/06/2023 18:39:29,Gemini_BTCUSD_d_17_12_17_to_10_03_23.csv,BTC_USD,DAY,125539.24,26.0,04/09/2020 04:00:00,08/09/2020 04:00:00,03/09/2020 04:00:00,STOP_LOSS_HIT,SHORT,11372.0,11468.57,11082.29,11468.57,2.355,2.61,0.84,7532.46,2,3.0,-2510.82
21/05/2018 04:00:00,15/06/2023 18:39:29,Gemini_BTCUSD_d_17_12_17_to_10_03_23.csv,BTC_USD,DAY,123028.42,25.682,27/05/2018 04:00:00,27/05/2018 04:00:00,22/05/2018 04:00:00,TAKE_PROFIT_HIT,SHORT,8330.0,8042.58,8042.58,8425.81,1.739,3.57,1.14,7381.52,2,3.0,7381.52
08/03/2021 04:00:00,15/06/2023 18:39:29,Gemini_BTCUSD_d_17_12_17_to_10_03_23.csv,BTC_USD,DAY,130409.94,2.708,14/03/2021 04:00:00,14/03/2021 04:00:00,10/03/2021 04:00:00,TAKE_PROFIT_HIT,LONG,53931.0,56820.66,56820.66,52967.78,1.12,5.09,1.82,7825.2,2,3.0,7825.2
23/10/2020 04:00:00,15/06/2023 18:39:29,Gemini_BTCUSD_d_17_12_17_to_10_03_23.csv,BTC_USD,DAY,138235.14,21.608,27/10/2020 04:00:00,29/10/2020 04:00:00,26/10/2020 04:00:00,STOP_LOSS_HIT,LONG,12988.0,12860.05,13371.85,12860.05,2.03,2.87,0.99,8294.23,2,3.0,-2764.74
20/01/2022 13:00:00,15/06/2023 18:39:29,Gemini_BTCUSD_d_17_12_17_to_10_03_23.csv,BTC_USD,DAY,135470.4,9.373,27/01/2022 13:00:00,23/01/2022 13:00:00,21/01/2022 04:00:00,STOP_LOSS_HIT,SHORT,38189.0,38478.06,37321.82,38478.06,2.642,2.32,0.75,8128.08,2,3.0,-2709.36
15/11/2020 04:00:00,15/06/2023 18:39:29,Gemini_BTCUSD_d_17_12_17_to_10_03_23.csv,BTC_USD,DAY,132761.04,10.698,21/11/2020 04:00:00,21/11/2020 04:00:00,16/11/2020 04:00:00,TAKE_PROFIT_HIT,LONG,16022.0,16766.6,16766.6,15773.8,1.291,4.44,1.57,7965.73,2,3.0,7965.73
20/12/2018 04:00:00,15/06/2023 18:39:29,Gemini_BTCUSD_d_17_12_17_to_10_03_23.csv,BTC_USD,DAY,140726.77,57.675,24/12/2018 04:00:00,26/12/2018 04:00:00,21/12/2018 04:00:00,STOP_LOSS_HIT,LONG,4043.0,3994.2,4189.41,3994.2,1.657,3.49,1.22,8444.2,2,3.0,-2814.54
05/02/2022 04:00:00,15/06/2023 18:39:29,Gemini_BTCUSD_d_17_12_17_to_10_03_23.csv,BTC_USD,DAY,137912.23,2.732,09/02/2022 04:00:00,08/02/2022 04:00:00,07/02/2022 04:00:00,TAKE_PROFIT_HIT,LONG,41485.0,44513.74,44513.74,40475.42,0.822,6.8,2.49,8274.52,2,3.0,8274.52
10/07/2018 04:00:00,15/06/2023 18:39:29,Gemini_BTCUSD_d_17_12_17_to_10_03_23.csv,BTC_USD,DAY,146186.75,55.754,17/07/2018 04:00:00,16/07/2018 04:00:00,11/07/2018 04:00:00,STOP_LOSS_HIT,SHORT,6343.0,6395.44,6185.68,6395.44,2.419,2.54,0.82,8771.22,2,3.0,-2923.74
20/10/2020 04:00:00,15/06/2023 18:39:29,Gemini_BTCUSD_d_17_12_17_to_10_03_23.csv,BTC_USD,DAY,143263.01,13.713,27/10/2020 04:00:00,26/10/2020 04:00:00,21/10/2020 04:00:00,TAKE_PROFIT_HIT,LONG,12202.0,12828.86,12828.86,11993.05,1.168,4.89,1.74,8596.13,2,3.0,8596.13
17/03/2022 04:00:00,15/06/2023 18:39:29,Gemini_BTCUSD_d_17_12_17_to_10_03_23.csv,BTC_USD,DAY,151859.14,3.889,21/03/2022 04:00:00,20/03/2022 04:00:00,20/03/2022 04:00:00,EXPIRED,LONG,40556.0,40861.0,42898.83,39775.06,1.039,5.46,1.96,9111.27,2,3.0,1186.15
25/09/2018 04:00:00,15/06/2023 18:39:29,Gemini_BTCUSD_d_17_12_17_to_10_03_23.csv,BTC_USD,DAY,153045.29,58.336,02/10/2018 04:00:00,01/10/2018 04:00:00,27/09/2018 04:00:00,TAKE_PROFIT_HIT,LONG,6384.0,6541.42,6541.42,6331.53,2.433,2.41,0.83,9183.25,2,3.0,9183.25
08/11/2018 04:00:00,15/06/2023 18:39:29,Gemini_BTCUSD_d_17_12_17_to_10_03_23.csv,BTC_USD,DAY,162228.54,37.544,15/11/2018 04:00:00,14/11/2018 04:00:00,14/11/2018 04:00:00,TAKE_PROFIT_HIT,SHORT,6399.0,6139.73,6139.73,6485.42,1.481,4.22,1.33,9734.03,2,3.0,9734.03
19/07/2022 04:00:00,15/06/2023 18:39:29,Gemini_BTCUSD_d_17_12_17_to_10_03_23.csv,BTC_USD,DAY,171962.57,5.897,25/07/2022 04:00:00,22/07/2022 04:00:00,20/07/2022 04:00:00,STOP_LOSS_HIT,LONG,23448.0,22864.82,25197.55,22864.82,0.804,6.94,2.55,10317.1,2,3.0,-3439.01
05/10/2022 00:00:00,15/06/2023 18:39:29,Gemini_BTCUSD_d_17_12_17_to_10_03_23.csv,BTC_USD,DAY,168523.56,8.901,09/10/2022 00:00:00,08/10/2022 00:00:00,05/10/2022 04:00:00,STOP_LOSS_HIT,LONG,20166.0,19787.35,21301.96,19787.35,1.065,5.33,1.91,10111.18,2,3.0,-3370.36
13/04/2021 04:00:00,15/06/2023 18:39:29,Gemini_BTCUSD_d_17_12_17_to_10_03_23.csv,BTC_USD,DAY,165153.2,3.576,15/04/2021 04:00:00,19/04/2021 04:00:00,14/04/2021 04:00:00,STOP_LOSS_HIT,LONG,63773.0,62849.32,66544.04,62849.32,1.381,4.16,1.47,9909.24,2,3.0,-3303.08
20/01/2022 04:00:00,15/06/2023 18:39:29,Gemini_BTCUSD_d_17_12_17_to_10_03_23.csv,BTC_USD,DAY,161850.12,6.759,25/01/2022 04:00:00,23/01/2022 04:00:00,20/01/2022 13:00:00,STOP_LOSS_HIT,SHORT,38462.0,38940.92,37025.26,38940.92,1.606,3.88,1.23,9710.93,2,3.0,-3237.02
08/02/2022 13:00:00,15/06/2023 18:39:29,Gemini_BTCUSD_d_17_12_17_to_10_03_23.csv,BTC_USD,DAY,158613.1,9.608,14/02/2022 13:00:00,11/02/2022 13:00:00,09/02/2022 04:00:00,STOP_LOSS_HIT,SHORT,44159.0,44489.17,43168.48,44489.17,2.675,2.29,0.74,9516.92,2,3.0,-3172.27
07/02/2020 04:00:00,15/06/2023 18:39:29,Gemini_BTCUSD_d_17_12_17_to_10_03_23.csv,BTC_USD,DAY,155440.83,21.169,13/02/2020 04:00:00,13/02/2020 04:00:00,09/02/2020 04:00:00,TAKE_PROFIT_HIT,LONG,9709.0,10149.6,10149.6,9562.14,1.322,4.34,1.54,9327.06,2,3.0,9327.06
10/11/2020 04:00:00,15/06/2023 18:39:29,Gemini_BTCUSD_d_17_12_17_to_10_03_23.csv,BTC_USD,DAY,164767.89,14.377,17/11/2020 04:00:00,16/11/2020 04:00:00,12/11/2020 04:00:00,TAKE_PROFIT_HIT,LONG,15421.0,16108.63,16108.63,15191.79,1.346,4.27,1.51,9886.06,2,3.0,9886.06
21/12/2020 04:00:00,15/06/2023 18:39:29,Gemini_BTCUSD_d_17_12_17_to_10_03_23.csv,BTC_USD,DAY,174653.95,8.657,28/12/2020 04:00:00,27/12/2020 04:00:00,22/12/2020 04:00:00,STOP_LOSS_HIT,LONG,22859.0,22455.49,24069.52,22455.49,1.133,5.03,1.8,10479.47,2,3.0,-3493.19
06/06/2018 04:00:00,15/06/2023 18:39:29,Gemini_BTCUSD_d_17_12_17_to_10_03_23.csv,BTC_USD,DAY,171160.76,40.622,13/06/2018 04:00:00,12/06/2018 04:00:00,09/06/2018 04:00:00,TAKE_PROFIT_HIT,SHORT,7730.0,7477.19,7477.19,7814.27,1.835,3.38,1.08,10269.65,2,3.0,10269.65
28/10/2020 04:00:00,15/06/2023 18:39:29,Gemini_BTCUSD_d_17_12_17_to_10_03_23.csv,BTC_USD,DAY,181430.41,17.745,04/11/2020 04:00:00,03/11/2020 04:00:00,29/10/2020 04:00:00,STOP_LOSS_HIT,LONG,13294.0,13089.51,13907.48,13089.51,1.3,4.41,1.56,10886.2,2,3.0,-3628.68
10/08/2020 04:00:00,15/06/2023 18:39:29,Gemini_BTCUSD_d_17_12_17_to_10_03_23.csv,BTC_USD,DAY,177801.73,32.38,14/08/2020 04:00:00,16/08/2020 04:00:00,11/08/2020 04:00:00,STOP_LOSS_HIT,LONG,11840.0,11730.18,12169.45,11730.18,2.156,2.71,0.94,10667.59,2,3.0,-3555.97
11/06/2022 04:00:00,15/06/2023 18:39:29,Gemini_BTCUSD_d_17_12_17_to_10_03_23.csv,BTC_USD,DAY,174245.76,4.875,18/06/2022 04:00:00,14/06/2022 04:00:00,11/06/2022 13:00:00,STOP_LOSS_HIT,SHORT,27528.0,28242.85,25383.46,28242.85,0.77,8.45,2.53,10454.63,2,3.0,-3484.89
01/12/2022 04:00:00,15/06/2023 18:39:29,Gemini_BTCUSD_d_17_12_17_to_10_03_23.csv,BTC_USD,DAY,170760.87,13.789,03/12/2022 04:00:00,04/12/2022 04:00:00,04/12/2022 04:00:00,EXPIRED,LONG,16916.0,17202.0,17659.04,16668.32,1.366,4.21,1.49,10245.78,2,3.0,3943.65
03/01/2018 04:00:00,15/06/2023 18:39:29,Gemini_BTCUSD_d_17_12_17_to_10_03_23.csv,BTC_USD,DAY,174704.52,24.625,07/01/2018 04:00:00,09/01/2018 04:00:00,04/01/2018 04:00:00,STOP_LOSS_HIT,LONG,15100.0,14958.11,15525.66,14958.11,2.128,2.74,0.95,10481.88,2,3.0,-3494.04
04/06/2021 04:00:00,15/06/2023 18:39:29,Gemini_BTCUSD_d_17_12_17_to_10_03_23.csv,BTC_USD,DAY,171210.48,8.912,08/06/2021 04:00:00,10/06/2021 04:00:00,05/06/2021 04:00:00,STOP_LOSS_HIT,SHORT,37420.0,37804.21,36267.36,37804.21,1.948,3.18,1.02,10272.33,2,3.0,-3424.08
13/06/2021 04:00:00,15/06/2023 18:39:29,Gemini_BTCUSD_d_17_12_17_to_10_03_23.csv,BTC_USD,DAY,167786.4,13.796,15/06/2021 04:00:00,19/06/2021 04:00:00,14/06/2021 04:00:00,TAKE_PROFIT_HIT,LONG,38989.0,39718.68,39718.68,38745.77,3.206,1.84,0.63,10066.67,2,3.0,10066.67
18/05/2020 04:00:00,15/06/2023 18:39:29,Gemini_BTCUSD_d_17_12_17_to_10_03_23.csv,BTC_USD,DAY,177853.07,27.188,25/05/2020 04:00:00,24/05/2020 04:00:00,20/05/2020 04:00:00,STOP_LOSS_HIT,LONG,9518.0,9387.17,9910.48,9387.17,1.455,3.96,1.39,10670.75,2,3.0,-3557.01
24/10/2022 00:00:00,15/06/2023 18:39:29,Gemini_BTCUSD_d_17_12_17_to_10_03_23.csv,BTC_USD,DAY,174296.06,11.424,29/10/2022 00:00:00,27/10/2022 00:00:00,25/10/2022 00:00:00,TAKE_PROFIT_HIT,LONG,19334.0,20249.39,20249.39,19028.87,1.267,4.52,1.6,10457.42,2,3.0,10457.42
20/05/2018 04:00:00,15/06/2023 18:39:29,Gemini_BTCUSD_d_17_12_17_to_10_03_23.csv,BTC_USD,DAY,184753.48,69.443,27/05/2018 04:00:00,26/05/2018 04:00:00,21/05/2018 04:00:00,STOP_LOSS_HIT,SHORT,8491.0,8544.21,8331.37,8544.21,3.191,1.92,0.62,11085.19,2,3.0,-3695.06
12/03/2021 04:00:00,15/06/2023 18:39:29,Gemini_BTCUSD_d_17_12_17_to_10_03_23.csv,BTC_USD,DAY,181058.42,4.439,19/03/2021 04:00:00,18/03/2021 04:00:00,13/03/2021 04:00:00,TAKE_PROFIT_HIT,LONG,56706.0,59153.11,59153.11,55890.3,1.39,4.14,1.46,10862.72,2,3.0,10862.72
02/09/2018 04:00:00,15/06/2023 18:39:29,Gemini_BTCUSD_d_17_12_17_to_10_03_23.csv,BTC_USD,DAY,191921.14,58.061,06/09/2018 04:00:00,08/09/2018 04:00:00,03/09/2018 04:00:00,STOP_LOSS_HIT,SHORT,7250.0,7316.11,7051.68,7316.11,2.193,2.81,0.9,11514.66,2,3.0,-3838.41
11/01/2019 04:00:00,15/06/2023 18:39:29,Gemini_BTCUSD_d_17_12_17_to_10_03_23.csv,BTC_USD,DAY,188082.73,93.877,18/01/2019 04:00:00,17/01/2019 04:00:00,13/01/2019 04:00:00,TAKE_PROFIT_HIT,SHORT,3641.0,3520.78,3520.78,3681.07,1.817,3.41,1.09,11285.89,2,3.0,11285.89
30/03/2022 04:00:00,15/06/2023 18:39:29,Gemini_BTCUSD_d_17_12_17_to_10_03_23.csv,BTC_USD,DAY,199368.62,5.019,05/04/2022 04:00:00,02/04/2022 04:00:00,31/03/2022 04:00:00,STOP_LOSS_HIT,LONG,47108.0,46313.53,49491.43,46313.53,1.186,4.82,1.72,11962.44,2,3.0,-3987.44
11/01/2023 00:00:00,15/06/2023 18:39:29,Gemini_BTCUSD_d_17_12_17_to_10_03_23.csv,BTC_USD,DAY,195381.18,8.695,16/01/2023 00:00:00,17/01/2023 00:00:00,13/01/2023 00:00:00,TAKE_PROFIT_HIT,LONG,17949.0,19297.28,19297.28,17499.57,0.799,6.99,2.57,11723.29,2,3.0,11723.29
