Open,Last update,Platform,Symbol,Timeframe,Account balance at open,Size,Expected close,Expiry,Close,Status,Side,Opening price,Closing price,Take profit,Stop loss,Leverage,TP price %,SL price %,Expected profit,Risk %,R/R ratio,PnL,Fee %,Fee Amount,Order Type
03/03/2023 00:00:00,19/06/2023 16:06:14,Upscale-Upscale-DUMMY_Gemini_BTCUSD_1h_01_07_22_to_16_06_23.csv,BTC_USD,WEEK,200.0,0.007,21/04/2023 00:00:00,21/04/2023 00:00:00,10/03/2023 00:00:00,STOP_LOSS_HIT,SHORT,20290.0,20826.59,18680.22,20826.59,0.71,8.62,2.58,11.16,2,3.1,-3.86,0.075,0.1065225,TAKER
03/03/2023 00:00:00,19/06/2023 16:06:14,Upscale-Upscale-DUMMY_Gemini_BTCUSD_1h_01_07_22_to_16_06_23.csv,BTC_USD,WEEK,196.14,0.007,21/04/2023 00:00:00,21/04/2023 00:00:00,10/03/2023 00:00:00,STOP_LOSS_HIT,SHORT,20290.0,20826.59,18680.22,20826.59,0.724,8.62,2.58,11.16,2,3.1,-3.86,0.075,0.1065225,TAKER
03/03/2023 00:00:00,19/06/2023 16:06:14,Upscale-Upscale-DUMMY_Gemini_BTCUSD_1h_01_07_22_to_16_06_23.csv,BTC_USD,WEEK,192.28,0.007,21/04/2023 00:00:00,21/04/2023 00:00:00,10/03/2023 00:00:00,STOP_LOSS_HIT,SHORT,20290.0,20826.59,18680.22,20826.59,0.739,8.62,2.58,11.16,2,3.1,-3.86,0.075,0.1065225,TAKER
20/01/2023 00:00:00,19/06/2023 16:06:14,Upscale-Upscale-DUMMY_Gemini_BTCUSD_1h_01_07_22_to_16_06_23.csv,BTC_USD,WEEK,188.42,0.002,17/03/2023 00:00:00,10/03/2023 00:00:00,10/02/2023 00:00:00,STOP_LOSS_HIT,LONG,23013.0,21483.15,27602.55,21483.15,0.244,16.63,7.12,9.14,2,3.0,-3.09,0.075,0.0345195,TAKER
24/02/2023 00:00:00,19/06/2023 16:06:14,Upscale-Upscale-DUMMY_Gemini_BTCUSD_1h_01_07_22_to_16_06_23.csv,BTC_USD,WEEK,185.33,0.004,21/04/2023 00:00:00,14/04/2023 00:00:00,03/03/2023 00:00:00,TAKE_PROFIT_HIT,SHORT,23468.0,20996.18,20996.18,24291.94,0.507,11.77,3.39,9.82,2,3.0,9.82,0.075,0.070404,TAKER
03/03/2023 00:00:00,19/06/2023 16:06:14,Upscale-Upscale-DUMMY_Gemini_BTCUSD_1h_01_07_22_to_16_06_23.csv,BTC_USD,WEEK,195.15,0.007,21/04/2023 00:00:00,21/04/2023 00:00:00,10/03/2023 00:00:00,STOP_LOSS_HIT,SHORT,20290.0,20826.59,18680.22,20826.59,0.728,8.62,2.58,11.16,2,3.1,-3.86,0.075,0.1065225,TAKER
24/02/2023 00:00:00,19/06/2023 16:06:14,Upscale-Upscale-DUMMY_Gemini_BTCUSD_1h_01_07_22_to_16_06_23.csv,BTC_USD,WEEK,191.29,0.005,21/04/2023 00:00:00,14/04/2023 00:00:00,03/03/2023 00:00:00,TAKE_PROFIT_HIT,SHORT,23468.0,20996.18,20996.18,24291.94,0.613,11.77,3.39,12.27,2,3.0,12.27,0.075,0.088005,TAKER
24/03/2023 00:00:00,19/06/2023 16:06:14,Upscale-Upscale-DUMMY_Gemini_BTCUSD_1h_01_07_22_to_16_06_23.csv,BTC_USD,WEEK,203.56,0.001,19/05/2023 00:00:00,12/05/2023 00:00:00,12/05/2023 00:00:00,EXPIRED,LONG,27941.0,26831.0,39981.24,23927.59,0.137,30.11,16.77,12.02,2,3.0,-1.13,0.075,0.02095575,TAKER
24/03/2023 00:00:00,19/06/2023 16:06:14,Upscale-Upscale-DUMMY_Gemini_BTCUSD_1h_01_07_22_to_16_06_23.csv,BTC_USD,WEEK,202.43,0.001,19/05/2023 00:00:00,12/05/2023 00:00:00,12/05/2023 00:00:00,EXPIRED,LONG,27941.0,26831.0,39981.24,23927.59,0.138,30.11,16.77,12.02,2,3.0,-1.13,0.075,0.02095575,TAKER
27/01/2023 00:00:00,19/06/2023 16:06:14,Upscale-Upscale-DUMMY_Gemini_BTCUSD_1h_01_07_22_to_16_06_23.csv,BTC_USD,WEEK,201.3,0.001,24/03/2023 00:00:00,17/03/2023 00:00:00,03/03/2023 00:00:00,STOP_LOSS_HIT,LONG,23487.0,19907.36,34225.92,19907.36,0.117,31.38,17.98,10.72,2,3.0,-3.6,0.075,0.01761525,TAKER
03/03/2023 00:00:00,19/06/2023 16:06:14,Upscale-Upscale-DUMMY_Gemini_BTCUSD_1h_01_07_22_to_16_06_23.csv,BTC_USD,WEEK,197.7,0.007,21/04/2023 00:00:00,21/04/2023 00:00:00,10/03/2023 00:00:00,STOP_LOSS_HIT,SHORT,20290.0,20826.59,18680.22,20826.59,0.718,8.62,2.58,11.16,2,3.1,-3.86,0.075,0.1065225,TAKER
03/03/2023 00:00:00,19/06/2023 16:06:14,Upscale-Upscale-DUMMY_Gemini_BTCUSD_1h_01_07_22_to_16_06_23.csv,BTC_USD,WEEK,193.84,0.007,21/04/2023 00:00:00,21/04/2023 00:00:00,10/03/2023 00:00:00,STOP_LOSS_HIT,SHORT,20290.0,20826.59,18680.22,20826.59,0.733,8.62,2.58,11.16,2,3.1,-3.86,0.075,0.1065225,TAKER
24/03/2023 00:00:00,19/06/2023 16:06:14,Upscale-Upscale-DUMMY_Gemini_BTCUSD_1h_01_07_22_to_16_06_23.csv,BTC_USD,WEEK,189.98,0.001,19/05/2023 00:00:00,12/05/2023 00:00:00,12/05/2023 00:00:00,EXPIRED,LONG,27941.0,26831.0,39981.24,23927.59,0.147,30.11,16.77,12.02,2,3.0,-1.13,0.075,0.02095575,TAKER
24/03/2023 00:00:00,19/06/2023 16:06:14,Upscale-Upscale-DUMMY_Gemini_BTCUSD_1h_01_07_22_to_16_06_23.csv,BTC_USD,WEEK,188.85,0.001,19/05/2023 00:00:00,12/05/2023 00:00:00,12/05/2023 00:00:00,EXPIRED,LONG,27941.0,26831.0,39981.24,23927.59,0.148,30.11,16.77,12.02,2,3.0,-1.13,0.075,0.02095575,TAKER
24/03/2023 00:00:00,19/06/2023 16:06:14,Upscale-Upscale-DUMMY_Gemini_BTCUSD_1h_01_07_22_to_16_06_23.csv,BTC_USD,WEEK,187.72,0.001,19/05/2023 00:00:00,12/05/2023 00:00:00,12/05/2023 00:00:00,EXPIRED,LONG,27941.0,26831.0,39981.24,23927.59,0.149,30.11,16.77,12.02,2,3.0,-1.13,0.075,0.02095575,TAKER
27/01/2023 00:00:00,19/06/2023 16:06:14,Upscale-Upscale-DUMMY_Gemini_BTCUSD_1h_01_07_22_to_16_06_23.csv,BTC_USD,WEEK,186.59,0.001,24/03/2023 00:00:00,17/03/2023 00:00:00,03/03/2023 00:00:00,STOP_LOSS_HIT,LONG,23487.0,19907.36,34225.92,19907.36,0.126,31.38,17.98,10.72,2,3.0,-3.6,0.075,0.01761525,TAKER
24/02/2023 00:00:00,19/06/2023 16:06:14,Upscale-Upscale-DUMMY_Gemini_BTCUSD_1h_01_07_22_to_16_06_23.csv,BTC_USD,WEEK,182.99,0.004,21/04/2023 00:00:00,14/04/2023 00:00:00,03/03/2023 00:00:00,TAKE_PROFIT_HIT,SHORT,23468.0,20996.18,20996.18,24291.94,0.513,11.77,3.39,9.82,2,3.0,9.82,0.075,0.070404,TAKER
24/02/2023 00:00:00,19/06/2023 16:06:14,Upscale-Upscale-DUMMY_Gemini_BTCUSD_1h_01_07_22_to_16_06_23.csv,BTC_USD,WEEK,192.81,0.005,21/04/2023 00:00:00,14/04/2023 00:00:00,03/03/2023 00:00:00,TAKE_PROFIT_HIT,SHORT,23468.0,20996.18,20996.18,24291.94,0.609,11.77,3.39,12.27,2,3.0,12.27,0.075,0.088005,TAKER
24/03/2023 00:00:00,19/06/2023 16:06:14,Upscale-Upscale-DUMMY_Gemini_BTCUSD_1h_01_07_22_to_16_06_23.csv,BTC_USD,WEEK,205.08,0.001,19/05/2023 00:00:00,12/05/2023 00:00:00,12/05/2023 00:00:00,EXPIRED,LONG,27941.0,26831.0,39981.24,23927.59,0.136,30.11,16.77,12.02,2,3.0,-1.13,0.075,0.02095575,TAKER
17/02/2023 00:00:00,19/06/2023 16:06:14,Upscale-Upscale-DUMMY_Gemini_BTCUSD_1h_01_07_22_to_16_06_23.csv,BTC_USD,WEEK,203.95,0.008,31/03/2023 00:00:00,07/04/2023 00:00:00,03/03/2023 00:00:00,TAKE_PROFIT_HIT,SHORT,23948.0,22334.58,22334.58,24485.81,0.939,7.22,2.2,12.76,2,3.1,12.76,0.075,0.143688,TAKER
17/02/2023 00:00:00,19/06/2023 16:06:14,Upscale-Upscale-DUMMY_Gemini_BTCUSD_1h_01_07_22_to_16_06_23.csv,BTC_USD,WEEK,216.71,0.008,31/03/2023 00:00:00,07/04/2023 00:00:00,03/03/2023 00:00:00,TAKE_PROFIT_HIT,SHORT,23948.0,22334.58,22334.58,24485.81,0.884,7.22,2.2,12.76,2,3.1,12.76,0.075,0.143688,TAKER
24/03/2023 00:00:00,19/06/2023 16:06:14,Upscale-Upscale-DUMMY_Gemini_BTCUSD_1h_01_07_22_to_16_06_23.csv,BTC_USD,WEEK,229.47,0.001,19/05/2023 00:00:00,12/05/2023 00:00:00,12/05/2023 00:00:00,EXPIRED,LONG,27941.0,26831.0,39981.24,23927.59,0.122,30.11,16.77,12.02,2,3.0,-1.13,0.075,0.02095575,TAKER
27/01/2023 00:00:00,19/06/2023 16:06:14,Upscale-Upscale-DUMMY_Gemini_BTCUSD_1h_01_07_22_to_16_06_23.csv,BTC_USD,WEEK,228.34,0.001,24/03/2023 00:00:00,17/03/2023 00:00:00,03/03/2023 00:00:00,STOP_LOSS_HIT,LONG,23487.0,19907.36,34225.92,19907.36,0.103,31.38,17.98,10.72,2,3.0,-3.6,0.075,0.01761525,TAKER
17/02/2023 00:00:00,19/06/2023 16:06:14,Upscale-Upscale-DUMMY_Gemini_BTCUSD_1h_01_07_22_to_16_06_23.csv,BTC_USD,WEEK,224.74,0.008,31/03/2023 00:00:00,07/04/2023 00:00:00,03/03/2023 00:00:00,TAKE_PROFIT_HIT,SHORT,23948.0,22334.58,22334.58,24485.81,0.852,7.22,2.2,12.76,2,3.1,12.76,0.075,0.143688,TAKER
24/03/2023 00:00:00,19/06/2023 16:06:14,Upscale-Upscale-DUMMY_Gemini_BTCUSD_1h_01_07_22_to_16_06_23.csv,BTC_USD,WEEK,237.5,0.001,19/05/2023 00:00:00,12/05/2023 00:00:00,12/05/2023 00:00:00,EXPIRED,LONG,27941.0,26831.0,39981.24,23927.59,0.118,30.11,16.77,12.02,2,3.0,-1.13,0.075,0.02095575,TAKER
03/03/2023 00:00:00,19/06/2023 16:06:14,Upscale-Upscale-DUMMY_Gemini_BTCUSD_1h_01_07_22_to_16_06_23.csv,BTC_USD,WEEK,236.37,0.009,21/04/2023 00:00:00,21/04/2023 00:00:00,10/03/2023 00:00:00,STOP_LOSS_HIT,SHORT,20290.0,20826.59,18680.22,20826.59,0.773,8.62,2.58,14.35,2,3.1,-4.97,0.075,0.13695749999999998,TAKER
24/03/2023 00:00:00,19/06/2023 16:06:14,Upscale-Upscale-DUMMY_Gemini_BTCUSD_1h_01_07_22_to_16_06_23.csv,BTC_USD,WEEK,231.4,0.001,19/05/2023 00:00:00,12/05/2023 00:00:00,12/05/2023 00:00:00,EXPIRED,LONG,27941.0,26831.0,39981.24,23927.59,0.121,30.11,16.77,12.02,2,3.0,-1.13,0.075,0.02095575,TAKER
24/03/2023 00:00:00,19/06/2023 16:06:14,Upscale-Upscale-DUMMY_Gemini_BTCUSD_1h_01_07_22_to_16_06_23.csv,BTC_USD,WEEK,230.27,0.001,19/05/2023 00:00:00,12/05/2023 00:00:00,12/05/2023 00:00:00,EXPIRED,LONG,27941.0,26831.0,39981.24,23927.59,0.121,30.11,16.77,12.02,2,3.0,-1.13,0.075,0.02095575,TAKER
20/01/2023 00:00:00,19/06/2023 16:06:14,Upscale-Upscale-DUMMY_Gemini_BTCUSD_1h_01_07_22_to_16_06_23.csv,BTC_USD,WEEK,229.14,0.003,17/03/2023 00:00:00,10/03/2023 00:00:00,10/02/2023 00:00:00,STOP_LOSS_HIT,LONG,23013.0,21483.15,27602.55,21483.15,0.301,16.63,7.12,13.72,2,3.0,-4.64,0.075,0.05177925,TAKER
24/03/2023 00:00:00,19/06/2023 16:06:14,Upscale-Upscale-DUMMY_Gemini_BTCUSD_1h_01_07_22_to_16_06_23.csv,BTC_USD,WEEK,224.5,0.001,19/05/2023 00:00:00,12/05/2023 00:00:00,12/05/2023 00:00:00,EXPIRED,LONG,27941.0,26831.0,39981.24,23927.59,0.124,30.11,16.77,12.02,2,3.0,-1.13,0.075,0.02095575,TAKER
20/01/2023 00:00:00,19/06/2023 16:06:14,Upscale-Upscale-DUMMY_Gemini_BTCUSD_1h_01_07_22_to_16_06_23.csv,BTC_USD,WEEK,223.37,0.003,17/03/2023 00:00:00,10/03/2023 00:00:00,10/02/2023 00:00:00,STOP_LOSS_HIT,LONG,23013.0,21483.15,27602.55,21483.15,0.309,16.63,7.12,13.72,2,3.0,-4.64,0.075,0.05177925,TAKER
24/02/2023 00:00:00,19/06/2023 16:06:14,Upscale-Upscale-DUMMY_Gemini_BTCUSD_1h_01_07_22_to_16_06_23.csv,BTC_USD,WEEK,218.73,0.005,21/04/2023 00:00:00,14/04/2023 00:00:00,03/03/2023 00:00:00,TAKE_PROFIT_HIT,SHORT,23468.0,20996.18,20996.18,24291.94,0.536,11.77,3.39,12.27,2,3.0,12.27,0.075,0.088005,TAKER
17/02/2023 00:00:00,19/06/2023 16:06:14,Upscale-Upscale-DUMMY_Gemini_BTCUSD_1h_01_07_22_to_16_06_23.csv,BTC_USD,WEEK,231.0,0.009,31/03/2023 00:00:00,07/04/2023 00:00:00,03/03/2023 00:00:00,TAKE_PROFIT_HIT,SHORT,23948.0,22334.58,22334.58,24485.81,0.933,7.22,2.2,14.36,2,3.1,14.36,0.075,0.161649,TAKER
27/01/2023 00:00:00,19/06/2023 16:06:14,Upscale-Upscale-DUMMY_Gemini_BTCUSD_1h_01_07_22_to_16_06_23.csv,BTC_USD,WEEK,245.36,0.001,24/03/2023 00:00:00,17/03/2023 00:00:00,03/03/2023 00:00:00,STOP_LOSS_HIT,LONG,23487.0,19907.36,34225.92,19907.36,0.096,31.38,17.98,10.72,1,3.0,-3.6,0.075,0.01761525,TAKER
27/01/2023 00:00:00,19/06/2023 16:06:14,Upscale-Upscale-DUMMY_Gemini_BTCUSD_1h_01_07_22_to_16_06_23.csv,BTC_USD,WEEK,241.76,0.001,24/03/2023 00:00:00,17/03/2023 00:00:00,03/03/2023 00:00:00,STOP_LOSS_HIT,LONG,23487.0,19907.36,34225.92,19907.36,0.097,31.38,17.98,10.72,1,3.0,-3.6,0.075,0.01761525,TAKER
24/02/2023 00:00:00,19/06/2023 16:06:14,Upscale-Upscale-DUMMY_Gemini_BTCUSD_1h_01_07_22_to_16_06_23.csv,BTC_USD,WEEK,238.16,0.006,21/04/2023 00:00:00,14/04/2023 00:00:00,03/03/2023 00:00:00,TAKE_PROFIT_HIT,SHORT,23468.0,20996.18,20996.18,24291.94,0.591,11.77,3.39,14.73,2,3.0,14.73,0.075,0.10560599999999999,TAKER
24/03/2023 00:00:00,19/06/2023 16:06:14,Upscale-Upscale-DUMMY_Gemini_BTCUSD_1h_01_07_22_to_16_06_23.csv,BTC_USD,WEEK,252.89,0.001,19/05/2023 00:00:00,12/05/2023 00:00:00,12/05/2023 00:00:00,EXPIRED,LONG,27941.0,26831.0,39981.24,23927.59,0.11,30.11,16.77,12.02,2,3.0,-1.13,0.075,0.02095575,TAKER
24/03/2023 00:00:00,19/06/2023 16:06:14,Upscale-Upscale-DUMMY_Gemini_BTCUSD_1h_01_07_22_to_16_06_23.csv,BTC_USD,WEEK,251.76,0.001,19/05/2023 00:00:00,12/05/2023 00:00:00,12/05/2023 00:00:00,EXPIRED,LONG,27941.0,26831.0,39981.24,23927.59,0.111,30.11,16.77,12.02,2,3.0,-1.13,0.075,0.02095575,TAKER
20/01/2023 00:00:00,19/06/2023 16:06:14,Upscale-Upscale-DUMMY_Gemini_BTCUSD_1h_01_07_22_to_16_06_23.csv,BTC_USD,WEEK,250.63,0.003,17/03/2023 00:00:00,10/03/2023 00:00:00,10/02/2023 00:00:00,STOP_LOSS_HIT,LONG,23013.0,21483.15,27602.55,21483.15,0.275,16.63,7.12,13.72,2,3.0,-4.64,0.075,0.05177925,TAKER
17/02/2023 00:00:00,19/06/2023 16:06:14,Upscale-Upscale-DUMMY_Gemini_BTCUSD_1h_01_07_22_to_16_06_23.csv,BTC_USD,WEEK,245.99,0.009,31/03/2023 00:00:00,07/04/2023 00:00:00,03/03/2023 00:00:00,TAKE_PROFIT_HIT,SHORT,23948.0,22334.58,22334.58,24485.81,0.876,7.22,2.2,14.36,2,3.1,14.36,0.075,0.161649,TAKER
24/03/2023 00:00:00,19/06/2023 16:06:14,Upscale-Upscale-DUMMY_Gemini_BTCUSD_1h_01_07_22_to_16_06_23.csv,BTC_USD,WEEK,260.35,0.001,19/05/2023 00:00:00,12/05/2023 00:00:00,12/05/2023 00:00:00,EXPIRED,LONG,27941.0,26831.0,39981.24,23927.59,0.107,30.11,16.77,12.02,2,3.0,-1.13,0.075,0.02095575,TAKER
24/03/2023 00:00:00,19/06/2023 16:06:14,Upscale-Upscale-DUMMY_Gemini_BTCUSD_1h_01_07_22_to_16_06_23.csv,BTC_USD,WEEK,259.22,0.001,19/05/2023 00:00:00,12/05/2023 00:00:00,12/05/2023 00:00:00,EXPIRED,LONG,27941.0,26831.0,39981.24,23927.59,0.108,30.11,16.77,12.02,2,3.0,-1.13,0.075,0.02095575,TAKER
17/02/2023 00:00:00,19/06/2023 16:06:14,Upscale-Upscale-DUMMY_Gemini_BTCUSD_1h_01_07_22_to_16_06_23.csv,BTC_USD,WEEK,258.09,0.01,31/03/2023 00:00:00,07/04/2023 00:00:00,03/03/2023 00:00:00,TAKE_PROFIT_HIT,SHORT,23948.0,22334.58,22334.58,24485.81,0.928,7.22,2.2,15.95,2,3.1,15.95,0.075,0.17961000000000002,TAKER
24/03/2023 00:00:00,19/06/2023 16:06:14,Upscale-Upscale-DUMMY_Gemini_BTCUSD_1h_01_07_22_to_16_06_23.csv,BTC_USD,WEEK,274.04,0.001,19/05/2023 00:00:00,12/05/2023 00:00:00,12/05/2023 00:00:00,EXPIRED,LONG,27941.0,26831.0,39981.24,23927.59,0.102,30.11,16.77,12.02,1,3.0,-1.13,0.075,0.02095575,TAKER
17/02/2023 00:00:00,19/06/2023 16:06:14,Upscale-Upscale-DUMMY_Gemini_BTCUSD_1h_01_07_22_to_16_06_23.csv,BTC_USD,WEEK,272.91,0.01,31/03/2023 00:00:00,07/04/2023 00:00:00,03/03/2023 00:00:00,TAKE_PROFIT_HIT,SHORT,23948.0,22334.58,22334.58,24485.81,0.878,7.22,2.2,15.95,2,3.1,15.95,0.075,0.17961000000000002,TAKER
03/03/2023 00:00:00,19/06/2023 16:06:14,Upscale-Upscale-DUMMY_Gemini_BTCUSD_1h_01_07_22_to_16_06_23.csv,BTC_USD,WEEK,288.86,0.011,21/04/2023 00:00:00,21/04/2023 00:00:00,10/03/2023 00:00:00,STOP_LOSS_HIT,SHORT,20290.0,20826.59,18680.22,20826.59,0.773,8.62,2.58,17.54,2,3.1,-6.07,0.075,0.16739249999999997,TAKER
24/02/2023 00:00:00,19/06/2023 16:06:14,Upscale-Upscale-DUMMY_Gemini_BTCUSD_1h_01_07_22_to_16_06_23.csv,BTC_USD,WEEK,282.79,0.007,21/04/2023 00:00:00,14/04/2023 00:00:00,03/03/2023 00:00:00,TAKE_PROFIT_HIT,SHORT,23468.0,20996.18,20996.18,24291.94,0.581,11.77,3.39,17.18,2,3.0,17.18,0.075,0.12320700000000001,TAKER
20/01/2023 00:00:00,19/06/2023 16:06:14,Upscale-Upscale-DUMMY_Gemini_BTCUSD_1h_01_07_22_to_16_06_23.csv,BTC_USD,WEEK,299.97,0.004,17/03/2023 00:00:00,10/03/2023 00:00:00,10/02/2023 00:00:00,STOP_LOSS_HIT,LONG,23013.0,21483.15,27602.55,21483.15,0.307,16.63,7.12,18.29,2,3.0,-6.19,0.075,0.069039,TAKER
27/01/2023 00:00:00,19/06/2023 16:06:15,Upscale-Upscale-DUMMY_Gemini_BTCUSD_1h_01_07_22_to_16_06_23.csv,BTC_USD,WEEK,293.78,0.002,24/03/2023 00:00:00,17/03/2023 00:00:00,03/03/2023 00:00:00,STOP_LOSS_HIT,LONG,23487.0,19907.36,34225.92,19907.36,0.16,31.38,17.98,21.44,2,3.0,-7.19,0.075,0.0352305,TAKER
03/03/2023 00:00:00,19/06/2023 16:06:15,Upscale-Upscale-DUMMY_Gemini_BTCUSD_1h_01_07_22_to_16_06_23.csv,BTC_USD,WEEK,286.59,0.011,21/04/2023 00:00:00,21/04/2023 00:00:00,10/03/2023 00:00:00,STOP_LOSS_HIT,SHORT,20290.0,20826.59,18680.22,20826.59,0.779,8.62,2.58,17.54,2,3.1,-6.07,0.075,0.16739249999999997,TAKER
24/02/2023 00:00:00,19/06/2023 16:06:15,Upscale-Upscale-DUMMY_Gemini_BTCUSD_1h_01_07_22_to_16_06_23.csv,BTC_USD,WEEK,280.52,0.007,21/04/2023 00:00:00,14/04/2023 00:00:00,03/03/2023 00:00:00,TAKE_PROFIT_HIT,SHORT,23468.0,20996.18,20996.18,24291.94,0.586,11.77,3.39,17.18,2,3.0,17.18,0.075,0.12320700000000001,TAKER
03/03/2023 00:00:00,19/06/2023 16:06:15,Upscale-Upscale-DUMMY_Gemini_BTCUSD_1h_01_07_22_to_16_06_23.csv,BTC_USD,WEEK,297.7,0.011,21/04/2023 00:00:00,21/04/2023 00:00:00,10/03/2023 00:00:00,STOP_LOSS_HIT,SHORT,20290.0,20826.59,18680.22,20826.59,0.75,8.62,2.58,17.54,2,3.1,-6.07,0.075,0.16739249999999997,TAKER
17/02/2023 00:00:00,19/06/2023 16:06:15,Upscale-Upscale-DUMMY_Gemini_BTCUSD_1h_01_07_22_to_16_06_23.csv,BTC_USD,WEEK,291.63,0.011,31/03/2023 00:00:00,07/04/2023 00:00:00,03/03/2023 00:00:00,TAKE_PROFIT_HIT,SHORT,23948.0,22334.58,22334.58,24485.81,0.903,7.22,2.2,17.55,2,3.1,17.55,0.075,0.19757099999999997,TAKER
20/01/2023 00:00:00,19/06/2023 16:06:15,Upscale-Upscale-DUMMY_Gemini_BTCUSD_1h_01_07_22_to_16_06_23.csv,BTC_USD,WEEK,309.18,0.004,17/03/2023 00:00:00,10/03/2023 00:00:00,10/02/2023 00:00:00,STOP_LOSS_HIT,LONG,23013.0,21483.15,27602.55,21483.15,0.298,16.63,7.12,18.29,2,3.0,-6.19,0.075,0.069039,TAKER
24/03/2023 00:00:00,19/06/2023 16:06:15,Upscale-Upscale-DUMMY_Gemini_BTCUSD_1h_01_07_22_to_16_06_23.csv,BTC_USD,WEEK,302.99,0.002,19/05/2023 00:00:00,12/05/2023 00:00:00,12/05/2023 00:00:00,EXPIRED,LONG,27941.0,26831.0,39981.24,23927.59,0.184,30.11,16.77,24.04,3,3.0,-2.26,0.075,0.0419115,TAKER
20/01/2023 00:00:00,19/06/2023 16:06:15,Upscale-Upscale-DUMMY_Gemini_BTCUSD_1h_01_07_22_to_16_06_23.csv,BTC_USD,WEEK,300.73,0.004,17/03/2023 00:00:00,10/03/2023 00:00:00,10/02/2023 00:00:00,STOP_LOSS_HIT,LONG,23013.0,21483.15,27602.55,21483.15,0.306,16.63,7.12,18.29,2,3.0,-6.19,0.075,0.069039,TAKER
24/02/2023 00:00:00,19/06/2023 16:06:15,Upscale-Upscale-DUMMY_Gemini_BTCUSD_1h_01_07_22_to_16_06_23.csv,BTC_USD,WEEK,294.54,0.007,21/04/2023 00:00:00,14/04/2023 00:00:00,03/03/2023 00:00:00,TAKE_PROFIT_HIT,SHORT,23468.0,20996.18,20996.18,24291.94,0.558,11.77,3.39,17.18,2,3.0,17.18,0.075,0.12320700000000001,TAKER
20/01/2023 00:00:00,19/06/2023 16:06:15,Upscale-Upscale-DUMMY_Gemini_BTCUSD_1h_01_07_22_to_16_06_23.csv,BTC_USD,WEEK,311.72,0.004,17/03/2023 00:00:00,10/03/2023 00:00:00,10/02/2023 00:00:00,STOP_LOSS_HIT,LONG,23013.0,21483.15,27602.55,21483.15,0.295,16.63,7.12,18.29,2,3.0,-6.19,0.075,0.069039,TAKER
27/01/2023 00:00:00,19/06/2023 16:06:15,Upscale-Upscale-DUMMY_Gemini_BTCUSD_1h_01_07_22_to_16_06_23.csv,BTC_USD,WEEK,305.53,0.002,24/03/2023 00:00:00,17/03/2023 00:00:00,03/03/2023 00:00:00,STOP_LOSS_HIT,LONG,23487.0,19907.36,34225.92,19907.36,0.154,31.38,17.98,21.44,2,3.0,-7.19,0.075,0.0352305,TAKER
27/01/2023 00:00:00,19/06/2023 16:06:15,Upscale-Upscale-DUMMY_Gemini_BTCUSD_1h_01_07_22_to_16_06_23.csv,BTC_USD,WEEK,298.34,0.002,24/03/2023 00:00:00,17/03/2023 00:00:00,03/03/2023 00:00:00,STOP_LOSS_HIT,LONG,23487.0,19907.36,34225.92,19907.36,0.157,31.38,17.98,21.44,2,3.0,-7.19,0.075,0.0352305,TAKER
03/03/2023 00:00:00,19/06/2023 16:06:15,Upscale-Upscale-DUMMY_Gemini_BTCUSD_1h_01_07_22_to_16_06_23.csv,BTC_USD,WEEK,291.15,0.011,21/04/2023 00:00:00,21/04/2023 00:00:00,10/03/2023 00:00:00,STOP_LOSS_HIT,SHORT,20290.0,20826.59,18680.22,20826.59,0.767,8.62,2.58,17.54,2,3.1,-6.07,0.075,0.16739249999999997,TAKER
17/02/2023 00:00:00,19/06/2023 16:06:15,Upscale-Upscale-DUMMY_Gemini_BTCUSD_1h_01_07_22_to_16_06_23.csv,BTC_USD,WEEK,285.08,0.011,31/03/2023 00:00:00,07/04/2023 00:00:00,03/03/2023 00:00:00,TAKE_PROFIT_HIT,SHORT,23948.0,22334.58,22334.58,24485.81,0.924,7.22,2.2,17.55,2,3.1,17.55,0.075,0.19757099999999997,TAKER
24/03/2023 00:00:00,19/06/2023 16:06:15,Upscale-Upscale-DUMMY_Gemini_BTCUSD_1h_01_07_22_to_16_06_23.csv,BTC_USD,WEEK,302.63,0.002,19/05/2023 00:00:00,12/05/2023 00:00:00,12/05/2023 00:00:00,EXPIRED,LONG,27941.0,26831.0,39981.24,23927.59,0.185,30.11,16.77,24.04,3,3.0,-2.26,0.075,0.0419115,TAKER
03/03/2023 00:00:00,19/06/2023 16:06:15,Upscale-Upscale-DUMMY_Gemini_BTCUSD_1h_01_07_22_to_16_06_23.csv,BTC_USD,WEEK,300.37,0.011,21/04/2023 00:00:00,21/04/2023 00:00:00,10/03/2023 00:00:00,STOP_LOSS_HIT,SHORT,20290.0,20826.59,18680.22,20826.59,0.743,8.62,2.58,17.54,2,3.1,-6.07,0.075,0.16739249999999997,TAKER
27/01/2023 00:00:00,19/06/2023 16:06:15,Upscale-Upscale-DUMMY_Gemini_BTCUSD_1h_01_07_22_to_16_06_23.csv,BTC_USD,WEEK,294.3,0.002,24/03/2023 00:00:00,17/03/2023 00:00:00,03/03/2023 00:00:00,STOP_LOSS_HIT,LONG,23487.0,19907.36,34225.92,19907.36,0.16,31.38,17.98,21.44,2,3.0,-7.19,0.075,0.0352305,TAKER
20/01/2023 00:00:00,19/06/2023 16:06:15,Upscale-Upscale-DUMMY_Gemini_BTCUSD_1h_01_07_22_to_16_06_23.csv,BTC_USD,WEEK,287.11,0.004,17/03/2023 00:00:00,10/03/2023 00:00:00,10/02/2023 00:00:00,STOP_LOSS_HIT,LONG,23013.0,21483.15,27602.55,21483.15,0.321,16.63,7.12,18.29,2,3.0,-6.19,0.075,0.069039,TAKER
03/03/2023 00:00:00,19/06/2023 16:06:15,Upscale-Upscale-DUMMY_Gemini_BTCUSD_1h_01_07_22_to_16_06_23.csv,BTC_USD,WEEK,280.92,0.01,21/04/2023 00:00:00,21/04/2023 00:00:00,10/03/2023 00:00:00,STOP_LOSS_HIT,SHORT,20290.0,20826.59,18680.22,20826.59,0.722,8.62,2.58,15.95,2,3.1,-5.52,0.075,0.152175,TAKER
24/03/2023 00:00:00,19/06/2023 16:06:15,Upscale-Upscale-DUMMY_Gemini_BTCUSD_1h_01_07_22_to_16_06_23.csv,BTC_USD,WEEK,275.4,0.001,19/05/2023 00:00:00,12/05/2023 00:00:00,12/05/2023 00:00:00,EXPIRED,LONG,27941.0,26831.0,39981.24,23927.59,0.101,30.11,16.77,12.02,1,3.0,-1.13,0.075,0.02095575,TAKER
20/01/2023 00:00:00,19/06/2023 16:06:15,Upscale-Upscale-DUMMY_Gemini_BTCUSD_1h_01_07_22_to_16_06_23.csv,BTC_USD,WEEK,274.27,0.004,17/03/2023 00:00:00,10/03/2023 00:00:00,10/02/2023 00:00:00,STOP_LOSS_HIT,LONG,23013.0,21483.15,27602.55,21483.15,0.336,16.63,7.12,18.29,2,3.0,-6.19,0.075,0.069039,TAKER
24/03/2023 00:00:00,19/06/2023 16:06:15,Upscale-Upscale-DUMMY_Gemini_BTCUSD_1h_01_07_22_to_16_06_23.csv,BTC_USD,WEEK,268.08,0.001,19/05/2023 00:00:00,12/05/2023 00:00:00,12/05/2023 00:00:00,EXPIRED,LONG,27941.0,26831.0,39981.24,23927.59,0.104,30.11,16.77,12.02,1,3.0,-1.13,0.075,0.02095575,TAKER
03/03/2023 00:00:00,19/06/2023 16:06:15,Upscale-Upscale-DUMMY_Gemini_BTCUSD_1h_01_07_22_to_16_06_23.csv,BTC_USD,WEEK,266.95,0.01,21/04/2023 00:00:00,21/04/2023 00:00:00,10/03/2023 00:00:00,STOP_LOSS_HIT,SHORT,20290.0,20826.59,18680.22,20826.59,0.76,8.62,2.58,15.95,2,3.1,-5.52,0.075,0.152175,TAKER
20/01/2023 00:00:00,19/06/2023 16:06:15,Upscale-Upscale-DUMMY_Gemini_BTCUSD_1h_01_07_22_to_16_06_23.csv,BTC_USD,WEEK,261.43,0.003,17/03/2023 00:00:00,10/03/2023 00:00:00,10/02/2023 00:00:00,STOP_LOSS_HIT,LONG,23013.0,21483.15,27602.55,21483.15,0.264,16.63,7.12,13.72,2,3.0,-4.64,0.075,0.05177925,TAKER
20/01/2023 00:00:00,19/06/2023 16:06:15,Upscale-Upscale-DUMMY_Gemini_BTCUSD_1h_01_07_22_to_16_06_23.csv,BTC_USD,WEEK,256.79,0.003,17/03/2023 00:00:00,10/03/2023 00:00:00,10/02/2023 00:00:00,STOP_LOSS_HIT,LONG,23013.0,21483.15,27602.55,21483.15,0.269,16.63,7.12,13.72,2,3.0,-4.64,0.075,0.05177925,TAKER
03/03/2023 00:00:00,19/06/2023 16:06:15,Upscale-Upscale-DUMMY_Gemini_BTCUSD_1h_01_07_22_to_16_06_23.csv,BTC_USD,WEEK,252.15,0.009,21/04/2023 00:00:00,21/04/2023 00:00:00,10/03/2023 00:00:00,STOP_LOSS_HIT,SHORT,20290.0,20826.59,18680.22,20826.59,0.724,8.62,2.58,14.35,2,3.1,-4.97,0.075,0.13695749999999998,TAKER
24/02/2023 00:00:00,19/06/2023 16:06:15,Upscale-Upscale-DUMMY_Gemini_BTCUSD_1h_01_07_22_to_16_06_23.csv,BTC_USD,WEEK,247.18,0.006,21/04/2023 00:00:00,14/04/2023 00:00:00,03/03/2023 00:00:00,TAKE_PROFIT_HIT,SHORT,23468.0,20996.18,20996.18,24291.94,0.57,11.77,3.39,14.73,2,3.0,14.73,0.075,0.10560599999999999,TAKER
27/01/2023 00:00:00,19/06/2023 16:06:15,Upscale-Upscale-DUMMY_Gemini_BTCUSD_1h_01_07_22_to_16_06_23.csv,BTC_USD,WEEK,261.91,0.001,24/03/2023 00:00:00,17/03/2023 00:00:00,03/03/2023 00:00:00,STOP_LOSS_HIT,LONG,23487.0,19907.36,34225.92,19907.36,0.09,31.38,17.98,10.72,1,3.0,-3.6,0.075,0.01761525,TAKER
24/02/2023 00:00:00,19/06/2023 16:06:15,Upscale-Upscale-DUMMY_Gemini_BTCUSD_1h_01_07_22_to_16_06_23.csv,BTC_USD,WEEK,258.31,0.006,21/04/2023 00:00:00,14/04/2023 00:00:00,03/03/2023 00:00:00,TAKE_PROFIT_HIT,SHORT,23468.0,20996.18,20996.18,24291.94,0.545,11.77,3.39,14.73,2,3.0,14.73,0.075,0.10560599999999999,TAKER
03/03/2023 00:00:00,19/06/2023 16:06:15,Upscale-Upscale-DUMMY_Gemini_BTCUSD_1h_01_07_22_to_16_06_23.csv,BTC_USD,WEEK,273.04,0.01,21/04/2023 00:00:00,21/04/2023 00:00:00,10/03/2023 00:00:00,STOP_LOSS_HIT,SHORT,20290.0,20826.59,18680.22,20826.59,0.743,8.62,2.58,15.95,2,3.1,-5.52,0.075,0.152175,TAKER
03/03/2023 00:00:00,19/06/2023 16:06:15,Upscale-Upscale-DUMMY_Gemini_BTCUSD_1h_01_07_22_to_16_06_23.csv,BTC_USD,WEEK,267.52,0.01,21/04/2023 00:00:00,21/04/2023 00:00:00,10/03/2023 00:00:00,STOP_LOSS_HIT,SHORT,20290.0,20826.59,18680.22,20826.59,0.758,8.62,2.58,15.95,2,3.1,-5.52,0.075,0.152175,TAKER
17/02/2023 00:00:00,19/06/2023 16:06:15,Upscale-Upscale-DUMMY_Gemini_BTCUSD_1h_01_07_22_to_16_06_23.csv,BTC_USD,WEEK,262.0,0.01,31/03/2023 00:00:00,07/04/2023 00:00:00,03/03/2023 00:00:00,TAKE_PROFIT_HIT,SHORT,23948.0,22334.58,22334.58,24485.81,0.914,7.22,2.2,15.95,2,3.1,15.95,0.075,0.17961000000000002,TAKER
17/02/2023 00:00:00,19/06/2023 16:06:15,Upscale-Upscale-DUMMY_Gemini_BTCUSD_1h_01_07_22_to_16_06_23.csv,BTC_USD,WEEK,277.95,0.01,31/03/2023 00:00:00,07/04/2023 00:00:00,03/03/2023 00:00:00,TAKE_PROFIT_HIT,SHORT,23948.0,22334.58,22334.58,24485.81,0.862,7.22,2.2,15.95,2,3.1,15.95,0.075,0.17961000000000002,TAKER
17/02/2023 00:00:00,19/06/2023 16:06:15,Upscale-Upscale-DUMMY_Gemini_BTCUSD_1h_01_07_22_to_16_06_23.csv,BTC_USD,WEEK,293.9,0.011,31/03/2023 00:00:00,07/04/2023 00:00:00,03/03/2023 00:00:00,TAKE_PROFIT_HIT,SHORT,23948.0,22334.58,22334.58,24485.81,0.896,7.22,2.2,17.55,2,3.1,17.55,0.075,0.19757099999999997,TAKER
24/03/2023 00:00:00,19/06/2023 16:06:15,Upscale-Upscale-DUMMY_Gemini_BTCUSD_1h_01_07_22_to_16_06_23.csv,BTC_USD,WEEK,311.45,0.002,19/05/2023 00:00:00,12/05/2023 00:00:00,12/05/2023 00:00:00,EXPIRED,LONG,27941.0,26831.0,39981.24,23927.59,0.179,30.11,16.77,24.04,3,3.0,-2.26,0.075,0.0419115,TAKER
24/03/2023 00:00:00,19/06/2023 16:06:15,Upscale-Upscale-DUMMY_Gemini_BTCUSD_1h_01_07_22_to_16_06_23.csv,BTC_USD,WEEK,309.19,0.002,19/05/2023 00:00:00,12/05/2023 00:00:00,12/05/2023 00:00:00,EXPIRED,LONG,27941.0,26831.0,39981.24,23927.59,0.181,30.11,16.77,24.04,3,3.0,-2.26,0.075,0.0419115,TAKER
20/01/2023 00:00:00,19/06/2023 16:06:15,Upscale-Upscale-DUMMY_Gemini_BTCUSD_1h_01_07_22_to_16_06_23.csv,BTC_USD,WEEK,306.93,0.004,17/03/2023 00:00:00,10/03/2023 00:00:00,10/02/2023 00:00:00,STOP_LOSS_HIT,LONG,23013.0,21483.15,27602.55,21483.15,0.3,16.63,7.12,18.29,2,3.0,-6.19,0.075,0.069039,TAKER
24/03/2023 00:00:00,19/06/2023 16:06:15,Upscale-Upscale-DUMMY_Gemini_BTCUSD_1h_01_07_22_to_16_06_23.csv,BTC_USD,WEEK,300.74,0.001,19/05/2023 00:00:00,12/05/2023 00:00:00,12/05/2023 00:00:00,EXPIRED,LONG,27941.0,26831.0,39981.24,23927.59,0.093,30.11,16.77,12.02,1,3.0,-1.13,0.075,0.02095575,TAKER
24/02/2023 00:00:00,19/06/2023 16:06:15,Upscale-Upscale-DUMMY_Gemini_BTCUSD_1h_01_07_22_to_16_06_23.csv,BTC_USD,WEEK,299.61,0.007,21/04/2023 00:00:00,14/04/2023 00:00:00,03/03/2023 00:00:00,TAKE_PROFIT_HIT,SHORT,23468.0,20996.18,20996.18,24291.94,0.548,11.77,3.39,17.18,2,3.0,17.18,0.075,0.12320700000000001,TAKER
24/02/2023 00:00:00,19/06/2023 16:06:15,Upscale-Upscale-DUMMY_Gemini_BTCUSD_1h_01_07_22_to_16_06_23.csv,BTC_USD,WEEK,316.79,0.008,21/04/2023 00:00:00,14/04/2023 00:00:00,03/03/2023 00:00:00,TAKE_PROFIT_HIT,SHORT,23468.0,20996.18,20996.18,24291.94,0.593,11.77,3.39,19.63,2,3.0,19.63,0.075,0.140808,TAKER
17/02/2023 00:00:00,19/06/2023 16:06:15,Upscale-Upscale-DUMMY_Gemini_BTCUSD_1h_01_07_22_to_16_06_23.csv,BTC_USD,WEEK,336.42,0.013,31/03/2023 00:00:00,07/04/2023 00:00:00,03/03/2023 00:00:00,TAKE_PROFIT_HIT,SHORT,23948.0,22334.58,22334.58,24485.81,0.925,7.22,2.2,20.74,2,3.1,20.74,0.075,0.233493,TAKER
17/02/2023 00:00:00,19/06/2023 16:06:15,Upscale-Upscale-DUMMY_Gemini_BTCUSD_1h_01_07_22_to_16_06_23.csv,BTC_USD,WEEK,357.16,0.013,31/03/2023 00:00:00,07/04/2023 00:00:00,03/03/2023 00:00:00,TAKE_PROFIT_HIT,SHORT,23948.0,22334.58,22334.58,24485.81,0.872,7.22,2.2,20.74,2,3.1,20.74,0.075,0.233493,TAKER
24/03/2023 00:00:00,19/06/2023 16:06:15,Upscale-Upscale-DUMMY_Gemini_BTCUSD_1h_01_07_22_to_16_06_23.csv,BTC_USD,WEEK,377.9,0.002,19/05/2023 00:00:00,12/05/2023 00:00:00,12/05/2023 00:00:00,EXPIRED,LONG,27941.0,26831.0,39981.24,23927.59,0.148,30.11,16.77,24.04,2,3.0,-2.26,0.075,0.0419115,TAKER
27/01/2023 00:00:00,19/06/2023 16:06:15,Upscale-Upscale-DUMMY_Gemini_BTCUSD_1h_01_07_22_to_16_06_23.csv,BTC_USD,WEEK,375.64,0.002,24/03/2023 00:00:00,17/03/2023 00:00:00,03/03/2023 00:00:00,STOP_LOSS_HIT,LONG,23487.0,19907.36,34225.92,19907.36,0.125,31.38,17.98,21.44,2,3.0,-7.19,0.075,0.0352305,TAKER
20/01/2023 00:00:00,19/06/2023 16:06:15,Upscale-Upscale-DUMMY_Gemini_BTCUSD_1h_01_07_22_to_16_06_23.csv,BTC_USD,WEEK,368.45,0.005,17/03/2023 00:00:00,10/03/2023 00:00:00,10/02/2023 00:00:00,STOP_LOSS_HIT,LONG,23013.0,21483.15,27602.55,21483.15,0.312,16.63,7.12,22.86,2,3.0,-7.74,0.075,0.08629875000000001,TAKER
20/01/2023 00:00:00,19/06/2023 16:06:15,Upscale-Upscale-DUMMY_Gemini_BTCUSD_1h_01_07_22_to_16_06_23.csv,BTC_USD,WEEK,360.71,0.005,17/03/2023 00:00:00,10/03/2023 00:00:00,10/02/2023 00:00:00,STOP_LOSS_HIT,LONG,23013.0,21483.15,27602.55,21483.15,0.319,16.63,7.12,22.86,2,3.0,-7.74,0.075,0.08629875000000001,TAKER
20/01/2023 00:00:00,19/06/2023 16:06:15,Upscale-Upscale-DUMMY_Gemini_BTCUSD_1h_01_07_22_to_16_06_23.csv,BTC_USD,WEEK,352.97,0.005,17/03/2023 00:00:00,10/03/2023 00:00:00,10/02/2023 00:00:00,STOP_LOSS_HIT,LONG,23013.0,21483.15,27602.55,21483.15,0.326,16.63,7.12,22.86,2,3.0,-7.74,0.075,0.08629875000000001,TAKER
03/03/2023 00:00:00,19/06/2023 16:06:15,Upscale-Upscale-DUMMY_Gemini_BTCUSD_1h_01_07_22_to_16_06_23.csv,BTC_USD,WEEK,345.23,0.013,21/04/2023 00:00:00,21/04/2023 00:00:00,10/03/2023 00:00:00,STOP_LOSS_HIT,SHORT,20290.0,20826.59,18680.22,20826.59,0.764,8.62,2.58,20.73,2,3.1,-7.17,0.075,0.19782749999999996,TAKER
24/02/2023 00:00:00,19/06/2023 16:06:15,Upscale-Upscale-DUMMY_Gemini_BTCUSD_1h_01_07_22_to_16_06_23.csv,BTC_USD,WEEK,338.06,0.008,21/04/2023 00:00:00,14/04/2023 00:00:00,03/03/2023 00:00:00,TAKE_PROFIT_HIT,SHORT,23468.0,20996.18,20996.18,24291.94,0.555,11.77,3.39,19.63,2,3.0,19.63,0.075,0.140808,TAKER
24/02/2023 00:00:00,19/06/2023 16:06:15,Upscale-Upscale-DUMMY_Gemini_BTCUSD_1h_01_07_22_to_16_06_23.csv,BTC_USD,WEEK,357.69,0.009,21/04/2023 00:00:00,14/04/2023 00:00:00,03/03/2023 00:00:00,TAKE_PROFIT_HIT,SHORT,23468.0,20996.18,20996.18,24291.94,0.59,11.77,3.39,22.09,2,3.0,22.09,0.075,0.15840899999999997,TAKER
27/01/2023 00:00:00,19/06/2023 16:06:15,Upscale-Upscale-DUMMY_Gemini_BTCUSD_1h_01_07_22_to_16_06_23.csv,BTC_USD,WEEK,379.78,0.002,24/03/2023 00:00:00,17/03/2023 00:00:00,03/03/2023 00:00:00,STOP_LOSS_HIT,LONG,23487.0,19907.36,34225.92,19907.36,0.124,31.38,17.98,21.44,2,3.0,-7.19,0.075,0.0352305,TAKER
03/03/2023 00:00:00,19/06/2023 16:06:15,Upscale-Upscale-DUMMY_Gemini_BTCUSD_1h_01_07_22_to_16_06_23.csv,BTC_USD,WEEK,372.59,0.014,21/04/2023 00:00:00,21/04/2023 00:00:00,10/03/2023 00:00:00,STOP_LOSS_HIT,SHORT,20290.0,20826.59,18680.22,20826.59,0.762,8.62,2.58,22.32,2,3.1,-7.73,0.075,0.213045,TAKER
03/03/2023 00:00:00,19/06/2023 16:06:15,Upscale-Upscale-DUMMY_Gemini_BTCUSD_1h_01_07_22_to_16_06_23.csv,BTC_USD,WEEK,364.86,0.014,21/04/2023 00:00:00,21/04/2023 00:00:00,10/03/2023 00:00:00,STOP_LOSS_HIT,SHORT,20290.0,20826.59,18680.22,20826.59,0.779,8.62,2.58,22.32,2,3.1,-7.73,0.075,0.213045,TAKER
24/02/2023 00:00:00,19/06/2023 16:06:15,Upscale-Upscale-DUMMY_Gemini_BTCUSD_1h_01_07_22_to_16_06_23.csv,BTC_USD,WEEK,357.13,0.009,21/04/2023 00:00:00,14/04/2023 00:00:00,03/03/2023 00:00:00,TAKE_PROFIT_HIT,SHORT,23468.0,20996.18,20996.18,24291.94,0.591,11.77,3.39,22.09,2,3.0,22.09,0.075,0.15840899999999997,TAKER
20/01/2023 00:00:00,19/06/2023 16:06:15,Upscale-Upscale-DUMMY_Gemini_BTCUSD_1h_01_07_22_to_16_06_23.csv,BTC_USD,WEEK,379.22,0.005,17/03/2023 00:00:00,10/03/2023 00:00:00,10/02/2023 00:00:00,STOP_LOSS_HIT,LONG,23013.0,21483.15,27602.55,21483.15,0.303,16.63,7.12,22.86,2,3.0,-7.74,0.075,0.08629875000000001,TAKER
03/03/2023 00:00:00,19/06/2023 16:06:15,Upscale-Upscale-DUMMY_Gemini_BTCUSD_1h_01_07_22_to_16_06_23.csv,BTC_USD,WEEK,371.48,0.014,21/04/2023 00:00:00,21/04/2023 00:00:00,10/03/2023 00:00:00,STOP_LOSS_HIT,SHORT,20290.0,20826.59,18680.22,20826.59,0.765,8.62,2.58,22.32,2,3.1,-7.73,0.075,0.213045,TAKER
17/02/2023 00:00:00,19/06/2023 16:06:15,Upscale-Upscale-DUMMY_Gemini_BTCUSD_1h_01_07_22_to_16_06_23.csv,BTC_USD,WEEK,363.75,0.014,31/03/2023 00:00:00,07/04/2023 00:00:00,03/03/2023 00:00:00,TAKE_PROFIT_HIT,SHORT,23948.0,22334.58,22334.58,24485.81,0.922,7.22,2.2,22.34,2,3.1,22.34,0.075,0.251454,TAKER
27/01/2023 00:00:00,19/06/2023 16:06:15,Upscale-Upscale-DUMMY_Gemini_BTCUSD_1h_01_07_22_to_16_06_23.csv,BTC_USD,WEEK,386.09,0.002,24/03/2023 00:00:00,17/03/2023 00:00:00,03/03/2023 00:00:00,STOP_LOSS_HIT,LONG,23487.0,19907.36,34225.92,19907.36,0.122,31.38,17.98,21.44,2,3.0,-7.19,0.075,0.0352305,TAKER
24/02/2023 00:00:00,19/06/2023 16:06:15,Upscale-Upscale-DUMMY_Gemini_BTCUSD_1h_01_07_22_to_16_06_23.csv,BTC_USD,WEEK,378.9,0.009,21/04/2023 00:00:00,14/04/2023 00:00:00,03/03/2023 00:00:00,TAKE_PROFIT_HIT,SHORT,23468.0,20996.18,20996.18,24291.94,0.557,11.77,3.39,22.09,2,3.0,22.09,0.075,0.15840899999999997,TAKER
27/01/2023 00:00:00,19/06/2023 16:06:15,Upscale-Upscale-DUMMY_Gemini_BTCUSD_1h_01_07_22_to_16_06_23.csv,BTC_USD,WEEK,400.99,0.002,24/03/2023 00:00:00,17/03/2023 00:00:00,03/03/2023 00:00:00,STOP_LOSS_HIT,LONG,23487.0,19907.36,34225.92,19907.36,0.117,31.38,17.98,21.44,2,3.0,-7.19,0.075,0.0352305,TAKER
17/02/2023 00:00:00,19/06/2023 16:06:15,Upscale-Upscale-DUMMY_Gemini_BTCUSD_1h_01_07_22_to_16_06_23.csv,BTC_USD,WEEK,393.8,0.015,31/03/2023 00:00:00,07/04/2023 00:00:00,03/03/2023 00:00:00,TAKE_PROFIT_HIT,SHORT,23948.0,22334.58,22334.58,24485.81,0.912,7.22,2.2,23.93,2,3.1,23.93,0.075,0.26941499999999996,TAKER
03/03/2023 00:00:00,19/06/2023 16:06:15,Upscale-Upscale-DUMMY_Gemini_BTCUSD_1h_01_07_22_to_16_06_23.csv,BTC_USD,WEEK,417.73,0.016,21/04/2023 00:00:00,21/04/2023 00:00:00,10/03/2023 00:00:00,STOP_LOSS_HIT,SHORT,20290.0,20826.59,18680.22,20826.59,0.777,8.62,2.58,25.51,2,3.1,-8.83,0.075,0.24348,TAKER
24/02/2023 00:00:00,19/06/2023 16:06:15,Upscale-Upscale-DUMMY_Gemini_BTCUSD_1h_01_07_22_to_16_06_23.csv,BTC_USD,WEEK,408.9,0.01,21/04/2023 00:00:00,14/04/2023 00:00:00,03/03/2023 00:00:00,TAKE_PROFIT_HIT,SHORT,23468.0,20996.18,20996.18,24291.94,0.574,11.77,3.39,24.54,2,3.0,24.54,0.075,0.17601,TAKER
17/02/2023 00:00:00,19/06/2023 16:06:15,Upscale-Upscale-DUMMY_Gemini_BTCUSD_1h_01_07_22_to_16_06_23.csv,BTC_USD,WEEK,433.44,0.016,31/03/2023 00:00:00,07/04/2023 00:00:00,03/03/2023 00:00:00,TAKE_PROFIT_HIT,SHORT,23948.0,22334.58,22334.58,24485.81,0.884,7.22,2.2,25.53,2,3.1,25.53,0.075,0.287376,TAKER
24/02/2023 00:00:00,19/06/2023 16:06:15,Upscale-Upscale-DUMMY_Gemini_BTCUSD_1h_01_07_22_to_16_06_23.csv,BTC_USD,WEEK,458.97,0.011,21/04/2023 00:00:00,14/04/2023 00:00:00,03/03/2023 00:00:00,TAKE_PROFIT_HIT,SHORT,23468.0,20996.18,20996.18,24291.94,0.562,11.77,3.39,27.0,2,3.0,27.0,0.075,0.19361099999999998,TAKER
24/03/2023 00:00:00,19/06/2023 16:06:15,Upscale-Upscale-DUMMY_Gemini_BTCUSD_1h_01_07_22_to_16_06_23.csv,BTC_USD,WEEK,485.97,0.002,19/05/2023 00:00:00,12/05/2023 00:00:00,12/05/2023 00:00:00,EXPIRED,LONG,27941.0,26831.0,39981.24,23927.59,0.115,30.11,16.77,24.04,2,3.0,-2.26,0.075,0.0419115,TAKER
27/01/2023 00:00:00,19/06/2023 16:06:15,Upscale-Upscale-DUMMY_Gemini_BTCUSD_1h_01_07_22_to_16_06_23.csv,BTC_USD,WEEK,483.71,0.003,24/03/2023 00:00:00,17/03/2023 00:00:00,03/03/2023 00:00:00,STOP_LOSS_HIT,LONG,23487.0,19907.36,34225.92,19907.36,0.146,31.38,17.98,32.16,2,3.0,-10.79,0.075,0.05284575,TAKER
24/03/2023 00:00:00,19/06/2023 16:06:15,Upscale-Upscale-DUMMY_Gemini_BTCUSD_1h_01_07_22_to_16_06_23.csv,BTC_USD,WEEK,472.92,0.002,19/05/2023 00:00:00,12/05/2023 00:00:00,12/05/2023 00:00:00,EXPIRED,LONG,27941.0,26831.0,39981.24,23927.59,0.118,30.11,16.77,24.04,2,3.0,-2.26,0.075,0.0419115,TAKER
24/02/2023 00:00:00,19/06/2023 16:06:15,Upscale-Upscale-DUMMY_Gemini_BTCUSD_1h_01_07_22_to_16_06_23.csv,BTC_USD,WEEK,470.66,0.011,21/04/2023 00:00:00,14/04/2023 00:00:00,03/03/2023 00:00:00,TAKE_PROFIT_HIT,SHORT,23468.0,20996.18,20996.18,24291.94,0.548,11.77,3.39,27.0,2,3.0,27.0,0.075,0.19361099999999998,TAKER
03/03/2023 00:00:00,19/06/2023 16:06:15,Upscale-Upscale-DUMMY_Gemini_BTCUSD_1h_01_07_22_to_16_06_23.csv,BTC_USD,WEEK,497.66,0.019,21/04/2023 00:00:00,21/04/2023 00:00:00,10/03/2023 00:00:00,STOP_LOSS_HIT,SHORT,20290.0,20826.59,18680.22,20826.59,0.775,8.62,2.58,30.3,2,3.1,-10.48,0.075,0.28913249999999996,TAKER
24/03/2023 00:00:00,19/06/2023 16:06:15,Upscale-Upscale-DUMMY_Gemini_BTCUSD_1h_01_07_22_to_16_06_23.csv,BTC_USD,WEEK,487.18,0.002,19/05/2023 00:00:00,12/05/2023 00:00:00,12/05/2023 00:00:00,EXPIRED,LONG,27941.0,26831.0,39981.24,23927.59,0.115,30.11,16.77,24.04,2,3.0,-2.26,0.075,0.0419115,TAKER
20/01/2023 00:00:00,19/06/2023 16:06:15,Upscale-Upscale-DUMMY_Gemini_BTCUSD_1h_01_07_22_to_16_06_23.csv,BTC_USD,WEEK,484.92,0.006,17/03/2023 00:00:00,10/03/2023 00:00:00,10/02/2023 00:00:00,STOP_LOSS_HIT,LONG,23013.0,21483.15,27602.55,21483.15,0.285,16.63,7.12,27.43,2,3.0,-9.28,0.075,0.1035585,TAKER
24/02/2023 00:00:00,19/06/2023 16:06:15,Upscale-Upscale-DUMMY_Gemini_BTCUSD_1h_01_07_22_to_16_06_23.csv,BTC_USD,WEEK,475.64,0.012,21/04/2023 00:00:00,14/04/2023 00:00:00,03/03/2023 00:00:00,TAKE_PROFIT_HIT,SHORT,23468.0,20996.18,20996.18,24291.94,0.592,11.77,3.39,29.45,2,3.0,29.45,0.075,0.21121199999999998,TAKER
24/02/2023 00:00:00,19/06/2023 16:06:15,Upscale-Upscale-DUMMY_Gemini_BTCUSD_1h_01_07_22_to_16_06_23.csv,BTC_USD,WEEK,505.09,0.012,21/04/2023 00:00:00,14/04/2023 00:00:00,03/03/2023 00:00:00,TAKE_PROFIT_HIT,SHORT,23468.0,20996.18,20996.18,24291.94,0.558,11.77,3.39,29.45,2,3.0,29.45,0.075,0.21121199999999998,TAKER
24/02/2023 00:00:00,19/06/2023 16:06:15,Upscale-Upscale-DUMMY_Gemini_BTCUSD_1h_01_07_22_to_16_06_23.csv,BTC_USD,WEEK,534.54,0.013,21/04/2023 00:00:00,14/04/2023 00:00:00,03/03/2023 00:00:00,TAKE_PROFIT_HIT,SHORT,23468.0,20996.18,20996.18,24291.94,0.571,11.77,3.39,31.9,2,3.0,31.9,0.075,0.228813,TAKER
24/02/2023 00:00:00,19/06/2023 16:06:15,Upscale-Upscale-DUMMY_Gemini_BTCUSD_1h_01_07_22_to_16_06_23.csv,BTC_USD,WEEK,566.44,0.014,21/04/2023 00:00:00,14/04/2023 00:00:00,03/03/2023 00:00:00,TAKE_PROFIT_HIT,SHORT,23468.0,20996.18,20996.18,24291.94,0.58,11.77,3.39,34.36,2,3.0,34.36,0.075,0.24641400000000002,TAKER
