Open,Last update,Platform,Symbol,Timeframe,Account balance at open,Size,Expected close,Expiry,Close,Status,Side,Opening price,Closing price,Take profit,Stop loss,Leverage,TP price %,SL price %,Expected profit,Risk %,R/R ratio,PnL,Fee %,Fee Amount,Order Type
27/01/2023 00:00:00,19/06/2023 16:25:32,Upscale-Upscale-DUMMY_Gemini_BTCUSD_1h_01_07_22_to_16_06_23.csv,BTC_USD,WEEK,200.0,0.001,24/03/2023 00:00:00,17/03/2023 00:00:00,03/03/2023 00:00:00,STOP_LOSS_HIT,LONG,23487.0,19907.36,34225.92,19907.36,0.117,31.38,17.98,10.72,2,3.0,-3.6,0.075,0.01761525,TAKER
03/03/2023 00:00:00,19/06/2023 16:25:32,Upscale-Upscale-DUMMY_Gemini_BTCUSD_1h_01_07_22_to_16_06_23.csv,BTC_USD,WEEK,196.4,0.007,21/04/2023 00:00:00,21/04/2023 00:00:00,10/03/2023 00:00:00,STOP_LOSS_HIT,SHORT,20290.0,20826.59,18680.22,20826.59,0.723,8.62,2.58,11.16,2,3.1,-3.86,0.075,0.1065225,TAKER
20/01/2023 00:00:00,19/06/2023 16:25:32,Upscale-Upscale-DUMMY_Gemini_BTCUSD_1h_01_07_22_to_16_06_23.csv,BTC_USD,WEEK,192.54,0.003,17/03/2023 00:00:00,10/03/2023 00:00:00,10/02/2023 00:00:00,STOP_LOSS_HIT,LONG,23013.0,21483.15,27602.55,21483.15,0.359,16.63,7.12,13.72,2,3.0,-4.64,0.075,0.05177925,TAKER
24/03/2023 00:00:00,19/06/2023 16:25:32,Upscale-Upscale-DUMMY_Gemini_BTCUSD_1h_01_07_22_to_16_06_23.csv,BTC_USD,WEEK,187.9,0.001,19/05/2023 00:00:00,12/05/2023 00:00:00,12/05/2023 00:00:00,EXPIRED,LONG,27941.0,26831.0,39981.24,23927.59,0.149,30.11,16.77,12.02,2,3.0,-1.13,0.075,0.02095575,TAKER
27/01/2023 00:00:00,19/06/2023 16:25:32,Upscale-Upscale-DUMMY_Gemini_BTCUSD_1h_01_07_22_to_16_06_23.csv,BTC_USD,WEEK,186.77,0.001,24/03/2023 00:00:00,17/03/2023 00:00:00,03/03/2023 00:00:00,STOP_LOSS_HIT,LONG,23487.0,19907.36,34225.92,19907.36,0.126,31.38,17.98,10.72,2,3.0,-3.6,0.075,0.01761525,TAKER
17/02/2023 00:00:00,19/06/2023 16:25:32,Upscale-Upscale-DUMMY_Gemini_BTCUSD_1h_01_07_22_to_16_06_23.csv,BTC_USD,WEEK,183.17,0.007,31/03/2023 00:00:00,07/04/2023 00:00:00,03/03/2023 00:00:00,TAKE_PROFIT_HIT,SHORT,23948.0,22334.58,22334.58,24485.81,0.915,7.22,2.2,11.17,2,3.1,11.17,0.075,0.125727,TAKER
03/03/2023 00:00:00,19/06/2023 16:25:32,Upscale-Upscale-DUMMY_Gemini_BTCUSD_1h_01_07_22_to_16_06_23.csv,BTC_USD,WEEK,194.34,0.007,21/04/2023 00:00:00,21/04/2023 00:00:00,10/03/2023 00:00:00,STOP_LOSS_HIT,SHORT,20290.0,20826.59,18680.22,20826.59,0.731,8.62,2.58,11.16,2,3.1,-3.86,0.075,0.1065225,TAKER
24/03/2023 00:00:00,19/06/2023 16:25:32,Upscale-Upscale-DUMMY_Gemini_BTCUSD_1h_01_07_22_to_16_06_23.csv,BTC_USD,WEEK,190.48,0.001,19/05/2023 00:00:00,12/05/2023 00:00:00,12/05/2023 00:00:00,EXPIRED,LONG,27941.0,26831.0,39981.24,23927.59,0.147,30.11,16.77,12.02,2,3.0,-1.13,0.075,0.02095575,TAKER
17/02/2023 00:00:00,19/06/2023 16:25:32,Upscale-Upscale-DUMMY_Gemini_BTCUSD_1h_01_07_22_to_16_06_23.csv,BTC_USD,WEEK,189.35,0.007,31/03/2023 00:00:00,07/04/2023 00:00:00,03/03/2023 00:00:00,TAKE_PROFIT_HIT,SHORT,23948.0,22334.58,22334.58,24485.81,0.885,7.22,2.2,11.17,2,3.1,11.17,0.075,0.125727,TAKER
17/02/2023 00:00:00,19/06/2023 16:25:32,Upscale-Upscale-DUMMY_Gemini_BTCUSD_1h_01_07_22_to_16_06_23.csv,BTC_USD,WEEK,200.52,0.007,31/03/2023 00:00:00,07/04/2023 00:00:00,03/03/2023 00:00:00,TAKE_PROFIT_HIT,SHORT,23948.0,22334.58,22334.58,24485.81,0.836,7.22,2.2,11.17,2,3.1,11.17,0.075,0.125727,TAKER
17/02/2023 00:00:00,19/06/2023 16:25:32,Upscale-Upscale-DUMMY_Gemini_BTCUSD_1h_01_07_22_to_16_06_23.csv,BTC_USD,WEEK,211.69,0.008,31/03/2023 00:00:00,07/04/2023 00:00:00,03/03/2023 00:00:00,TAKE_PROFIT_HIT,SHORT,23948.0,22334.58,22334.58,24485.81,0.905,7.22,2.2,12.76,2,3.1,12.76,0.075,0.143688,TAKER
24/03/2023 00:00:00,19/06/2023 16:25:32,Upscale-Upscale-DUMMY_Gemini_BTCUSD_1h_01_07_22_to_16_06_23.csv,BTC_USD,WEEK,224.45,0.001,19/05/2023 00:00:00,12/05/2023 00:00:00,12/05/2023 00:00:00,EXPIRED,LONG,27941.0,26831.0,39981.24,23927.59,0.124,30.11,16.77,12.02,2,3.0,-1.13,0.075,0.02095575,TAKER
24/03/2023 00:00:00,19/06/2023 16:25:32,Upscale-Upscale-DUMMY_Gemini_BTCUSD_1h_01_07_22_to_16_06_23.csv,BTC_USD,WEEK,223.32,0.001,19/05/2023 00:00:00,12/05/2023 00:00:00,12/05/2023 00:00:00,EXPIRED,LONG,27941.0,26831.0,39981.24,23927.59,0.125,30.11,16.77,12.02,2,3.0,-1.13,0.075,0.02095575,TAKER
20/01/2023 00:00:00,19/06/2023 16:25:32,Upscale-Upscale-DUMMY_Gemini_BTCUSD_1h_01_07_22_to_16_06_23.csv,BTC_USD,WEEK,222.19,0.003,17/03/2023 00:00:00,10/03/2023 00:00:00,10/02/2023 00:00:00,STOP_LOSS_HIT,LONG,23013.0,21483.15,27602.55,21483.15,0.311,16.63,7.12,13.72,2,3.0,-4.64,0.075,0.05177925,TAKER
24/02/2023 00:00:00,19/06/2023 16:25:32,Upscale-Upscale-DUMMY_Gemini_BTCUSD_1h_01_07_22_to_16_06_23.csv,BTC_USD,WEEK,217.55,0.005,21/04/2023 00:00:00,14/04/2023 00:00:00,03/03/2023 00:00:00,TAKE_PROFIT_HIT,SHORT,23468.0,20996.18,20996.18,24291.94,0.539,11.77,3.39,12.27,2,3.0,12.27,0.075,0.088005,TAKER
24/02/2023 00:00:00,19/06/2023 16:25:32,Upscale-Upscale-DUMMY_Gemini_BTCUSD_1h_01_07_22_to_16_06_23.csv,BTC_USD,WEEK,229.82,0.006,21/04/2023 00:00:00,14/04/2023 00:00:00,03/03/2023 00:00:00,TAKE_PROFIT_HIT,SHORT,23468.0,20996.18,20996.18,24291.94,0.613,11.77,3.39,14.73,2,3.0,14.73,0.075,0.10560599999999999,TAKER
24/03/2023 00:00:00,19/06/2023 16:25:32,Upscale-Upscale-DUMMY_Gemini_BTCUSD_1h_01_07_22_to_16_06_23.csv,BTC_USD,WEEK,244.55,0.001,19/05/2023 00:00:00,12/05/2023 00:00:00,12/05/2023 00:00:00,EXPIRED,LONG,27941.0,26831.0,39981.24,23927.59,0.114,30.11,16.77,12.02,2,3.0,-1.13,0.075,0.02095575,TAKER
24/02/2023 00:00:00,19/06/2023 16:25:32,Upscale-Upscale-DUMMY_Gemini_BTCUSD_1h_01_07_22_to_16_06_23.csv,BTC_USD,WEEK,243.42,0.006,21/04/2023 00:00:00,14/04/2023 00:00:00,03/03/2023 00:00:00,TAKE_PROFIT_HIT,SHORT,23468.0,20996.18,20996.18,24291.94,0.578,11.77,3.39,14.73,2,3.0,14.73,0.075,0.10560599999999999,TAKER
27/01/2023 00:00:00,19/06/2023 16:25:32,Upscale-Upscale-DUMMY_Gemini_BTCUSD_1h_01_07_22_to_16_06_23.csv,BTC_USD,WEEK,258.15,0.001,24/03/2023 00:00:00,17/03/2023 00:00:00,03/03/2023 00:00:00,STOP_LOSS_HIT,LONG,23487.0,19907.36,34225.92,19907.36,0.091,31.38,17.98,10.72,1,3.0,-3.6,0.075,0.01761525,TAKER
27/01/2023 00:00:00,19/06/2023 16:25:32,Upscale-Upscale-DUMMY_Gemini_BTCUSD_1h_01_07_22_to_16_06_23.csv,BTC_USD,WEEK,254.55,0.001,24/03/2023 00:00:00,17/03/2023 00:00:00,03/03/2023 00:00:00,STOP_LOSS_HIT,LONG,23487.0,19907.36,34225.92,19907.36,0.092,31.38,17.98,10.72,1,3.0,-3.6,0.075,0.01761525,TAKER
27/01/2023 00:00:00,19/06/2023 16:25:32,Upscale-Upscale-DUMMY_Gemini_BTCUSD_1h_01_07_22_to_16_06_23.csv,BTC_USD,WEEK,250.95,0.001,24/03/2023 00:00:00,17/03/2023 00:00:00,03/03/2023 00:00:00,STOP_LOSS_HIT,LONG,23487.0,19907.36,34225.92,19907.36,0.094,31.38,17.98,10.72,1,3.0,-3.6,0.075,0.01761525,TAKER
24/02/2023 00:00:00,19/06/2023 16:25:32,Upscale-Upscale-DUMMY_Gemini_BTCUSD_1h_01_07_22_to_16_06_23.csv,BTC_USD,WEEK,247.35,0.006,21/04/2023 00:00:00,14/04/2023 00:00:00,03/03/2023 00:00:00,TAKE_PROFIT_HIT,SHORT,23468.0,20996.18,20996.18,24291.94,0.569,11.77,3.39,14.73,2,3.0,14.73,0.075,0.10560599999999999,TAKER
20/01/2023 00:00:00,19/06/2023 16:25:32,Upscale-Upscale-DUMMY_Gemini_BTCUSD_1h_01_07_22_to_16_06_23.csv,BTC_USD,WEEK,262.08,0.003,17/03/2023 00:00:00,10/03/2023 00:00:00,10/02/2023 00:00:00,STOP_LOSS_HIT,LONG,23013.0,21483.15,27602.55,21483.15,0.263,16.63,7.12,13.72,2,3.0,-4.64,0.075,0.05177925,TAKER
03/03/2023 00:00:00,19/06/2023 16:25:32,Upscale-Upscale-DUMMY_Gemini_BTCUSD_1h_01_07_22_to_16_06_23.csv,BTC_USD,WEEK,257.44,0.01,21/04/2023 00:00:00,21/04/2023 00:00:00,10/03/2023 00:00:00,STOP_LOSS_HIT,SHORT,20290.0,20826.59,18680.22,20826.59,0.788,8.62,2.58,15.95,2,3.1,-5.52,0.075,0.152175,TAKER
20/01/2023 00:00:00,19/06/2023 16:25:32,Upscale-Upscale-DUMMY_Gemini_BTCUSD_1h_01_07_22_to_16_06_23.csv,BTC_USD,WEEK,251.92,0.003,17/03/2023 00:00:00,10/03/2023 00:00:00,10/02/2023 00:00:00,STOP_LOSS_HIT,LONG,23013.0,21483.15,27602.55,21483.15,0.274,16.63,7.12,13.72,2,3.0,-4.64,0.075,0.05177925,TAKER
03/03/2023 00:00:00,19/06/2023 16:25:32,Upscale-Upscale-DUMMY_Gemini_BTCUSD_1h_01_07_22_to_16_06_23.csv,BTC_USD,WEEK,247.28,0.009,21/04/2023 00:00:00,21/04/2023 00:00:00,10/03/2023 00:00:00,STOP_LOSS_HIT,SHORT,20290.0,20826.59,18680.22,20826.59,0.738,8.62,2.58,14.35,2,3.1,-4.97,0.075,0.13695749999999998,TAKER
03/03/2023 00:00:00,19/06/2023 16:25:32,Upscale-Upscale-DUMMY_Gemini_BTCUSD_1h_01_07_22_to_16_06_23.csv,BTC_USD,WEEK,242.31,0.009,21/04/2023 00:00:00,21/04/2023 00:00:00,10/03/2023 00:00:00,STOP_LOSS_HIT,SHORT,20290.0,20826.59,18680.22,20826.59,0.754,8.62,2.58,14.35,2,3.1,-4.97,0.075,0.13695749999999998,TAKER
27/01/2023 00:00:00,19/06/2023 16:25:32,Upscale-Upscale-DUMMY_Gemini_BTCUSD_1h_01_07_22_to_16_06_23.csv,BTC_USD,WEEK,237.34,0.001,24/03/2023 00:00:00,17/03/2023 00:00:00,03/03/2023 00:00:00,STOP_LOSS_HIT,LONG,23487.0,19907.36,34225.92,19907.36,0.099,31.38,17.98,10.72,1,3.0,-3.6,0.075,0.01761525,TAKER
24/02/2023 00:00:00,19/06/2023 16:25:32,Upscale-Upscale-DUMMY_Gemini_BTCUSD_1h_01_07_22_to_16_06_23.csv,BTC_USD,WEEK,233.74,0.006,21/04/2023 00:00:00,14/04/2023 00:00:00,03/03/2023 00:00:00,TAKE_PROFIT_HIT,SHORT,23468.0,20996.18,20996.18,24291.94,0.602,11.77,3.39,14.73,2,3.0,14.73,0.075,0.10560599999999999,TAKER
24/03/2023 00:00:00,19/06/2023 16:25:32,Upscale-Upscale-DUMMY_Gemini_BTCUSD_1h_01_07_22_to_16_06_23.csv,BTC_USD,WEEK,248.47,0.001,19/05/2023 00:00:00,12/05/2023 00:00:00,12/05/2023 00:00:00,EXPIRED,LONG,27941.0,26831.0,39981.24,23927.59,0.112,30.11,16.77,12.02,2,3.0,-1.13,0.075,0.02095575,TAKER
17/02/2023 00:00:00,19/06/2023 16:25:32,Upscale-Upscale-DUMMY_Gemini_BTCUSD_1h_01_07_22_to_16_06_23.csv,BTC_USD,WEEK,247.34,0.009,31/03/2023 00:00:00,07/04/2023 00:00:00,03/03/2023 00:00:00,TAKE_PROFIT_HIT,SHORT,23948.0,22334.58,22334.58,24485.81,0.871,7.22,2.2,14.36,2,3.1,14.36,0.075,0.161649,TAKER
03/03/2023 00:00:00,19/06/2023 16:25:32,Upscale-Upscale-DUMMY_Gemini_BTCUSD_1h_01_07_22_to_16_06_23.csv,BTC_USD,WEEK,261.7,0.01,21/04/2023 00:00:00,21/04/2023 00:00:00,10/03/2023 00:00:00,STOP_LOSS_HIT,SHORT,20290.0,20826.59,18680.22,20826.59,0.775,8.62,2.58,15.95,2,3.1,-5.52,0.075,0.152175,TAKER
17/02/2023 00:00:00,19/06/2023 16:25:32,Upscale-Upscale-DUMMY_Gemini_BTCUSD_1h_01_07_22_to_16_06_23.csv,BTC_USD,WEEK,256.18,0.01,31/03/2023 00:00:00,07/04/2023 00:00:00,03/03/2023 00:00:00,TAKE_PROFIT_HIT,SHORT,23948.0,22334.58,22334.58,24485.81,0.935,7.22,2.2,15.95,2,3.1,15.95,0.075,0.17961000000000002,TAKER
27/01/2023 00:00:00,19/06/2023 16:25:32,Upscale-Upscale-DUMMY_Gemini_BTCUSD_1h_01_07_22_to_16_06_23.csv,BTC_USD,WEEK,272.13,0.002,24/03/2023 00:00:00,17/03/2023 00:00:00,03/03/2023 00:00:00,STOP_LOSS_HIT,LONG,23487.0,19907.36,34225.92,19907.36,0.173,31.38,17.98,21.44,3,3.0,-7.19,0.075,0.0352305,TAKER
24/02/2023 00:00:00,19/06/2023 16:25:32,Upscale-Upscale-DUMMY_Gemini_BTCUSD_1h_01_07_22_to_16_06_23.csv,BTC_USD,WEEK,264.94,0.006,21/04/2023 00:00:00,14/04/2023 00:00:00,03/03/2023 00:00:00,TAKE_PROFIT_HIT,SHORT,23468.0,20996.18,20996.18,24291.94,0.531,11.77,3.39,14.73,2,3.0,14.73,0.075,0.10560599999999999,TAKER
24/03/2023 00:00:00,19/06/2023 16:25:32,Upscale-Upscale-DUMMY_Gemini_BTCUSD_1h_01_07_22_to_16_06_23.csv,BTC_USD,WEEK,279.67,0.001,19/05/2023 00:00:00,12/05/2023 00:00:00,12/05/2023 00:00:00,EXPIRED,LONG,27941.0,26831.0,39981.24,23927.59,0.1,30.11,16.77,12.02,1,3.0,-1.13,0.075,0.02095575,TAKER
27/01/2023 00:00:00,19/06/2023 16:25:32,Upscale-Upscale-DUMMY_Gemini_BTCUSD_1h_01_07_22_to_16_06_23.csv,BTC_USD,WEEK,278.54,0.002,24/03/2023 00:00:00,17/03/2023 00:00:00,03/03/2023 00:00:00,STOP_LOSS_HIT,LONG,23487.0,19907.36,34225.92,19907.36,0.169,31.38,17.98,21.44,3,3.0,-7.19,0.075,0.0352305,TAKER
24/02/2023 00:00:00,19/06/2023 16:25:32,Upscale-Upscale-DUMMY_Gemini_BTCUSD_1h_01_07_22_to_16_06_23.csv,BTC_USD,WEEK,271.35,0.007,21/04/2023 00:00:00,14/04/2023 00:00:00,03/03/2023 00:00:00,TAKE_PROFIT_HIT,SHORT,23468.0,20996.18,20996.18,24291.94,0.605,11.77,3.39,17.18,2,3.0,17.18,0.075,0.12320700000000001,TAKER
24/03/2023 00:00:00,19/06/2023 16:25:32,Upscale-Upscale-DUMMY_Gemini_BTCUSD_1h_01_07_22_to_16_06_23.csv,BTC_USD,WEEK,288.53,0.001,19/05/2023 00:00:00,12/05/2023 00:00:00,12/05/2023 00:00:00,EXPIRED,LONG,27941.0,26831.0,39981.24,23927.59,0.097,30.11,16.77,12.02,1,3.0,-1.13,0.075,0.02095575,TAKER
24/03/2023 00:00:00,19/06/2023 16:25:32,Upscale-Upscale-DUMMY_Gemini_BTCUSD_1h_01_07_22_to_16_06_23.csv,BTC_USD,WEEK,287.4,0.001,19/05/2023 00:00:00,12/05/2023 00:00:00,12/05/2023 00:00:00,EXPIRED,LONG,27941.0,26831.0,39981.24,23927.59,0.097,30.11,16.77,12.02,1,3.0,-1.13,0.075,0.02095575,TAKER
27/01/2023 00:00:00,19/06/2023 16:25:32,Upscale-Upscale-DUMMY_Gemini_BTCUSD_1h_01_07_22_to_16_06_23.csv,BTC_USD,WEEK,286.27,0.002,24/03/2023 00:00:00,17/03/2023 00:00:00,03/03/2023 00:00:00,STOP_LOSS_HIT,LONG,23487.0,19907.36,34225.92,19907.36,0.164,31.38,17.98,21.44,2,3.0,-7.19,0.075,0.0352305,TAKER
24/02/2023 00:00:00,19/06/2023 16:25:32,Upscale-Upscale-DUMMY_Gemini_BTCUSD_1h_01_07_22_to_16_06_23.csv,BTC_USD,WEEK,279.08,0.007,21/04/2023 00:00:00,14/04/2023 00:00:00,03/03/2023 00:00:00,TAKE_PROFIT_HIT,SHORT,23468.0,20996.18,20996.18,24291.94,0.589,11.77,3.39,17.18,2,3.0,17.18,0.075,0.12320700000000001,TAKER
17/02/2023 00:00:00,19/06/2023 16:25:32,Upscale-Upscale-DUMMY_Gemini_BTCUSD_1h_01_07_22_to_16_06_23.csv,BTC_USD,WEEK,296.26,0.011,31/03/2023 00:00:00,07/04/2023 00:00:00,03/03/2023 00:00:00,TAKE_PROFIT_HIT,SHORT,23948.0,22334.58,22334.58,24485.81,0.889,7.22,2.2,17.55,2,3.1,17.55,0.075,0.19757099999999997,TAKER
27/01/2023 00:00:00,19/06/2023 16:25:32,Upscale-Upscale-DUMMY_Gemini_BTCUSD_1h_01_07_22_to_16_06_23.csv,BTC_USD,WEEK,313.81,0.002,24/03/2023 00:00:00,17/03/2023 00:00:00,03/03/2023 00:00:00,STOP_LOSS_HIT,LONG,23487.0,19907.36,34225.92,19907.36,0.15,31.38,17.98,21.44,2,3.0,-7.19,0.075,0.0352305,TAKER
27/01/2023 00:00:00,19/06/2023 16:25:32,Upscale-Upscale-DUMMY_Gemini_BTCUSD_1h_01_07_22_to_16_06_23.csv,BTC_USD,WEEK,306.62,0.002,24/03/2023 00:00:00,17/03/2023 00:00:00,03/03/2023 00:00:00,STOP_LOSS_HIT,LONG,23487.0,19907.36,34225.92,19907.36,0.153,31.38,17.98,21.44,2,3.0,-7.19,0.075,0.0352305,TAKER
24/02/2023 00:00:00,19/06/2023 16:25:32,Upscale-Upscale-DUMMY_Gemini_BTCUSD_1h_01_07_22_to_16_06_23.csv,BTC_USD,WEEK,299.43,0.007,21/04/2023 00:00:00,14/04/2023 00:00:00,03/03/2023 00:00:00,TAKE_PROFIT_HIT,SHORT,23468.0,20996.18,20996.18,24291.94,0.549,11.77,3.39,17.18,2,3.0,17.18,0.075,0.12320700000000001,TAKER
24/02/2023 00:00:00,19/06/2023 16:25:32,Upscale-Upscale-DUMMY_Gemini_BTCUSD_1h_01_07_22_to_16_06_23.csv,BTC_USD,WEEK,316.61,0.008,21/04/2023 00:00:00,14/04/2023 00:00:00,03/03/2023 00:00:00,TAKE_PROFIT_HIT,SHORT,23468.0,20996.18,20996.18,24291.94,0.593,11.77,3.39,19.63,2,3.0,19.63,0.075,0.140808,TAKER
20/01/2023 00:00:00,19/06/2023 16:25:32,Upscale-Upscale-DUMMY_Gemini_BTCUSD_1h_01_07_22_to_16_06_23.csv,BTC_USD,WEEK,336.24,0.004,17/03/2023 00:00:00,10/03/2023 00:00:00,10/02/2023 00:00:00,STOP_LOSS_HIT,LONG,23013.0,21483.15,27602.55,21483.15,0.274,16.63,7.12,18.29,2,3.0,-6.19,0.075,0.069039,TAKER
27/01/2023 00:00:00,19/06/2023 16:25:32,Upscale-Upscale-DUMMY_Gemini_BTCUSD_1h_01_07_22_to_16_06_23.csv,BTC_USD,WEEK,330.05,0.002,24/03/2023 00:00:00,17/03/2023 00:00:00,03/03/2023 00:00:00,STOP_LOSS_HIT,LONG,23487.0,19907.36,34225.92,19907.36,0.142,31.38,17.98,21.44,2,3.0,-7.19,0.075,0.0352305,TAKER
27/01/2023 00:00:00,19/06/2023 16:25:32,Upscale-Upscale-DUMMY_Gemini_BTCUSD_1h_01_07_22_to_16_06_23.csv,BTC_USD,WEEK,322.86,0.002,24/03/2023 00:00:00,17/03/2023 00:00:00,03/03/2023 00:00:00,STOP_LOSS_HIT,LONG,23487.0,19907.36,34225.92,19907.36,0.145,31.38,17.98,21.44,2,3.0,-7.19,0.075,0.0352305,TAKER
27/01/2023 00:00:00,19/06/2023 16:25:32,Upscale-Upscale-DUMMY_Gemini_BTCUSD_1h_01_07_22_to_16_06_23.csv,BTC_USD,WEEK,315.67,0.002,24/03/2023 00:00:00,17/03/2023 00:00:00,03/03/2023 00:00:00,STOP_LOSS_HIT,LONG,23487.0,19907.36,34225.92,19907.36,0.149,31.38,17.98,21.44,2,3.0,-7.19,0.075,0.0352305,TAKER
03/03/2023 00:00:00,19/06/2023 16:25:32,Upscale-Upscale-DUMMY_Gemini_BTCUSD_1h_01_07_22_to_16_06_23.csv,BTC_USD,WEEK,308.48,0.011,21/04/2023 00:00:00,21/04/2023 00:00:00,10/03/2023 00:00:00,STOP_LOSS_HIT,SHORT,20290.0,20826.59,18680.22,20826.59,0.724,8.62,2.58,17.54,2,3.1,-6.07,0.075,0.16739249999999997,TAKER
03/03/2023 00:00:00,19/06/2023 16:25:32,Upscale-Upscale-DUMMY_Gemini_BTCUSD_1h_01_07_22_to_16_06_23.csv,BTC_USD,WEEK,302.41,0.011,21/04/2023 00:00:00,21/04/2023 00:00:00,10/03/2023 00:00:00,STOP_LOSS_HIT,SHORT,20290.0,20826.59,18680.22,20826.59,0.738,8.62,2.58,17.54,2,3.1,-6.07,0.075,0.16739249999999997,TAKER
27/01/2023 00:00:00,19/06/2023 16:25:32,Upscale-Upscale-DUMMY_Gemini_BTCUSD_1h_01_07_22_to_16_06_23.csv,BTC_USD,WEEK,296.34,0.002,24/03/2023 00:00:00,17/03/2023 00:00:00,03/03/2023 00:00:00,STOP_LOSS_HIT,LONG,23487.0,19907.36,34225.92,19907.36,0.159,31.38,17.98,21.44,2,3.0,-7.19,0.075,0.0352305,TAKER
20/01/2023 00:00:00,19/06/2023 16:25:32,Upscale-Upscale-DUMMY_Gemini_BTCUSD_1h_01_07_22_to_16_06_23.csv,BTC_USD,WEEK,289.15,0.004,17/03/2023 00:00:00,10/03/2023 00:00:00,10/02/2023 00:00:00,STOP_LOSS_HIT,LONG,23013.0,21483.15,27602.55,21483.15,0.318,16.63,7.12,18.29,2,3.0,-6.19,0.075,0.069039,TAKER
24/02/2023 00:00:00,19/06/2023 16:25:32,Upscale-Upscale-DUMMY_Gemini_BTCUSD_1h_01_07_22_to_16_06_23.csv,BTC_USD,WEEK,282.96,0.007,21/04/2023 00:00:00,14/04/2023 00:00:00,03/03/2023 00:00:00,TAKE_PROFIT_HIT,SHORT,23468.0,20996.18,20996.18,24291.94,0.581,11.77,3.39,17.18,2,3.0,17.18,0.075,0.12320700000000001,TAKER
27/01/2023 00:00:00,19/06/2023 16:25:32,Upscale-Upscale-DUMMY_Gemini_BTCUSD_1h_01_07_22_to_16_06_23.csv,BTC_USD,WEEK,300.14,0.002,24/03/2023 00:00:00,17/03/2023 00:00:00,03/03/2023 00:00:00,STOP_LOSS_HIT,LONG,23487.0,19907.36,34225.92,19907.36,0.157,31.38,17.98,21.44,2,3.0,-7.19,0.075,0.0352305,TAKER
24/03/2023 00:00:00,19/06/2023 16:25:32,Upscale-Upscale-DUMMY_Gemini_BTCUSD_1h_01_07_22_to_16_06_23.csv,BTC_USD,WEEK,292.95,0.001,19/05/2023 00:00:00,12/05/2023 00:00:00,12/05/2023 00:00:00,EXPIRED,LONG,27941.0,26831.0,39981.24,23927.59,0.095,30.11,16.77,12.02,1,3.0,-1.13,0.075,0.02095575,TAKER
17/02/2023 00:00:00,19/06/2023 16:25:32,Upscale-Upscale-DUMMY_Gemini_BTCUSD_1h_01_07_22_to_16_06_23.csv,BTC_USD,WEEK,291.82,0.011,31/03/2023 00:00:00,07/04/2023 00:00:00,03/03/2023 00:00:00,TAKE_PROFIT_HIT,SHORT,23948.0,22334.58,22334.58,24485.81,0.903,7.22,2.2,17.55,2,3.1,17.55,0.075,0.19757099999999997,TAKER
20/01/2023 00:00:00,19/06/2023 16:25:32,Upscale-Upscale-DUMMY_Gemini_BTCUSD_1h_01_07_22_to_16_06_23.csv,BTC_USD,WEEK,309.37,0.004,17/03/2023 00:00:00,10/03/2023 00:00:00,10/02/2023 00:00:00,STOP_LOSS_HIT,LONG,23013.0,21483.15,27602.55,21483.15,0.298,16.63,7.12,18.29,2,3.0,-6.19,0.075,0.069039,TAKER
17/02/2023 00:00:00,19/06/2023 16:25:32,Upscale-Upscale-DUMMY_Gemini_BTCUSD_1h_01_07_22_to_16_06_23.csv,BTC_USD,WEEK,303.18,0.011,31/03/2023 00:00:00,07/04/2023 00:00:00,03/03/2023 00:00:00,TAKE_PROFIT_HIT,SHORT,23948.0,22334.58,22334.58,24485.81,0.869,7.22,2.2,17.55,2,3.1,17.55,0.075,0.19757099999999997,TAKER
24/03/2023 00:00:00,19/06/2023 16:25:32,Upscale-Upscale-DUMMY_Gemini_BTCUSD_1h_01_07_22_to_16_06_23.csv,BTC_USD,WEEK,320.73,0.002,19/05/2023 00:00:00,12/05/2023 00:00:00,12/05/2023 00:00:00,EXPIRED,LONG,27941.0,26831.0,39981.24,23927.59,0.174,30.11,16.77,24.04,2,3.0,-2.26,0.075,0.0419115,TAKER
24/03/2023 00:00:00,19/06/2023 16:25:32,Upscale-Upscale-DUMMY_Gemini_BTCUSD_1h_01_07_22_to_16_06_23.csv,BTC_USD,WEEK,318.47,0.002,19/05/2023 00:00:00,12/05/2023 00:00:00,12/05/2023 00:00:00,EXPIRED,LONG,27941.0,26831.0,39981.24,23927.59,0.175,30.11,16.77,24.04,3,3.0,-2.26,0.075,0.0419115,TAKER
24/02/2023 00:00:00,19/06/2023 16:25:32,Upscale-Upscale-DUMMY_Gemini_BTCUSD_1h_01_07_22_to_16_06_23.csv,BTC_USD,WEEK,316.21,0.008,21/04/2023 00:00:00,14/04/2023 00:00:00,03/03/2023 00:00:00,TAKE_PROFIT_HIT,SHORT,23468.0,20996.18,20996.18,24291.94,0.594,11.77,3.39,19.63,2,3.0,19.63,0.075,0.140808,TAKER
24/02/2023 00:00:00,19/06/2023 16:25:32,Upscale-Upscale-DUMMY_Gemini_BTCUSD_1h_01_07_22_to_16_06_23.csv,BTC_USD,WEEK,335.84,0.008,21/04/2023 00:00:00,14/04/2023 00:00:00,03/03/2023 00:00:00,TAKE_PROFIT_HIT,SHORT,23468.0,20996.18,20996.18,24291.94,0.559,11.77,3.39,19.63,2,3.0,19.63,0.075,0.140808,TAKER
17/02/2023 00:00:00,19/06/2023 16:25:32,Upscale-Upscale-DUMMY_Gemini_BTCUSD_1h_01_07_22_to_16_06_23.csv,BTC_USD,WEEK,355.47,0.013,31/03/2023 00:00:00,07/04/2023 00:00:00,03/03/2023 00:00:00,TAKE_PROFIT_HIT,SHORT,23948.0,22334.58,22334.58,24485.81,0.876,7.22,2.2,20.74,2,3.1,20.74,0.075,0.233493,TAKER
24/02/2023 00:00:00,19/06/2023 16:25:32,Upscale-Upscale-DUMMY_Gemini_BTCUSD_1h_01_07_22_to_16_06_23.csv,BTC_USD,WEEK,376.21,0.009,21/04/2023 00:00:00,14/04/2023 00:00:00,03/03/2023 00:00:00,TAKE_PROFIT_HIT,SHORT,23468.0,20996.18,20996.18,24291.94,0.561,11.77,3.39,22.09,2,3.0,22.09,0.075,0.15840899999999997,TAKER
20/01/2023 00:00:00,19/06/2023 16:25:32,Upscale-Upscale-DUMMY_Gemini_BTCUSD_1h_01_07_22_to_16_06_23.csv,BTC_USD,WEEK,398.3,0.005,17/03/2023 00:00:00,10/03/2023 00:00:00,10/02/2023 00:00:00,STOP_LOSS_HIT,LONG,23013.0,21483.15,27602.55,21483.15,0.289,16.63,7.12,22.86,2,3.0,-7.74,0.075,0.08629875000000001,TAKER
20/01/2023 00:00:00,19/06/2023 16:25:32,Upscale-Upscale-DUMMY_Gemini_BTCUSD_1h_01_07_22_to_16_06_23.csv,BTC_USD,WEEK,390.56,0.005,17/03/2023 00:00:00,10/03/2023 00:00:00,10/02/2023 00:00:00,STOP_LOSS_HIT,LONG,23013.0,21483.15,27602.55,21483.15,0.295,16.63,7.12,22.86,2,3.0,-7.74,0.075,0.08629875000000001,TAKER
03/03/2023 00:00:00,19/06/2023 16:25:32,Upscale-Upscale-DUMMY_Gemini_BTCUSD_1h_01_07_22_to_16_06_23.csv,BTC_USD,WEEK,382.82,0.014,21/04/2023 00:00:00,21/04/2023 00:00:00,10/03/2023 00:00:00,STOP_LOSS_HIT,SHORT,20290.0,20826.59,18680.22,20826.59,0.742,8.62,2.58,22.32,2,3.1,-7.73,0.075,0.213045,TAKER
24/02/2023 00:00:00,19/06/2023 16:25:32,Upscale-Upscale-DUMMY_Gemini_BTCUSD_1h_01_07_22_to_16_06_23.csv,BTC_USD,WEEK,375.09,0.009,21/04/2023 00:00:00,14/04/2023 00:00:00,03/03/2023 00:00:00,TAKE_PROFIT_HIT,SHORT,23468.0,20996.18,20996.18,24291.94,0.563,11.77,3.39,22.09,2,3.0,22.09,0.075,0.15840899999999997,TAKER
03/03/2023 00:00:00,19/06/2023 16:25:32,Upscale-Upscale-DUMMY_Gemini_BTCUSD_1h_01_07_22_to_16_06_23.csv,BTC_USD,WEEK,397.18,0.015,21/04/2023 00:00:00,21/04/2023 00:00:00,10/03/2023 00:00:00,STOP_LOSS_HIT,SHORT,20290.0,20826.59,18680.22,20826.59,0.766,8.62,2.58,23.92,2,3.1,-8.28,0.075,0.22826249999999998,TAKER
17/02/2023 00:00:00,19/06/2023 16:25:32,Upscale-Upscale-DUMMY_Gemini_BTCUSD_1h_01_07_22_to_16_06_23.csv,BTC_USD,WEEK,388.9,0.014,31/03/2023 00:00:00,07/04/2023 00:00:00,03/03/2023 00:00:00,TAKE_PROFIT_HIT,SHORT,23948.0,22334.58,22334.58,24485.81,0.862,7.22,2.2,22.34,2,3.1,22.34,0.075,0.251454,TAKER
24/02/2023 00:00:00,19/06/2023 16:25:32,Upscale-Upscale-DUMMY_Gemini_BTCUSD_1h_01_07_22_to_16_06_23.csv,BTC_USD,WEEK,411.24,0.01,21/04/2023 00:00:00,14/04/2023 00:00:00,03/03/2023 00:00:00,TAKE_PROFIT_HIT,SHORT,23468.0,20996.18,20996.18,24291.94,0.571,11.77,3.39,24.54,2,3.0,24.54,0.075,0.17601,TAKER
27/01/2023 00:00:00,19/06/2023 16:25:32,Upscale-Upscale-DUMMY_Gemini_BTCUSD_1h_01_07_22_to_16_06_23.csv,BTC_USD,WEEK,435.78,0.002,24/03/2023 00:00:00,17/03/2023 00:00:00,03/03/2023 00:00:00,STOP_LOSS_HIT,LONG,23487.0,19907.36,34225.92,19907.36,0.108,31.38,17.98,21.44,2,3.0,-7.19,0.075,0.0352305,TAKER
27/01/2023 00:00:00,19/06/2023 16:25:32,Upscale-Upscale-DUMMY_Gemini_BTCUSD_1h_01_07_22_to_16_06_23.csv,BTC_USD,WEEK,428.59,0.002,24/03/2023 00:00:00,17/03/2023 00:00:00,03/03/2023 00:00:00,STOP_LOSS_HIT,LONG,23487.0,19907.36,34225.92,19907.36,0.11,31.38,17.98,21.44,2,3.0,-7.19,0.075,0.0352305,TAKER
24/02/2023 00:00:00,19/06/2023 16:25:32,Upscale-Upscale-DUMMY_Gemini_BTCUSD_1h_01_07_22_to_16_06_23.csv,BTC_USD,WEEK,421.4,0.01,21/04/2023 00:00:00,14/04/2023 00:00:00,03/03/2023 00:00:00,TAKE_PROFIT_HIT,SHORT,23468.0,20996.18,20996.18,24291.94,0.557,11.77,3.39,24.54,2,3.0,24.54,0.075,0.17601,TAKER
24/03/2023 00:00:00,19/06/2023 16:25:32,Upscale-Upscale-DUMMY_Gemini_BTCUSD_1h_01_07_22_to_16_06_23.csv,BTC_USD,WEEK,445.94,0.002,19/05/2023 00:00:00,12/05/2023 00:00:00,12/05/2023 00:00:00,EXPIRED,LONG,27941.0,26831.0,39981.24,23927.59,0.125,30.11,16.77,24.04,2,3.0,-2.26,0.075,0.0419115,TAKER
27/01/2023 00:00:00,19/06/2023 16:25:32,Upscale-Upscale-DUMMY_Gemini_BTCUSD_1h_01_07_22_to_16_06_23.csv,BTC_USD,WEEK,443.68,0.002,24/03/2023 00:00:00,17/03/2023 00:00:00,03/03/2023 00:00:00,STOP_LOSS_HIT,LONG,23487.0,19907.36,34225.92,19907.36,0.106,31.38,17.98,21.44,2,3.0,-7.19,0.075,0.0352305,TAKER
24/03/2023 00:00:00,19/06/2023 16:25:32,Upscale-Upscale-DUMMY_Gemini_BTCUSD_1h_01_07_22_to_16_06_23.csv,BTC_USD,WEEK,436.49,0.002,19/05/2023 00:00:00,12/05/2023 00:00:00,12/05/2023 00:00:00,EXPIRED,LONG,27941.0,26831.0,39981.24,23927.59,0.128,30.11,16.77,24.04,2,3.0,-2.26,0.075,0.0419115,TAKER
24/02/2023 00:00:00,19/06/2023 16:25:32,Upscale-Upscale-DUMMY_Gemini_BTCUSD_1h_01_07_22_to_16_06_23.csv,BTC_USD,WEEK,434.23,0.011,21/04/2023 00:00:00,14/04/2023 00:00:00,03/03/2023 00:00:00,TAKE_PROFIT_HIT,SHORT,23468.0,20996.18,20996.18,24291.94,0.594,11.77,3.39,27.0,2,3.0,27.0,0.075,0.19361099999999998,TAKER
17/02/2023 00:00:00,19/06/2023 16:25:32,Upscale-Upscale-DUMMY_Gemini_BTCUSD_1h_01_07_22_to_16_06_23.csv,BTC_USD,WEEK,461.23,0.017,31/03/2023 00:00:00,07/04/2023 00:00:00,03/03/2023 00:00:00,TAKE_PROFIT_HIT,SHORT,23948.0,22334.58,22334.58,24485.81,0.883,7.22,2.2,27.12,2,3.1,27.12,0.075,0.305337,TAKER
20/01/2023 00:00:00,19/06/2023 16:25:32,Upscale-Upscale-DUMMY_Gemini_BTCUSD_1h_01_07_22_to_16_06_23.csv,BTC_USD,WEEK,488.35,0.006,17/03/2023 00:00:00,10/03/2023 00:00:00,10/02/2023 00:00:00,STOP_LOSS_HIT,LONG,23013.0,21483.15,27602.55,21483.15,0.283,16.63,7.12,27.43,2,3.0,-9.28,0.075,0.1035585,TAKER
24/02/2023 00:00:00,19/06/2023 16:25:32,Upscale-Upscale-DUMMY_Gemini_BTCUSD_1h_01_07_22_to_16_06_23.csv,BTC_USD,WEEK,479.07,0.012,21/04/2023 00:00:00,14/04/2023 00:00:00,03/03/2023 00:00:00,TAKE_PROFIT_HIT,SHORT,23468.0,20996.18,20996.18,24291.94,0.588,11.77,3.39,29.45,2,3.0,29.45,0.075,0.21121199999999998,TAKER
24/03/2023 00:00:00,19/06/2023 16:25:32,Upscale-Upscale-DUMMY_Gemini_BTCUSD_1h_01_07_22_to_16_06_23.csv,BTC_USD,WEEK,508.52,0.003,19/05/2023 00:00:00,12/05/2023 00:00:00,12/05/2023 00:00:00,EXPIRED,LONG,27941.0,26831.0,39981.24,23927.59,0.165,30.11,16.77,36.06,2,3.0,-3.39,0.075,0.06286725,TAKER
03/03/2023 00:00:00,19/06/2023 16:25:32,Upscale-Upscale-DUMMY_Gemini_BTCUSD_1h_01_07_22_to_16_06_23.csv,BTC_USD,WEEK,505.13,0.019,21/04/2023 00:00:00,21/04/2023 00:00:00,10/03/2023 00:00:00,STOP_LOSS_HIT,SHORT,20290.0,20826.59,18680.22,20826.59,0.763,8.62,2.58,30.3,2,3.1,-10.48,0.075,0.28913249999999996,TAKER
03/03/2023 00:00:00,19/06/2023 16:25:32,Upscale-Upscale-DUMMY_Gemini_BTCUSD_1h_01_07_22_to_16_06_23.csv,BTC_USD,WEEK,494.65,0.018,21/04/2023 00:00:00,21/04/2023 00:00:00,10/03/2023 00:00:00,STOP_LOSS_HIT,SHORT,20290.0,20826.59,18680.22,20826.59,0.738,8.62,2.58,28.7,2,3.1,-9.93,0.075,0.27391499999999996,TAKER
24/02/2023 00:00:00,19/06/2023 16:25:32,Upscale-Upscale-DUMMY_Gemini_BTCUSD_1h_01_07_22_to_16_06_23.csv,BTC_USD,WEEK,484.72,0.012,21/04/2023 00:00:00,14/04/2023 00:00:00,03/03/2023 00:00:00,TAKE_PROFIT_HIT,SHORT,23468.0,20996.18,20996.18,24291.94,0.581,11.77,3.39,29.45,2,3.0,29.45,0.075,0.21121199999999998,TAKER
24/02/2023 00:00:00,19/06/2023 16:25:32,Upscale-Upscale-DUMMY_Gemini_BTCUSD_1h_01_07_22_to_16_06_23.csv,BTC_USD,WEEK,514.17,0.012,21/04/2023 00:00:00,14/04/2023 00:00:00,03/03/2023 00:00:00,TAKE_PROFIT_HIT,SHORT,23468.0,20996.18,20996.18,24291.94,0.548,11.77,3.39,29.45,2,3.0,29.45,0.075,0.21121199999999998,TAKER
17/02/2023 00:00:00,19/06/2023 16:25:32,Upscale-Upscale-DUMMY_Gemini_BTCUSD_1h_01_07_22_to_16_06_23.csv,BTC_USD,WEEK,543.62,0.02,31/03/2023 00:00:00,07/04/2023 00:00:00,03/03/2023 00:00:00,TAKE_PROFIT_HIT,SHORT,23948.0,22334.58,22334.58,24485.81,0.881,7.22,2.2,31.91,2,3.1,31.91,0.075,0.35922000000000004,TAKER
03/03/2023 00:00:00,19/06/2023 16:25:32,Upscale-Upscale-DUMMY_Gemini_BTCUSD_1h_01_07_22_to_16_06_23.csv,BTC_USD,WEEK,575.53,0.021,21/04/2023 00:00:00,21/04/2023 00:00:00,10/03/2023 00:00:00,STOP_LOSS_HIT,SHORT,20290.0,20826.59,18680.22,20826.59,0.74,8.62,2.58,33.49,2,3.1,-11.59,0.075,0.3195675,TAKER
17/02/2023 00:00:00,19/06/2023 16:25:32,Upscale-Upscale-DUMMY_Gemini_BTCUSD_1h_01_07_22_to_16_06_23.csv,BTC_USD,WEEK,563.94,0.021,31/03/2023 00:00:00,07/04/2023 00:00:00,03/03/2023 00:00:00,TAKE_PROFIT_HIT,SHORT,23948.0,22334.58,22334.58,24485.81,0.892,7.22,2.2,33.5,2,3.1,33.5,0.075,0.377181,TAKER
03/03/2023 00:00:00,19/06/2023 16:25:32,Upscale-Upscale-DUMMY_Gemini_BTCUSD_1h_01_07_22_to_16_06_23.csv,BTC_USD,WEEK,597.44,0.022,21/04/2023 00:00:00,21/04/2023 00:00:00,10/03/2023 00:00:00,STOP_LOSS_HIT,SHORT,20290.0,20826.59,18680.22,20826.59,0.747,8.62,2.58,35.08,2,3.1,-12.14,0.075,0.33478499999999994,TAKER
20/01/2023 00:00:00,19/06/2023 16:25:32,Upscale-Upscale-DUMMY_Gemini_BTCUSD_1h_01_07_22_to_16_06_23.csv,BTC_USD,WEEK,585.3,0.008,17/03/2023 00:00:00,10/03/2023 00:00:00,10/02/2023 00:00:00,STOP_LOSS_HIT,LONG,23013.0,21483.15,27602.55,21483.15,0.315,16.63,7.12,36.58,2,3.0,-12.38,0.075,0.138078,TAKER
03/03/2023 00:00:00,19/06/2023 16:25:32,Upscale-Upscale-DUMMY_Gemini_BTCUSD_1h_01_07_22_to_16_06_23.csv,BTC_USD,WEEK,572.92,0.021,21/04/2023 00:00:00,21/04/2023 00:00:00,10/03/2023 00:00:00,STOP_LOSS_HIT,SHORT,20290.0,20826.59,18680.22,20826.59,0.744,8.62,2.58,33.49,2,3.1,-11.59,0.075,0.3195675,TAKER
03/03/2023 00:00:00,19/06/2023 16:25:32,Upscale-Upscale-DUMMY_Gemini_BTCUSD_1h_01_07_22_to_16_06_23.csv,BTC_USD,WEEK,561.33,0.021,21/04/2023 00:00:00,21/04/2023 00:00:00,10/03/2023 00:00:00,STOP_LOSS_HIT,SHORT,20290.0,20826.59,18680.22,20826.59,0.759,8.62,2.58,33.49,2,3.1,-11.59,0.075,0.3195675,TAKER
17/02/2023 00:00:00,19/06/2023 16:25:32,Upscale-Upscale-DUMMY_Gemini_BTCUSD_1h_01_07_22_to_16_06_23.csv,BTC_USD,WEEK,549.74,0.02,31/03/2023 00:00:00,07/04/2023 00:00:00,03/03/2023 00:00:00,TAKE_PROFIT_HIT,SHORT,23948.0,22334.58,22334.58,24485.81,0.871,7.22,2.2,31.91,2,3.1,31.91,0.075,0.35922000000000004,TAKER
20/01/2023 00:00:00,19/06/2023 16:25:32,Upscale-Upscale-DUMMY_Gemini_BTCUSD_1h_01_07_22_to_16_06_23.csv,BTC_USD,WEEK,581.65,0.008,17/03/2023 00:00:00,10/03/2023 00:00:00,10/02/2023 00:00:00,STOP_LOSS_HIT,LONG,23013.0,21483.15,27602.55,21483.15,0.317,16.63,7.12,36.58,2,3.0,-12.38,0.075,0.138078,TAKER
03/03/2023 00:00:00,19/06/2023 16:25:32,Upscale-Upscale-DUMMY_Gemini_BTCUSD_1h_01_07_22_to_16_06_23.csv,BTC_USD,WEEK,569.27,0.021,21/04/2023 00:00:00,21/04/2023 00:00:00,10/03/2023 00:00:00,STOP_LOSS_HIT,SHORT,20290.0,20826.59,18680.22,20826.59,0.748,8.62,2.58,33.49,2,3.1,-11.59,0.075,0.3195675,TAKER
24/03/2023 00:00:00,19/06/2023 16:25:32,Upscale-Upscale-DUMMY_Gemini_BTCUSD_1h_01_07_22_to_16_06_23.csv,BTC_USD,WEEK,557.68,0.003,19/05/2023 00:00:00,12/05/2023 00:00:00,12/05/2023 00:00:00,EXPIRED,LONG,27941.0,26831.0,39981.24,23927.59,0.15,30.11,16.77,36.06,2,3.0,-3.39,0.075,0.06286725,TAKER
17/02/2023 00:00:00,19/06/2023 16:25:32,Upscale-Upscale-DUMMY_Gemini_BTCUSD_1h_01_07_22_to_16_06_23.csv,BTC_USD,WEEK,554.29,0.021,31/03/2023 00:00:00,07/04/2023 00:00:00,03/03/2023 00:00:00,TAKE_PROFIT_HIT,SHORT,23948.0,22334.58,22334.58,24485.81,0.907,7.22,2.2,33.5,2,3.1,33.5,0.075,0.377181,TAKER
20/01/2023 00:00:00,19/06/2023 16:25:32,Upscale-Upscale-DUMMY_Gemini_BTCUSD_1h_01_07_22_to_16_06_23.csv,BTC_USD,WEEK,587.79,0.008,17/03/2023 00:00:00,10/03/2023 00:00:00,10/02/2023 00:00:00,STOP_LOSS_HIT,LONG,23013.0,21483.15,27602.55,21483.15,0.313,16.63,7.12,36.58,2,3.0,-12.38,0.075,0.138078,TAKER
24/03/2023 00:00:00,19/06/2023 16:25:32,Upscale-Upscale-DUMMY_Gemini_BTCUSD_1h_01_07_22_to_16_06_23.csv,BTC_USD,WEEK,575.41,0.003,19/05/2023 00:00:00,12/05/2023 00:00:00,12/05/2023 00:00:00,EXPIRED,LONG,27941.0,26831.0,39981.24,23927.59,0.146,30.11,16.77,36.06,2,3.0,-3.39,0.075,0.06286725,TAKER
27/01/2023 00:00:00,19/06/2023 16:25:32,Upscale-Upscale-DUMMY_Gemini_BTCUSD_1h_01_07_22_to_16_06_23.csv,BTC_USD,WEEK,572.02,0.003,24/03/2023 00:00:00,17/03/2023 00:00:00,03/03/2023 00:00:00,STOP_LOSS_HIT,LONG,23487.0,19907.36,34225.92,19907.36,0.123,31.38,17.98,32.16,2,3.0,-10.79,0.075,0.05284575,TAKER
17/02/2023 00:00:00,19/06/2023 16:25:32,Upscale-Upscale-DUMMY_Gemini_BTCUSD_1h_01_07_22_to_16_06_23.csv,BTC_USD,WEEK,561.23,0.021,31/03/2023 00:00:00,07/04/2023 00:00:00,03/03/2023 00:00:00,TAKE_PROFIT_HIT,SHORT,23948.0,22334.58,22334.58,24485.81,0.896,7.22,2.2,33.5,2,3.1,33.5,0.075,0.377181,TAKER
17/02/2023 00:00:00,19/06/2023 16:25:32,Upscale-Upscale-DUMMY_Gemini_BTCUSD_1h_01_07_22_to_16_06_23.csv,BTC_USD,WEEK,594.73,0.022,31/03/2023 00:00:00,07/04/2023 00:00:00,03/03/2023 00:00:00,TAKE_PROFIT_HIT,SHORT,23948.0,22334.58,22334.58,24485.81,0.886,7.22,2.2,35.1,2,3.1,35.1,0.075,0.39514199999999994,TAKER
