Open,Last update,Platform,Symbol,Timeframe,Account balance at open,Size,Expected close,Expiry,Close,Status,Side,Opening price,Closing price,Take profit,Stop loss,Leverage,TP price %,SL price %,Expected profit,Risk %,R/R ratio,PnL,Fee %,Fee Amount,Order Type
08/07/2022 21:00:00,19/06/2023 16:06:36,DUMMY_Gemini_BTCUSD_1h_01_07_22_to_16_06_23.csv,BTC_USD,HOUR,200.0,0.016,09/07/2022 05:00:00,09/07/2022 04:00:00,08/07/2022 23:00:00,STOP_LOSS_HIT,SHORT,21701.0,21946.89,20963.33,21946.89,1.736,3.52,1.12,11.54,2,3.1,-4.19,0.075,0.260412,TAKER
29/03/2023 04:00:00,19/06/2023 16:06:36,DUMMY_Gemini_BTCUSD_1h_01_07_22_to_16_06_23.csv,BTC_USD,HOUR,195.81,0.014,29/03/2023 06:00:00,29/03/2023 11:00:00,29/03/2023 08:00:00,TAKE_PROFIT_HIT,LONG,27572.0,28407.31,28407.31,27293.57,1.971,2.94,1.02,11.4,2,3.2,11.4,0.075,0.289506,TAKER
14/09/2022 23:00:00,19/06/2023 16:06:36,DUMMY_Gemini_BTCUSD_1h_01_07_22_to_16_06_23.csv,BTC_USD,HOUR,207.21,0.009,15/09/2022 05:00:00,15/09/2022 06:00:00,15/09/2022 06:00:00,EXPIRED,LONG,20234.0,20105.0,21585.88,19783.38,0.879,6.26,2.28,12.03,2,3.1,-1.3,0.075,0.1365795,TAKER
30/11/2022 05:00:00,19/06/2023 16:06:36,DUMMY_Gemini_BTCUSD_1h_01_07_22_to_16_06_23.csv,BTC_USD,HOUR,205.91,0.021,30/11/2022 11:00:00,30/11/2022 12:00:00,30/11/2022 12:00:00,EXPIRED,LONG,16869.0,16779.0,17456.79,16673.07,1.72,3.37,1.18,12.08,2,3.1,-2.16,0.075,0.26568675,TAKER
20/05/2023 18:00:00,19/06/2023 16:06:36,DUMMY_Gemini_BTCUSD_1h_01_07_22_to_16_06_23.csv,BTC_USD,HOUR,203.75,0.007,21/05/2023 00:00:00,21/05/2023 01:00:00,21/05/2023 01:00:00,EXPIRED,LONG,27041.0,27177.0,28827.78,26445.41,0.929,6.2,2.25,12.37,2,3.1,0.81,0.075,0.14196525,TAKER
10/10/2022 06:00:00,19/06/2023 16:06:36,DUMMY_Gemini_BTCUSD_1h_01_07_22_to_16_06_23.csv,BTC_USD,HOUR,204.56,0.02,10/10/2022 09:00:00,10/10/2022 13:00:00,10/10/2022 08:00:00,STOP_LOSS_HIT,LONG,19397.0,19193.83,20006.5,19193.83,1.896,3.05,1.06,11.9,2,3.2,-4.35,0.075,0.29095499999999996,TAKER
28/05/2023 03:00:00,19/06/2023 16:06:36,DUMMY_Gemini_BTCUSD_1h_01_07_22_to_16_06_23.csv,BTC_USD,HOUR,200.21,0.012,28/05/2023 10:00:00,28/05/2023 10:00:00,28/05/2023 10:00:00,EXPIRED,LONG,27201.0,27228.0,28184.5,26873.17,1.63,3.49,1.22,11.56,2,3.1,0.08,0.075,0.24480900000000003,TAKER
16/11/2022 10:00:00,19/06/2023 16:06:36,DUMMY_Gemini_BTCUSD_1h_01_07_22_to_16_06_23.csv,BTC_USD,HOUR,200.29,0.018,16/11/2022 12:00:00,16/11/2022 17:00:00,16/11/2022 13:00:00,STOP_LOSS_HIT,LONG,16711.0,16493.45,17363.67,16493.45,1.502,3.76,1.32,11.52,2,3.1,-4.14,0.075,0.2255985,TAKER
29/01/2023 14:00:00,19/06/2023 16:06:36,DUMMY_Gemini_BTCUSD_1h_01_07_22_to_16_06_23.csv,BTC_USD,HOUR,196.15,0.009,29/01/2023 20:00:00,29/01/2023 21:00:00,29/01/2023 21:00:00,EXPIRED,LONG,23553.0,23814.0,24915.65,23098.78,1.081,5.47,1.97,12.1,2,3.1,2.19,0.075,0.15898274999999998,TAKER
04/12/2022 09:00:00,19/06/2023 16:06:36,DUMMY_Gemini_BTCUSD_1h_01_07_22_to_16_06_23.csv,BTC_USD,HOUR,198.34,0.022,04/12/2022 11:00:00,04/12/2022 16:00:00,04/12/2022 16:00:00,EXPIRED,LONG,17014.0,17017.0,17567.2,16829.6,1.887,3.15,1.1,11.89,2,3.1,-0.21,0.075,0.280731,TAKER
13/03/2023 15:00:00,19/06/2023 16:06:36,DUMMY_Gemini_BTCUSD_1h_01_07_22_to_16_06_23.csv,BTC_USD,HOUR,198.13,0.009,13/03/2023 22:00:00,13/03/2023 22:00:00,13/03/2023 22:00:00,EXPIRED,LONG,24145.0,24327.0,25412.16,23722.61,1.097,4.99,1.78,11.24,2,3.1,1.48,0.075,0.16297874999999998,TAKER
01/03/2023 05:00:00,19/06/2023 16:06:36,DUMMY_Gemini_BTCUSD_1h_01_07_22_to_16_06_23.csv,BTC_USD,HOUR,199.61,0.006,01/03/2023 08:00:00,01/03/2023 12:00:00,01/03/2023 12:00:00,EXPIRED,LONG,23698.0,23726.0,25714.1,23025.97,0.712,7.84,2.92,11.99,2,3.1,0.06,0.075,0.10664100000000001,TAKER
29/10/2022 23:00:00,19/06/2023 16:06:36,DUMMY_Gemini_BTCUSD_1h_01_07_22_to_16_06_23.csv,BTC_USD,HOUR,199.67,0.018,30/10/2022 01:00:00,30/10/2022 06:00:00,30/10/2022 06:00:00,EXPIRED,LONG,20822.0,20899.0,21490.87,20599.05,1.877,3.11,1.08,11.76,2,3.2,1.1,0.075,0.281097,TAKER
08/08/2022 04:00:00,19/06/2023 16:06:36,DUMMY_Gemini_BTCUSD_1h_01_07_22_to_16_06_23.csv,BTC_USD,HOUR,200.77,0.015,08/08/2022 10:00:00,08/08/2022 11:00:00,08/08/2022 08:00:00,TAKE_PROFIT_HIT,LONG,23334.0,24134.71,24134.71,23067.1,1.743,3.32,1.16,11.75,2,3.1,11.75,0.075,0.2625075,TAKER
28/04/2023 05:00:00,19/06/2023 16:06:36,DUMMY_Gemini_BTCUSD_1h_01_07_22_to_16_06_23.csv,BTC_USD,HOUR,212.52,0.008,28/04/2023 13:00:00,28/04/2023 12:00:00,28/04/2023 12:00:00,EXPIRED,LONG,29488.0,29235.0,31083.97,28956.01,1.11,5.13,1.84,12.59,2,3.1,-2.2,0.075,0.17692799999999997,TAKER
20/02/2023 22:00:00,19/06/2023 16:06:36,DUMMY_Gemini_BTCUSD_1h_01_07_22_to_16_06_23.csv,BTC_USD,HOUR,210.32,0.015,21/02/2023 00:00:00,21/02/2023 05:00:00,21/02/2023 05:00:00,EXPIRED,LONG,24706.0,24952.0,25550.5,24424.5,1.762,3.31,1.15,12.39,2,3.1,3.41,0.075,0.2779425,TAKER
12/09/2022 17:00:00,19/06/2023 16:06:36,DUMMY_Gemini_BTCUSD_1h_01_07_22_to_16_06_23.csv,BTC_USD,HOUR,213.73,0.018,12/09/2022 19:00:00,13/09/2022 00:00:00,13/09/2022 00:00:00,EXPIRED,LONG,22367.0,22171.0,23075.04,22130.99,1.884,3.07,1.07,12.44,2,3.1,-3.83,0.075,0.30195449999999996,TAKER
25/02/2023 23:00:00,19/06/2023 16:06:36,DUMMY_Gemini_BTCUSD_1h_01_07_22_to_16_06_23.csv,BTC_USD,HOUR,209.9,0.014,26/02/2023 02:00:00,26/02/2023 06:00:00,26/02/2023 06:00:00,EXPIRED,LONG,23171.0,23162.0,24065.82,22872.73,1.545,3.72,1.3,12.28,2,3.1,-0.37,0.075,0.2432955,TAKER
14/02/2023 21:00:00,19/06/2023 16:06:36,DUMMY_Gemini_BTCUSD_1h_01_07_22_to_16_06_23.csv,BTC_USD,HOUR,209.53,0.018,15/02/2023 03:00:00,15/02/2023 04:00:00,15/02/2023 04:00:00,EXPIRED,SHORT,22247.0,22088.0,21554.39,22477.87,1.911,3.21,1.03,12.17,2,3.2,2.56,0.075,0.30033449999999995,TAKER
18/02/2023 15:00:00,19/06/2023 16:06:36,DUMMY_Gemini_BTCUSD_1h_01_07_22_to_16_06_23.csv,BTC_USD,HOUR,212.09,0.007,18/02/2023 19:00:00,18/02/2023 22:00:00,18/02/2023 22:00:00,EXPIRED,LONG,24682.0,24637.0,26482.43,24081.86,0.815,6.8,2.49,12.47,2,3.1,-0.44,0.075,0.1295805,TAKER
24/11/2022 06:00:00,19/06/2023 16:06:36,DUMMY_Gemini_BTCUSD_1h_01_07_22_to_16_06_23.csv,BTC_USD,HOUR,211.65,0.022,24/11/2022 11:00:00,24/11/2022 13:00:00,24/11/2022 08:00:00,STOP_LOSS_HIT,LONG,16710.0,16518.71,17283.86,16518.71,1.737,3.32,1.16,12.35,2,3.1,-4.48,0.075,0.275715,TAKER
26/05/2023 17:00:00,19/06/2023 16:06:36,DUMMY_Gemini_BTCUSD_1h_01_07_22_to_16_06_23.csv,BTC_USD,HOUR,207.17,0.01,26/05/2023 22:00:00,27/05/2023 00:00:00,27/05/2023 00:00:00,EXPIRED,LONG,26719.0,26668.0,28008.7,26289.1,1.29,4.6,1.64,12.7,2,3.1,-0.71,0.075,0.2003925,TAKER
08/10/2022 17:00:00,19/06/2023 16:06:36,DUMMY_Gemini_BTCUSD_1h_01_07_22_to_16_06_23.csv,BTC_USD,HOUR,206.46,0.02,09/10/2022 00:00:00,09/10/2022 00:00:00,08/10/2022 21:00:00,STOP_LOSS_HIT,LONG,19508.0,19306.26,20113.21,19306.26,1.89,3.01,1.04,11.81,2,3.2,-4.33,0.075,0.29262,TAKER
04/05/2023 01:00:00,19/06/2023 16:06:36,DUMMY_Gemini_BTCUSD_1h_01_07_22_to_16_06_23.csv,BTC_USD,HOUR,202.13,0.006,04/05/2023 09:00:00,04/05/2023 08:00:00,04/05/2023 08:00:00,EXPIRED,SHORT,29061.0,29078.0,27051.25,29730.92,0.863,7.43,2.25,11.93,2,3.1,-0.23,0.075,0.13077450000000002,TAKER
27/07/2022 10:00:00,19/06/2023 16:06:36,DUMMY_Gemini_BTCUSD_1h_01_07_22_to_16_06_23.csv,BTC_USD,HOUR,201.9,0.016,27/07/2022 16:00:00,27/07/2022 17:00:00,27/07/2022 17:00:00,EXPIRED,LONG,21285.0,21635.0,22042.25,21032.59,1.687,3.44,1.2,11.86,2,3.1,5.34,0.075,0.25542,TAKER
20/02/2023 16:00:00,19/06/2023 16:06:36,DUMMY_Gemini_BTCUSD_1h_01_07_22_to_16_06_23.csv,BTC_USD,HOUR,207.24,0.013,21/02/2023 00:00:00,20/02/2023 23:00:00,20/02/2023 23:00:00,EXPIRED,SHORT,24885.0,24838.0,23954.93,25195.02,1.561,3.88,1.23,11.85,2,3.1,0.37,0.075,0.24262874999999998,TAKER
06/08/2022 05:00:00,19/06/2023 16:06:36,DUMMY_Gemini_BTCUSD_1h_01_07_22_to_16_06_23.csv,BTC_USD,HOUR,207.61,0.01,06/08/2022 07:00:00,06/08/2022 12:00:00,06/08/2022 12:00:00,EXPIRED,LONG,23199.0,23171.0,24433.02,22787.66,1.117,5.05,1.81,12.17,2,3.1,-0.45,0.075,0.1739925,TAKER
13/12/2022 12:00:00,19/06/2023 16:06:36,DUMMY_Gemini_BTCUSD_1h_01_07_22_to_16_06_23.csv,BTC_USD,HOUR,207.16,0.02,13/12/2022 17:00:00,13/12/2022 19:00:00,13/12/2022 19:00:00,EXPIRED,LONG,17428.0,17735.0,18052.76,17219.75,1.683,3.46,1.21,12.23,2,3.1,5.88,0.075,0.26142,TAKER
07/02/2023 23:00:00,19/06/2023 16:06:36,DUMMY_Gemini_BTCUSD_1h_01_07_22_to_16_06_23.csv,BTC_USD,HOUR,213.04,0.016,08/02/2023 07:00:00,08/02/2023 06:00:00,08/02/2023 06:00:00,EXPIRED,SHORT,23254.0,23207.0,22452.27,23521.24,1.746,3.57,1.14,12.55,2,3.1,0.47,0.075,0.279048,TAKER
10/04/2023 21:00:00,19/06/2023 16:06:36,DUMMY_Gemini_BTCUSD_1h_01_07_22_to_16_06_23.csv,BTC_USD,HOUR,213.51,0.013,11/04/2023 03:00:00,11/04/2023 04:00:00,10/04/2023 22:00:00,STOP_LOSS_HIT,SHORT,29241.0,29579.32,28226.03,29579.32,1.78,3.6,1.14,12.91,2,3.1,-4.68,0.075,0.28509975,TAKER
11/02/2023 16:00:00,19/06/2023 16:06:36,DUMMY_Gemini_BTCUSD_1h_01_07_22_to_16_06_23.csv,BTC_USD,HOUR,208.83,0.011,12/02/2023 00:00:00,11/02/2023 23:00:00,11/02/2023 23:00:00,EXPIRED,SHORT,21702.0,21860.0,20514.51,22097.83,1.143,5.79,1.79,12.88,2,3.1,-1.92,0.075,0.17904149999999996,TAKER
15/07/2022 20:00:00,19/06/2023 16:06:36,DUMMY_Gemini_BTCUSD_1h_01_07_22_to_16_06_23.csv,BTC_USD,HOUR,206.91,0.012,15/07/2022 22:00:00,16/07/2022 03:00:00,16/07/2022 03:00:00,EXPIRED,LONG,20932.0,20739.0,21950.46,20592.51,1.214,4.64,1.65,12.03,2,3.1,-2.5,0.075,0.188388,TAKER
29/07/2022 04:00:00,19/06/2023 16:06:36,DUMMY_Gemini_BTCUSD_1h_01_07_22_to_16_06_23.csv,BTC_USD,HOUR,204.41,0.011,29/07/2022 12:00:00,29/07/2022 11:00:00,29/07/2022 11:00:00,STOP_LOSS_HIT,LONG,24014.0,23635.11,25150.66,23635.11,1.292,4.52,1.6,12.31,2,3.1,-4.37,0.075,0.1981155,TAKER
15/07/2022 19:00:00,19/06/2023 16:06:36,DUMMY_Gemini_BTCUSD_1h_01_07_22_to_16_06_23.csv,BTC_USD,HOUR,200.04,0.019,16/07/2022 02:00:00,16/07/2022 02:00:00,15/07/2022 20:00:00,STOP_LOSS_HIT,LONG,21156.0,20942.65,21796.05,20942.65,2.009,2.94,1.02,11.86,2,3.2,-4.36,0.075,0.301473,TAKER
21/11/2022 12:00:00,19/06/2023 16:06:36,DUMMY_Gemini_BTCUSD_1h_01_07_22_to_16_06_23.csv,BTC_USD,HOUR,195.68,0.02,21/11/2022 14:00:00,21/11/2022 19:00:00,21/11/2022 19:00:00,STOP_LOSS_HIT,LONG,16080.0,15879.95,16680.16,15879.95,1.643,3.6,1.26,11.76,2,3.1,-4.24,0.075,0.2412,TAKER
06/02/2023 20:00:00,19/06/2023 16:06:36,DUMMY_Gemini_BTCUSD_1h_01_07_22_to_16_06_23.csv,BTC_USD,HOUR,191.44,0.016,07/02/2023 02:00:00,07/02/2023 03:00:00,07/02/2023 03:00:00,EXPIRED,SHORT,23011.0,22872.0,22274.25,23256.59,1.923,3.31,1.06,11.51,2,3.2,1.95,0.075,0.276132,TAKER
27/02/2023 02:00:00,19/06/2023 16:06:36,DUMMY_Gemini_BTCUSD_1h_01_07_22_to_16_06_23.csv,BTC_USD,HOUR,193.39,0.01,27/02/2023 08:00:00,27/02/2023 09:00:00,27/02/2023 09:00:00,EXPIRED,LONG,23560.0,23396.0,24751.17,23162.94,1.218,4.81,1.71,11.73,2,3.1,-1.82,0.075,0.17669999999999997,TAKER
22/11/2022 19:00:00,19/06/2023 16:06:36,DUMMY_Gemini_BTCUSD_1h_01_07_22_to_16_06_23.csv,BTC_USD,HOUR,191.57,0.021,23/11/2022 00:00:00,23/11/2022 02:00:00,23/11/2022 02:00:00,EXPIRED,LONG,16147.0,16472.0,16705.89,15960.7,1.77,3.35,1.17,11.48,2,3.1,6.57,0.075,0.25431525000000005,TAKER
17/10/2022 16:00:00,19/06/2023 16:06:36,DUMMY_Gemini_BTCUSD_1h_01_07_22_to_16_06_23.csv,BTC_USD,HOUR,198.14,0.017,17/10/2022 22:00:00,17/10/2022 23:00:00,17/10/2022 23:00:00,EXPIRED,LONG,19516.0,19554.0,20197.54,19288.82,1.674,3.37,1.18,11.34,2,3.1,0.4,0.075,0.24882900000000002,TAKER
07/09/2022 21:00:00,19/06/2023 16:06:36,DUMMY_Gemini_BTCUSD_1h_01_07_22_to_16_06_23.csv,BTC_USD,HOUR,198.54,0.009,08/09/2022 00:00:00,08/09/2022 04:00:00,08/09/2022 04:00:00,EXPIRED,LONG,19369.0,19357.0,20647.26,18942.91,0.878,6.19,2.25,11.37,2,3.1,-0.24,0.075,0.13074075,TAKER
29/03/2023 02:00:00,19/06/2023 16:06:36,DUMMY_Gemini_BTCUSD_1h_01_07_22_to_16_06_23.csv,BTC_USD,HOUR,198.3,0.011,29/03/2023 09:00:00,29/03/2023 09:00:00,29/03/2023 06:00:00,STOP_LOSS_HIT,SHORT,27419.0,27785.1,26320.72,27785.1,1.521,4.17,1.32,11.85,2,3.1,-4.25,0.075,0.22620674999999998,TAKER
08/12/2022 19:00:00,19/06/2023 16:06:36,DUMMY_Gemini_BTCUSD_1h_01_07_22_to_16_06_23.csv,BTC_USD,HOUR,194.05,0.008,08/12/2022 22:00:00,09/12/2022 02:00:00,09/12/2022 02:00:00,EXPIRED,LONG,17259.0,17217.0,18674.12,16787.29,0.712,7.58,2.81,11.22,2,3.1,-0.44,0.075,0.103554,TAKER
27/02/2023 01:00:00,19/06/2023 16:06:36,DUMMY_Gemini_BTCUSD_1h_01_07_22_to_16_06_23.csv,BTC_USD,HOUR,193.61,0.01,27/02/2023 05:00:00,27/02/2023 08:00:00,27/02/2023 08:00:00,EXPIRED,LONG,23559.0,23360.0,24757.19,23159.6,1.217,4.84,1.72,11.81,2,3.1,-2.17,0.075,0.17669249999999997,TAKER
25/01/2023 14:00:00,19/06/2023 16:06:36,DUMMY_Gemini_BTCUSD_1h_01_07_22_to_16_06_23.csv,BTC_USD,HOUR,191.44,0.01,25/01/2023 16:00:00,25/01/2023 21:00:00,25/01/2023 21:00:00,TAKE_PROFIT_HIT,LONG,22422.0,23546.81,23546.81,22047.07,1.171,4.78,1.7,11.08,2,3.1,11.08,0.075,0.16816499999999998,TAKER
22/12/2022 22:00:00,19/06/2023 16:06:36,DUMMY_Gemini_BTCUSD_1h_01_07_22_to_16_06_23.csv,BTC_USD,HOUR,202.52,0.021,23/12/2022 03:00:00,23/12/2022 05:00:00,23/12/2022 05:00:00,EXPIRED,LONG,16793.0,16824.0,17360.48,16603.84,1.741,3.27,1.14,11.65,2,3.1,0.39,0.075,0.26448975,TAKER
20/01/2023 18:00:00,19/06/2023 16:06:36,DUMMY_Gemini_BTCUSD_1h_01_07_22_to_16_06_23.csv,BTC_USD,HOUR,202.91,0.008,20/01/2023 19:00:00,21/01/2023 01:00:00,21/01/2023 01:00:00,EXPIRED,LONG,21390.0,22581.0,22898.99,20887.0,0.843,6.59,2.41,11.94,2,3.1,9.4,0.075,0.12834,TAKER
20/05/2023 20:00:00,19/06/2023 16:06:36,DUMMY_Gemini_BTCUSD_1h_01_07_22_to_16_06_23.csv,BTC_USD,HOUR,212.31,0.008,20/05/2023 23:00:00,21/05/2023 03:00:00,21/05/2023 03:00:00,EXPIRED,LONG,27021.0,27187.0,28536.98,26515.68,1.018,5.31,1.91,11.97,2,3.1,1.17,0.075,0.162126,TAKER
29/04/2023 04:00:00,19/06/2023 16:06:36,DUMMY_Gemini_BTCUSD_1h_01_07_22_to_16_06_23.csv,BTC_USD,HOUR,213.48,0.006,29/04/2023 06:00:00,29/04/2023 11:00:00,29/04/2023 11:00:00,EXPIRED,LONG,29396.0,29335.0,31491.68,28697.44,0.826,6.65,2.43,12.44,2,3.1,-0.5,0.075,0.13228199999999998,TAKER
28/07/2022 11:00:00,19/06/2023 16:06:36,DUMMY_Gemini_BTCUSD_1h_01_07_22_to_16_06_23.csv,BTC_USD,HOUR,212.98,0.011,28/07/2022 13:00:00,28/07/2022 18:00:00,28/07/2022 12:00:00,STOP_LOSS_HIT,LONG,23124.0,22742.51,24268.47,22742.51,1.194,4.72,1.68,12.4,2,3.1,-4.39,0.075,0.19077299999999997,TAKER
22/12/2022 05:00:00,19/06/2023 16:06:36,DUMMY_Gemini_BTCUSD_1h_01_07_22_to_16_06_23.csv,BTC_USD,HOUR,208.59,0.015,22/12/2022 12:00:00,22/12/2022 12:00:00,22/12/2022 12:00:00,EXPIRED,SHORT,16829.0,16819.0,16006.74,17103.09,1.21,5.14,1.6,12.14,2,3.1,-0.04,0.075,0.18932624999999997,TAKER
19/01/2023 17:00:00,19/06/2023 16:06:36,DUMMY_Gemini_BTCUSD_1h_01_07_22_to_16_06_23.csv,BTC_USD,HOUR,208.55,0.009,19/01/2023 18:00:00,20/01/2023 00:00:00,20/01/2023 00:00:00,EXPIRED,LONG,20837.0,21059.0,22277.69,20356.77,0.899,6.47,2.36,12.83,2,3.1,1.86,0.075,0.14064975,TAKER
14/08/2022 09:00:00,19/06/2023 16:06:36,DUMMY_Gemini_BTCUSD_1h_01_07_22_to_16_06_23.csv,BTC_USD,HOUR,210.41,0.007,14/08/2022 11:00:00,14/08/2022 16:00:00,14/08/2022 16:00:00,EXPIRED,LONG,24762.0,24323.0,26582.2,24155.27,0.824,6.85,2.51,12.61,2,3.1,-3.2,0.075,0.1300005,TAKER
17/10/2022 00:00:00,19/06/2023 16:06:36,DUMMY_Gemini_BTCUSD_1h_01_07_22_to_16_06_23.csv,BTC_USD,HOUR,207.21,0.019,17/10/2022 08:00:00,17/10/2022 07:00:00,17/10/2022 07:00:00,EXPIRED,LONG,19230.0,19300.0,19889.0,19010.33,1.763,3.31,1.16,12.25,2,3.1,1.06,0.075,0.27402750000000003,TAKER
31/12/2022 06:00:00,19/06/2023 16:06:36,DUMMY_Gemini_BTCUSD_1h_01_07_22_to_16_06_23.csv,BTC_USD,HOUR,208.27,0.023,31/12/2022 08:00:00,31/12/2022 13:00:00,31/12/2022 13:00:00,EXPIRED,LONG,16533.0,16577.0,17069.39,16354.2,1.826,3.14,1.09,12.05,2,3.1,0.73,0.075,0.28519425000000004,TAKER
01/04/2023 07:00:00,19/06/2023 16:06:36,DUMMY_Gemini_BTCUSD_1h_01_07_22_to_16_06_23.csv,BTC_USD,HOUR,209.0,0.014,01/04/2023 15:00:00,01/04/2023 14:00:00,01/04/2023 14:00:00,EXPIRED,LONG,28441.0,28350.0,29355.65,28136.12,1.905,3.12,1.08,12.51,2,3.2,-1.57,0.075,0.2986305,TAKER
14/02/2023 18:00:00,19/06/2023 16:06:36,DUMMY_Gemini_BTCUSD_1h_01_07_22_to_16_06_23.csv,BTC_USD,HOUR,207.43,0.01,15/02/2023 01:00:00,15/02/2023 01:00:00,15/02/2023 01:00:00,EXPIRED,SHORT,22118.0,22114.0,20862.87,22536.38,1.066,6.02,1.86,12.39,2,3.1,-0.13,0.075,0.165885,TAKER
09/09/2022 06:00:00,19/06/2023 16:06:36,DUMMY_Gemini_BTCUSD_1h_01_07_22_to_16_06_23.csv,BTC_USD,HOUR,207.3,0.008,09/09/2022 10:00:00,09/09/2022 13:00:00,09/09/2022 13:00:00,EXPIRED,LONG,20696.0,21015.0,22217.0,20189.0,0.799,6.85,2.51,12.04,2,3.1,2.43,0.075,0.12417600000000001,TAKER
01/06/2023 17:00:00,19/06/2023 16:06:36,DUMMY_Gemini_BTCUSD_1h_01_07_22_to_16_06_23.csv,BTC_USD,HOUR,209.73,0.009,02/06/2023 00:00:00,02/06/2023 00:00:00,02/06/2023 00:00:00,EXPIRED,LONG,26966.0,26783.0,28409.96,26484.68,1.157,5.08,1.82,12.81,2,3.1,-1.83,0.075,0.1820205,TAKER
27/09/2022 04:00:00,19/06/2023 16:06:36,DUMMY_Gemini_BTCUSD_1h_01_07_22_to_16_06_23.csv,BTC_USD,HOUR,207.9,0.009,27/09/2022 05:00:00,27/09/2022 11:00:00,27/09/2022 11:00:00,EXPIRED,LONG,20048.0,20238.0,21454.73,19579.09,0.868,6.56,2.39,12.53,2,3.1,1.57,0.075,0.135324,TAKER
08/03/2023 03:00:00,19/06/2023 16:06:36,DUMMY_Gemini_BTCUSD_1h_01_07_22_to_16_06_23.csv,BTC_USD,HOUR,209.47,0.016,08/03/2023 08:00:00,08/03/2023 10:00:00,08/03/2023 05:00:00,STOP_LOSS_HIT,LONG,22148.0,21889.38,22923.86,21889.38,1.692,3.38,1.18,12.15,2,3.1,-4.4,0.075,0.265776,TAKER
18/02/2023 04:00:00,19/06/2023 16:06:36,DUMMY_Gemini_BTCUSD_1h_01_07_22_to_16_06_23.csv,BTC_USD,HOUR,205.07,0.015,18/02/2023 06:00:00,18/02/2023 11:00:00,18/02/2023 11:00:00,EXPIRED,LONG,24650.0,24537.0,25481.83,24372.73,1.803,3.26,1.14,12.2,2,3.1,-1.97,0.075,0.2773125,TAKER
27/11/2022 03:00:00,19/06/2023 16:06:36,DUMMY_Gemini_BTCUSD_1h_01_07_22_to_16_06_23.csv,BTC_USD,HOUR,203.1,0.022,27/11/2022 08:00:00,27/11/2022 10:00:00,27/11/2022 10:00:00,EXPIRED,LONG,16515.0,16543.0,17060.38,16333.21,1.789,3.2,1.11,11.73,2,3.1,0.34,0.075,0.2724975,TAKER
06/08/2022 00:00:00,19/06/2023 16:06:36,DUMMY_Gemini_BTCUSD_1h_01_07_22_to_16_06_23.csv,BTC_USD,HOUR,203.44,0.014,06/08/2022 03:00:00,06/08/2022 07:00:00,06/08/2022 07:00:00,EXPIRED,LONG,23271.0,23210.0,24170.55,22971.15,1.601,3.72,1.31,12.35,2,3.1,-1.1,0.075,0.2443455,TAKER
13/01/2023 20:00:00,19/06/2023 16:06:36,DUMMY_Gemini_BTCUSD_1h_01_07_22_to_16_06_23.csv,BTC_USD,HOUR,202.34,0.009,14/01/2023 01:00:00,14/01/2023 03:00:00,14/01/2023 00:00:00,TAKE_PROFIT_HIT,LONG,19486.0,20872.26,20872.26,19023.91,0.867,6.64,2.43,12.34,2,3.1,12.34,0.075,0.1315305,TAKER
24/04/2023 04:00:00,19/06/2023 16:06:36,DUMMY_Gemini_BTCUSD_1h_01_07_22_to_16_06_23.csv,BTC_USD,HOUR,214.68,0.015,24/04/2023 10:00:00,24/04/2023 11:00:00,24/04/2023 07:00:00,STOP_LOSS_HIT,LONG,27703.0,27419.8,28552.62,27419.8,1.936,2.98,1.03,12.43,2,3.2,-4.56,0.075,0.31165875,TAKER
05/09/2022 02:00:00,19/06/2023 16:06:36,DUMMY_Gemini_BTCUSD_1h_01_07_22_to_16_06_23.csv,BTC_USD,HOUR,210.12,0.018,05/09/2022 10:00:00,05/09/2022 09:00:00,05/09/2022 09:00:00,EXPIRED,LONG,19856.0,19774.0,20540.68,19627.78,1.701,3.33,1.16,12.06,2,3.1,-1.74,0.075,0.26805599999999996,TAKER
26/03/2023 16:00:00,19/06/2023 16:06:36,DUMMY_Gemini_BTCUSD_1h_01_07_22_to_16_06_23.csv,BTC_USD,HOUR,208.38,0.011,26/03/2023 22:00:00,26/03/2023 23:00:00,26/03/2023 23:00:00,EXPIRED,LONG,27680.0,28007.0,28843.61,27292.13,1.461,4.03,1.42,12.57,2,3.1,3.37,0.075,0.22835999999999995,TAKER
07/07/2022 10:00:00,19/06/2023 16:06:36,DUMMY_Gemini_BTCUSD_1h_01_07_22_to_16_06_23.csv,BTC_USD,HOUR,211.75,0.012,07/07/2022 17:00:00,07/07/2022 17:00:00,07/07/2022 17:00:00,EXPIRED,LONG,20485.0,20893.0,21552.4,20129.2,1.161,4.95,1.77,12.62,2,3.1,4.71,0.075,0.184365,TAKER
22/03/2023 12:00:00,19/06/2023 16:06:36,DUMMY_Gemini_BTCUSD_1h_01_07_22_to_16_06_23.csv,BTC_USD,HOUR,216.46,0.008,22/03/2023 14:00:00,22/03/2023 19:00:00,22/03/2023 19:00:00,STOP_LOSS_HIT,LONG,28304.0,27741.57,29991.29,27741.57,1.046,5.63,2.03,13.33,2,3.1,-4.67,0.075,0.16982400000000003,TAKER
17/03/2023 23:00:00,19/06/2023 16:06:36,DUMMY_Gemini_BTCUSD_1h_01_07_22_to_16_06_23.csv,BTC_USD,HOUR,211.79,0.007,18/03/2023 05:00:00,18/03/2023 06:00:00,18/03/2023 06:00:00,EXPIRED,LONG,27451.0,27547.0,29221.42,26860.86,0.907,6.06,2.2,12.25,2,3.1,0.53,0.075,0.14411775000000002,TAKER
28/11/2022 20:00:00,19/06/2023 16:06:36,DUMMY_Gemini_BTCUSD_1h_01_07_22_to_16_06_23.csv,BTC_USD,HOUR,212.32,0.025,29/11/2022 03:00:00,29/11/2022 03:00:00,29/11/2022 03:00:00,EXPIRED,SHORT,16244.0,16269.0,15741.31,16411.56,1.913,3.19,1.02,12.26,2,3.2,-0.93,0.075,0.304575,TAKER
16/01/2023 03:00:00,19/06/2023 16:06:36,DUMMY_Gemini_BTCUSD_1h_01_07_22_to_16_06_23.csv,BTC_USD,HOUR,211.39,0.009,16/01/2023 10:00:00,16/01/2023 10:00:00,16/01/2023 10:00:00,EXPIRED,LONG,21087.0,20848.0,22543.62,20601.46,0.898,6.46,2.36,12.97,2,3.1,-2.29,0.075,0.14233724999999997,TAKER
14/05/2023 17:00:00,19/06/2023 16:06:36,DUMMY_Gemini_BTCUSD_1h_01_07_22_to_16_06_23.csv,BTC_USD,HOUR,209.1,0.006,14/05/2023 19:00:00,15/05/2023 00:00:00,15/05/2023 00:00:00,EXPIRED,LONG,26950.0,26803.0,29190.52,26203.16,0.773,7.68,2.85,13.32,2,3.1,-1.0,0.075,0.12127500000000001,TAKER
28/03/2023 19:00:00,19/06/2023 16:06:36,DUMMY_Gemini_BTCUSD_1h_01_07_22_to_16_06_23.csv,BTC_USD,HOUR,208.1,0.015,28/03/2023 21:00:00,29/03/2023 02:00:00,28/03/2023 21:00:00,STOP_LOSS_HIT,LONG,27429.0,27147.14,28274.59,27147.14,1.977,2.99,1.04,12.38,2,3.2,-4.54,0.075,0.30857625,TAKER
26/04/2023 14:00:00,19/06/2023 16:06:36,DUMMY_Gemini_BTCUSD_1h_01_07_22_to_16_06_23.csv,BTC_USD,HOUR,203.56,0.007,26/04/2023 16:00:00,26/04/2023 21:00:00,26/04/2023 19:00:00,STOP_LOSS_HIT,LONG,29687.0,29136.95,31337.15,29136.95,1.021,5.27,1.89,11.4,2,3.1,-4.01,0.075,0.15585675,TAKER
28/05/2023 07:00:00,19/06/2023 16:06:36,DUMMY_Gemini_BTCUSD_1h_01_07_22_to_16_06_23.csv,BTC_USD,HOUR,199.55,0.011,28/05/2023 11:00:00,28/05/2023 14:00:00,28/05/2023 14:00:00,EXPIRED,LONG,27225.0,27198.0,28279.77,26873.41,1.501,3.73,1.31,11.38,2,3.1,-0.52,0.075,0.22460624999999998,TAKER
10/12/2022 18:00:00,19/06/2023 16:06:36,DUMMY_Gemini_BTCUSD_1h_01_07_22_to_16_06_23.csv,BTC_USD,HOUR,199.03,0.014,10/12/2022 23:00:00,11/12/2022 01:00:00,11/12/2022 01:00:00,EXPIRED,LONG,17202.0,17162.0,18074.82,16911.06,1.21,4.83,1.72,12.04,2,3.1,-0.74,0.075,0.180621,TAKER
13/03/2023 00:00:00,19/06/2023 16:06:36,DUMMY_Gemini_BTCUSD_1h_01_07_22_to_16_06_23.csv,BTC_USD,HOUR,198.29,0.014,13/03/2023 02:00:00,13/03/2023 07:00:00,13/03/2023 03:00:00,STOP_LOSS_HIT,LONG,22685.0,22407.74,23516.78,22407.74,1.602,3.54,1.24,11.41,2,3.1,-4.12,0.075,0.2381925,TAKER
29/01/2023 16:00:00,19/06/2023 16:06:36,DUMMY_Gemini_BTCUSD_1h_01_07_22_to_16_06_23.csv,BTC_USD,HOUR,194.17,0.016,29/01/2023 21:00:00,29/01/2023 23:00:00,29/01/2023 23:00:00,EXPIRED,LONG,23594.0,23761.0,24315.98,23353.34,1.944,2.97,1.03,11.27,2,3.2,2.39,0.075,0.283128,TAKER
12/11/2022 06:00:00,19/06/2023 16:06:36,DUMMY_Gemini_BTCUSD_1h_01_07_22_to_16_06_23.csv,BTC_USD,HOUR,196.56,0.01,12/11/2022 08:00:00,12/11/2022 13:00:00,12/11/2022 13:00:00,EXPIRED,LONG,16723.0,16750.0,17951.37,16313.54,0.851,6.84,2.51,12.16,2,3.1,0.14,0.075,0.1254225,TAKER
04/03/2023 00:00:00,19/06/2023 16:06:36,DUMMY_Gemini_BTCUSD_1h_01_07_22_to_16_06_23.csv,BTC_USD,HOUR,196.7,0.015,04/03/2023 06:00:00,04/03/2023 07:00:00,04/03/2023 07:00:00,EXPIRED,LONG,22370.0,22364.0,23173.72,22102.1,1.706,3.47,1.21,11.8,2,3.1,-0.34,0.075,0.2516625,TAKER
19/12/2022 00:00:00,19/06/2023 16:06:36,DUMMY_Gemini_BTCUSD_1h_01_07_22_to_16_06_23.csv,BTC_USD,HOUR,196.36,0.023,19/12/2022 02:00:00,19/12/2022 07:00:00,19/12/2022 07:00:00,EXPIRED,LONG,16776.0,16715.0,17284.7,16606.43,1.965,2.94,1.02,11.41,2,3.2,-1.69,0.075,0.28938600000000003,TAKER
02/04/2023 04:00:00,19/06/2023 16:06:36,DUMMY_Gemini_BTCUSD_1h_01_07_22_to_16_06_23.csv,BTC_USD,HOUR,194.67,0.012,02/04/2023 09:00:00,02/04/2023 11:00:00,02/04/2023 11:00:00,EXPIRED,LONG,28411.0,28377.0,29419.76,28074.75,1.751,3.43,1.2,11.85,2,3.1,-0.66,0.075,0.255699,TAKER
07/08/2022 14:00:00,19/06/2023 16:06:36,DUMMY_Gemini_BTCUSD_1h_01_07_22_to_16_06_23.csv,BTC_USD,HOUR,194.01,0.005,07/08/2022 16:00:00,07/08/2022 21:00:00,07/08/2022 21:00:00,EXPIRED,LONG,23128.0,23314.0,25426.41,22361.87,0.596,9.04,3.43,11.41,2,3.1,0.84,0.075,0.08673,TAKER
08/01/2023 18:00:00,19/06/2023 16:06:36,DUMMY_Gemini_BTCUSD_1h_01_07_22_to_16_06_23.csv,BTC_USD,HOUR,194.85,0.02,08/01/2023 20:00:00,09/01/2023 01:00:00,09/01/2023 01:00:00,EXPIRED,LONG,16935.0,17186.0,17517.57,16740.81,1.738,3.33,1.16,11.4,2,3.1,4.77,0.075,0.254025,TAKER
17/11/2022 00:00:00,19/06/2023 16:06:36,DUMMY_Gemini_BTCUSD_1h_01_07_22_to_16_06_23.csv,BTC_USD,HOUR,199.62,0.024,17/11/2022 06:00:00,17/11/2022 07:00:00,17/11/2022 07:00:00,EXPIRED,SHORT,16665.0,16569.0,16156.4,16834.53,2.004,3.15,1.01,11.91,2,3.2,2.0,0.075,0.29997,TAKER
27/11/2022 03:00:00,19/06/2023 16:06:36,DUMMY_Gemini_BTCUSD_1h_01_07_22_to_16_06_23.csv,BTC_USD,HOUR,201.62,0.022,27/11/2022 08:00:00,27/11/2022 10:00:00,27/11/2022 10:00:00,EXPIRED,LONG,16515.0,16543.0,17060.38,16333.21,1.802,3.2,1.11,11.73,2,3.1,0.34,0.075,0.2724975,TAKER
26/03/2023 13:00:00,19/06/2023 16:06:36,DUMMY_Gemini_BTCUSD_1h_01_07_22_to_16_06_23.csv,BTC_USD,HOUR,201.96,0.006,26/03/2023 15:00:00,26/03/2023 20:00:00,26/03/2023 20:00:00,EXPIRED,LONG,28172.0,27804.0,30323.05,27454.98,0.837,7.09,2.61,12.78,2,3.1,-2.33,0.075,0.126774,TAKER
03/02/2023 18:00:00,19/06/2023 16:06:36,DUMMY_Gemini_BTCUSD_1h_01_07_22_to_16_06_23.csv,BTC_USD,HOUR,199.63,0.016,03/02/2023 20:00:00,04/02/2023 01:00:00,04/02/2023 01:00:00,EXPIRED,LONG,23423.0,23388.0,24160.61,23177.13,1.877,3.05,1.06,11.52,2,3.2,-0.84,0.075,0.281076,TAKER
30/04/2023 07:00:00,19/06/2023 16:06:36,DUMMY_Gemini_BTCUSD_1h_01_07_22_to_16_06_23.csv,BTC_USD,HOUR,198.79,0.012,30/04/2023 10:00:00,30/04/2023 14:00:00,30/04/2023 14:00:00,EXPIRED,LONG,29286.0,29410.0,30319.31,28941.57,1.768,3.41,1.19,12.14,2,3.1,1.22,0.075,0.26357400000000003,TAKER
16/06/2023 08:00:00,19/06/2023 16:06:36,DUMMY_Gemini_BTCUSD_1h_01_07_22_to_16_06_23.csv,BTC_USD,HOUR,200.01,0.009,16/06/2023 12:00:00,16/06/2023 15:00:00,16/06/2023 15:00:00,EXPIRED,LONG,25526.0,25818.0,26845.76,25086.08,1.149,4.92,1.75,11.71,2,3.1,2.46,0.075,0.1723005,TAKER
29/11/2022 14:00:00,19/06/2023 16:06:36,DUMMY_Gemini_BTCUSD_1h_01_07_22_to_16_06_23.csv,BTC_USD,HOUR,202.47,0.018,29/11/2022 16:00:00,29/11/2022 21:00:00,29/11/2022 21:00:00,EXPIRED,LONG,16408.0,16472.0,17075.81,16185.4,1.459,3.91,1.38,11.8,2,3.1,0.93,0.075,0.221508,TAKER
11/09/2022 03:00:00,19/06/2023 16:06:36,DUMMY_Gemini_BTCUSD_1h_01_07_22_to_16_06_23.csv,BTC_USD,HOUR,203.4,0.01,11/09/2022 05:00:00,11/09/2022 10:00:00,11/09/2022 10:00:00,EXPIRED,LONG,21556.0,21588.0,22738.76,21161.75,1.06,5.2,1.86,11.67,2,3.1,0.16,0.075,0.16166999999999998,TAKER
12/02/2023 06:00:00,19/06/2023 16:06:36,DUMMY_Gemini_BTCUSD_1h_01_07_22_to_16_06_23.csv,BTC_USD,HOUR,203.56,0.007,12/02/2023 08:00:00,12/02/2023 13:00:00,12/02/2023 13:00:00,EXPIRED,LONG,21814.0,21809.0,23510.9,21248.37,0.75,7.22,2.66,11.76,2,3.1,-0.15,0.075,0.11452350000000001,TAKER
30/07/2022 22:00:00,19/06/2023 16:06:36,DUMMY_Gemini_BTCUSD_1h_01_07_22_to_16_06_23.csv,BTC_USD,HOUR,203.41,0.016,31/07/2022 00:00:00,31/07/2022 05:00:00,31/07/2022 05:00:00,EXPIRED,LONG,23710.0,23719.0,24460.55,23459.82,1.865,3.07,1.07,11.72,2,3.2,-0.14,0.075,0.28452,TAKER
20/01/2023 22:00:00,19/06/2023 16:06:36,DUMMY_Gemini_BTCUSD_1h_01_07_22_to_16_06_23.csv,BTC_USD,HOUR,203.27,0.01,21/01/2023 00:00:00,21/01/2023 05:00:00,21/01/2023 05:00:00,EXPIRED,LONG,22600.0,22586.0,23800.62,22199.8,1.112,5.04,1.8,11.84,2,3.1,-0.31,0.075,0.16949999999999998,TAKER
14/07/2022 21:00:00,19/06/2023 16:06:36,DUMMY_Gemini_BTCUSD_1h_01_07_22_to_16_06_23.csv,BTC_USD,HOUR,202.96,0.018,15/07/2022 01:00:00,15/07/2022 04:00:00,15/07/2022 04:00:00,EXPIRED,LONG,20473.0,20539.0,21166.09,20241.97,1.816,3.27,1.14,12.2,2,3.1,0.91,0.075,0.27638549999999995,TAKER
18/03/2023 07:00:00,19/06/2023 16:06:36,DUMMY_Gemini_BTCUSD_1h_01_07_22_to_16_06_23.csv,BTC_USD,HOUR,203.87,0.014,18/03/2023 09:00:00,18/03/2023 14:00:00,18/03/2023 14:00:00,EXPIRED,LONG,27415.0,27617.0,28301.07,27119.65,1.883,3.13,1.09,12.12,2,3.1,2.54,0.075,0.2878575,TAKER
18/10/2022 06:00:00,19/06/2023 16:06:36,DUMMY_Gemini_BTCUSD_1h_01_07_22_to_16_06_23.csv,BTC_USD,HOUR,206.41,0.018,18/10/2022 07:00:00,18/10/2022 13:00:00,18/10/2022 13:00:00,EXPIRED,LONG,19637.0,19544.0,20310.27,19412.58,1.712,3.31,1.16,11.85,2,3.1,-1.94,0.075,0.2650995,TAKER
17/02/2023 19:00:00,19/06/2023 16:06:36,DUMMY_Gemini_BTCUSD_1h_01_07_22_to_16_06_23.csv,BTC_USD,HOUR,204.47,0.008,17/02/2023 23:00:00,18/02/2023 02:00:00,18/02/2023 02:00:00,EXPIRED,LONG,24538.0,24569.0,26032.28,24039.91,0.96,5.74,2.07,11.81,2,3.1,0.1,0.075,0.147228,TAKER
08/06/2023 19:00:00,19/06/2023 16:06:36,DUMMY_Gemini_BTCUSD_1h_01_07_22_to_16_06_23.csv,BTC_USD,HOUR,204.57,0.014,09/06/2023 00:00:00,09/06/2023 02:00:00,09/06/2023 02:00:00,EXPIRED,LONG,26547.0,26465.0,27423.36,26254.88,1.817,3.2,1.11,11.99,2,3.1,-1.43,0.075,0.2787435,TAKER
21/03/2023 12:00:00,19/06/2023 16:06:36,DUMMY_Gemini_BTCUSD_1h_01_07_22_to_16_06_23.csv,BTC_USD,HOUR,203.14,0.006,21/03/2023 17:00:00,21/03/2023 19:00:00,21/03/2023 19:00:00,EXPIRED,LONG,28288.0,28220.0,30439.32,27570.89,0.836,7.07,2.6,12.78,2,3.1,-0.54,0.075,0.127296,TAKER
21/07/2022 19:00:00,19/06/2023 16:06:36,DUMMY_Gemini_BTCUSD_1h_01_07_22_to_16_06_23.csv,BTC_USD,HOUR,202.6,0.016,22/07/2022 02:00:00,22/07/2022 02:00:00,21/07/2022 22:00:00,STOP_LOSS_HIT,LONG,23209.0,22952.17,23979.51,22952.17,1.833,3.21,1.12,12.05,2,3.1,-4.39,0.075,0.278508,TAKER
16/07/2022 18:00:00,19/06/2023 16:06:36,DUMMY_Gemini_BTCUSD_1h_01_07_22_to_16_06_23.csv,BTC_USD,HOUR,198.21,0.016,16/07/2022 20:00:00,17/07/2022 01:00:00,16/07/2022 20:00:00,STOP_LOSS_HIT,LONG,21284.0,21036.17,22027.49,21036.17,1.718,3.38,1.18,11.64,2,3.1,-4.22,0.075,0.25540799999999997,TAKER
18/07/2022 14:00:00,19/06/2023 16:06:36,DUMMY_Gemini_BTCUSD_1h_01_07_22_to_16_06_23.csv,BTC_USD,HOUR,193.99,0.007,18/07/2022 16:00:00,18/07/2022 21:00:00,18/07/2022 19:00:00,STOP_LOSS_HIT,LONG,22215.0,21680.09,23819.73,21680.09,0.802,6.74,2.47,11.12,2,3.1,-3.86,0.075,0.11662875,TAKER
13/01/2023 13:00:00,19/06/2023 16:06:36,DUMMY_Gemini_BTCUSD_1h_01_07_22_to_16_06_23.csv,BTC_USD,HOUR,190.13,0.018,13/01/2023 20:00:00,13/01/2023 20:00:00,13/01/2023 20:00:00,TAKE_PROFIT_HIT,LONG,18859.0,19479.17,19479.17,18652.28,1.785,3.18,1.11,10.91,2,3.1,10.91,0.075,0.2545965,TAKER
22/12/2022 03:00:00,19/06/2023 16:06:36,DUMMY_Gemini_BTCUSD_1h_01_07_22_to_16_06_23.csv,BTC_USD,HOUR,201.04,0.023,22/12/2022 07:00:00,22/12/2022 10:00:00,22/12/2022 10:00:00,EXPIRED,LONG,16859.0,16830.0,17394.14,16680.62,1.929,3.08,1.07,12.02,2,3.2,-0.96,0.075,0.29081775,TAKER
21/01/2023 09:00:00,19/06/2023 16:06:36,DUMMY_Gemini_BTCUSD_1h_01_07_22_to_16_06_23.csv,BTC_USD,HOUR,200.08,0.01,21/01/2023 17:00:00,21/01/2023 16:00:00,21/01/2023 10:00:00,STOP_LOSS_HIT,LONG,23041.0,22639.64,24245.08,22639.64,1.152,4.97,1.77,11.87,2,3.1,-4.19,0.075,0.17280749999999998,TAKER
21/09/2022 12:00:00,19/06/2023 16:06:36,DUMMY_Gemini_BTCUSD_1h_01_07_22_to_16_06_23.csv,BTC_USD,HOUR,195.89,0.006,21/09/2022 15:00:00,21/09/2022 19:00:00,21/09/2022 19:00:00,EXPIRED,LONG,19247.0,19003.0,21314.79,18557.74,0.59,9.7,3.71,12.32,2,3.0,-1.55,0.075,0.0866115,TAKER
14/05/2023 17:00:00,19/06/2023 16:06:36,DUMMY_Gemini_BTCUSD_1h_01_07_22_to_16_06_23.csv,BTC_USD,HOUR,194.34,0.005,14/05/2023 19:00:00,15/05/2023 00:00:00,15/05/2023 00:00:00,EXPIRED,LONG,26950.0,26803.0,29190.52,26203.16,0.693,7.68,2.85,11.1,2,3.1,-0.84,0.075,0.1010625,TAKER
27/04/2023 19:00:00,19/06/2023 16:06:36,DUMMY_Gemini_BTCUSD_1h_01_07_22_to_16_06_23.csv,BTC_USD,HOUR,193.5,0.005,27/04/2023 22:00:00,28/04/2023 02:00:00,28/04/2023 02:00:00,EXPIRED,LONG,29656.0,29408.0,32122.94,28833.69,0.766,7.68,2.85,12.22,2,3.1,-1.35,0.075,0.11121,TAKER
17/10/2022 12:00:00,19/06/2023 16:06:36,DUMMY_Gemini_BTCUSD_1h_01_07_22_to_16_06_23.csv,BTC_USD,HOUR,192.15,0.007,17/10/2022 15:00:00,17/10/2022 19:00:00,17/10/2022 19:00:00,EXPIRED,LONG,19520.0,19523.0,21204.81,18958.4,0.711,7.95,2.96,11.69,2,3.1,-0.08,0.075,0.10248000000000002,TAKER
31/12/2022 05:00:00,19/06/2023 16:06:36,DUMMY_Gemini_BTCUSD_1h_01_07_22_to_16_06_23.csv,BTC_USD,HOUR,192.07,0.013,31/12/2022 08:00:00,31/12/2022 12:00:00,31/12/2022 12:00:00,EXPIRED,LONG,16527.0,16564.0,17410.42,16232.53,1.119,5.07,1.81,11.32,2,3.1,0.32,0.075,0.16113824999999998,TAKER
26/04/2023 12:00:00,19/06/2023 16:06:36,DUMMY_Gemini_BTCUSD_1h_01_07_22_to_16_06_23.csv,BTC_USD,HOUR,192.39,0.005,26/04/2023 16:00:00,26/04/2023 19:00:00,26/04/2023 19:00:00,STOP_LOSS_HIT,LONG,29961.0,29158.38,32368.87,29158.38,0.779,7.44,2.75,11.93,2,3.1,-4.13,0.075,0.11235374999999999,TAKER
29/11/2022 14:00:00,19/06/2023 16:06:36,DUMMY_Gemini_BTCUSD_1h_01_07_22_to_16_06_23.csv,BTC_USD,HOUR,188.26,0.017,29/11/2022 16:00:00,29/11/2022 21:00:00,29/11/2022 21:00:00,EXPIRED,LONG,16408.0,16472.0,17075.81,16185.4,1.482,3.91,1.38,11.14,2,3.1,0.88,0.075,0.209202,TAKER
09/06/2023 02:00:00,19/06/2023 16:06:36,DUMMY_Gemini_BTCUSD_1h_01_07_22_to_16_06_23.csv,BTC_USD,HOUR,189.14,0.014,09/06/2023 09:00:00,09/06/2023 09:00:00,09/06/2023 09:00:00,EXPIRED,LONG,26465.0,26630.0,27286.04,26191.32,1.959,3.01,1.04,11.22,2,3.2,2.03,0.075,0.2778825,TAKER
04/11/2022 13:00:00,19/06/2023 16:06:36,DUMMY_Gemini_BTCUSD_1h_01_07_22_to_16_06_23.csv,BTC_USD,HOUR,191.17,0.016,04/11/2022 19:00:00,04/11/2022 20:00:00,04/11/2022 20:00:00,EXPIRED,LONG,20761.0,21147.0,21456.67,20529.11,1.738,3.24,1.13,10.88,2,3.1,5.93,0.075,0.249132,TAKER
14/12/2022 04:00:00,19/06/2023 16:06:36,DUMMY_Gemini_BTCUSD_1h_01_07_22_to_16_06_23.csv,BTC_USD,HOUR,197.1,0.02,14/12/2022 06:00:00,14/12/2022 11:00:00,14/12/2022 11:00:00,EXPIRED,LONG,17832.0,17823.0,18424.67,17634.44,1.809,3.22,1.12,11.59,2,3.1,-0.45,0.075,0.26748,TAKER
14/11/2022 12:00:00,19/06/2023 16:06:36,DUMMY_Gemini_BTCUSD_1h_01_07_22_to_16_06_23.csv,BTC_USD,HOUR,196.65,0.012,14/11/2022 20:00:00,14/11/2022 19:00:00,14/11/2022 13:00:00,STOP_LOSS_HIT,SHORT,16770.0,17091.05,15806.84,17091.05,1.023,6.09,1.88,11.41,2,3.1,-4.0,0.075,0.15093,TAKER
20/11/2022 00:00:00,19/06/2023 16:06:36,DUMMY_Gemini_BTCUSD_1h_01_07_22_to_16_06_23.csv,BTC_USD,HOUR,192.65,0.014,20/11/2022 06:00:00,20/11/2022 07:00:00,20/11/2022 07:00:00,EXPIRED,LONG,16696.0,16694.0,17544.53,16413.16,1.213,4.84,1.72,11.7,2,3.1,-0.2,0.075,0.175308,TAKER
28/03/2023 17:00:00,19/06/2023 16:06:36,DUMMY_Gemini_BTCUSD_1h_01_07_22_to_16_06_23.csv,BTC_USD,HOUR,192.45,0.014,29/03/2023 01:00:00,29/03/2023 00:00:00,28/03/2023 18:00:00,STOP_LOSS_HIT,SHORT,26890.0,27161.18,26076.48,27161.18,1.956,3.12,1.0,11.11,2,3.2,-4.08,0.075,0.28234499999999996,TAKER
08/01/2023 01:00:00,19/06/2023 16:06:36,DUMMY_Gemini_BTCUSD_1h_01_07_22_to_16_06_23.csv,BTC_USD,HOUR,188.37,0.02,08/01/2023 07:00:00,08/01/2023 08:00:00,08/01/2023 08:00:00,EXPIRED,SHORT,16929.0,16947.0,16366.64,17116.46,1.797,3.44,1.1,10.99,2,3.1,-0.61,0.075,0.253935,TAKER
24/07/2022 03:00:00,19/06/2023 16:06:36,DUMMY_Gemini_BTCUSD_1h_01_07_22_to_16_06_23.csv,BTC_USD,HOUR,187.76,0.016,24/07/2022 09:00:00,24/07/2022 10:00:00,24/07/2022 10:00:00,EXPIRED,LONG,22336.0,22529.0,23046.39,22099.21,1.903,3.08,1.07,11.1,2,3.2,2.82,0.075,0.268032,TAKER
27/04/2023 08:00:00,19/06/2023 16:06:36,DUMMY_Gemini_BTCUSD_1h_01_07_22_to_16_06_23.csv,BTC_USD,HOUR,190.58,0.008,27/04/2023 16:00:00,27/04/2023 15:00:00,27/04/2023 15:00:00,STOP_LOSS_HIT,SHORT,28954.0,29433.08,27516.77,29433.08,1.215,5.22,1.63,11.32,2,3.1,-4.01,0.075,0.173724,TAKER
08/10/2022 05:00:00,19/06/2023 16:06:36,DUMMY_Gemini_BTCUSD_1h_01_07_22_to_16_06_23.csv,BTC_USD,HOUR,186.57,0.011,08/10/2022 07:00:00,08/10/2022 12:00:00,08/10/2022 12:00:00,EXPIRED,LONG,19511.0,19519.0,20564.45,19159.85,1.15,5.12,1.83,11.43,2,3.1,-0.07,0.075,0.16096575,TAKER
16/10/2022 21:00:00,19/06/2023 16:06:36,DUMMY_Gemini_BTCUSD_1h_01_07_22_to_16_06_23.csv,BTC_USD,HOUR,186.5,0.019,16/10/2022 23:00:00,17/10/2022 04:00:00,17/10/2022 04:00:00,EXPIRED,LONG,19151.0,19233.0,19729.01,18958.33,1.951,2.93,1.02,10.71,2,3.2,1.29,0.075,0.27290175,TAKER
05/09/2022 21:00:00,19/06/2023 16:06:36,DUMMY_Gemini_BTCUSD_1h_01_07_22_to_16_06_23.csv,BTC_USD,HOUR,187.79,0.017,06/09/2022 01:00:00,06/09/2022 04:00:00,06/09/2022 04:00:00,EXPIRED,LONG,19750.0,19763.0,20399.24,19533.59,1.788,3.18,1.11,10.79,2,3.1,-0.03,0.075,0.2518125,TAKER
17/12/2022 23:00:00,19/06/2023 16:06:36,DUMMY_Gemini_BTCUSD_1h_01_07_22_to_16_06_23.csv,BTC_USD,HOUR,187.76,0.015,18/12/2022 04:00:00,18/12/2022 06:00:00,18/12/2022 06:00:00,EXPIRED,LONG,16800.0,16745.0,17543.82,16552.06,1.342,4.24,1.5,10.97,2,3.1,-1.01,0.075,0.18899999999999997,TAKER
27/11/2022 17:00:00,19/06/2023 16:06:36,DUMMY_Gemini_BTCUSD_1h_01_07_22_to_16_06_23.csv,BTC_USD,HOUR,186.75,0.019,28/11/2022 01:00:00,28/11/2022 00:00:00,28/11/2022 00:00:00,EXPIRED,LONG,16513.0,16441.0,17093.29,16319.57,1.68,3.39,1.19,10.79,2,3.1,-1.6,0.075,0.23531025,TAKER
21/01/2023 23:00:00,19/06/2023 16:06:36,DUMMY_Gemini_BTCUSD_1h_01_07_22_to_16_06_23.csv,BTC_USD,HOUR,185.15,0.009,22/01/2023 06:00:00,22/01/2023 06:00:00,22/01/2023 06:00:00,EXPIRED,LONG,22790.0,22930.0,24045.41,22371.53,1.108,5.22,1.87,11.14,2,3.1,1.11,0.075,0.15383249999999998,TAKER
10/06/2023 18:00:00,19/06/2023 16:06:36,DUMMY_Gemini_BTCUSD_1h_01_07_22_to_16_06_23.csv,BTC_USD,HOUR,186.26,0.008,10/06/2023 23:00:00,11/06/2023 01:00:00,11/06/2023 01:00:00,EXPIRED,LONG,25567.0,25837.0,26943.83,25108.06,1.098,5.11,1.83,10.86,2,3.1,2.01,0.075,0.15340199999999998,TAKER
02/09/2022 16:00:00,19/06/2023 16:06:36,DUMMY_Gemini_BTCUSD_1h_01_07_22_to_16_06_23.csv,BTC_USD,HOUR,188.27,0.009,02/09/2022 20:00:00,02/09/2022 23:00:00,02/09/2022 23:00:00,EXPIRED,LONG,20133.0,19950.0,21387.92,19714.69,0.962,5.87,2.12,11.16,2,3.1,-1.78,0.075,0.13589774999999998,TAKER
04/11/2022 03:00:00,19/06/2023 16:06:36,DUMMY_Gemini_BTCUSD_1h_01_07_22_to_16_06_23.csv,BTC_USD,HOUR,186.49,0.011,04/11/2022 08:00:00,04/11/2022 10:00:00,04/11/2022 10:00:00,EXPIRED,LONG,20325.0,20660.0,21308.63,19997.12,1.199,4.62,1.64,10.65,2,3.1,3.52,0.075,0.16768124999999998,TAKER
10/07/2022 01:00:00,19/06/2023 16:06:36,DUMMY_Gemini_BTCUSD_1h_01_07_22_to_16_06_23.csv,BTC_USD,HOUR,190.01,0.015,10/07/2022 03:00:00,10/07/2022 08:00:00,10/07/2022 02:00:00,STOP_LOSS_HIT,LONG,21400.0,21142.57,22172.3,21142.57,1.689,3.48,1.22,11.34,2,3.1,-4.1,0.075,0.24075,TAKER
25/01/2023 14:00:00,19/06/2023 16:06:36,DUMMY_Gemini_BTCUSD_1h_01_07_22_to_16_06_23.csv,BTC_USD,HOUR,185.91,0.01,25/01/2023 16:00:00,25/01/2023 21:00:00,25/01/2023 21:00:00,TAKE_PROFIT_HIT,LONG,22422.0,23546.81,23546.81,22047.07,1.206,4.78,1.7,11.08,2,3.1,11.08,0.075,0.16816499999999998,TAKER
07/07/2022 13:00:00,19/06/2023 16:06:36,DUMMY_Gemini_BTCUSD_1h_01_07_22_to_16_06_23.csv,BTC_USD,HOUR,196.99,0.01,07/07/2022 17:00:00,07/07/2022 20:00:00,07/07/2022 19:00:00,TAKE_PROFIT_HIT,LONG,20528.0,21713.93,21713.93,20132.69,1.042,5.46,1.96,11.71,2,3.1,11.71,0.075,0.15395999999999999,TAKER
23/02/2023 08:00:00,19/06/2023 16:06:36,DUMMY_Gemini_BTCUSD_1h_01_07_22_to_16_06_23.csv,BTC_USD,HOUR,208.7,0.016,23/02/2023 10:00:00,23/02/2023 15:00:00,23/02/2023 11:00:00,STOP_LOSS_HIT,LONG,24415.0,24150.97,25207.11,24150.97,1.872,3.14,1.09,12.38,2,3.2,-4.52,0.075,0.29297999999999996,TAKER
14/11/2022 08:00:00,19/06/2023 16:06:36,DUMMY_Gemini_BTCUSD_1h_01_07_22_to_16_06_23.csv,BTC_USD,HOUR,204.18,0.011,14/11/2022 10:00:00,14/11/2022 15:00:00,14/11/2022 15:00:00,EXPIRED,LONG,16748.0,16567.0,17835.51,16385.5,0.902,6.1,2.21,11.82,2,3.1,-2.13,0.075,0.138171,TAKER
03/04/2023 16:00:00,19/06/2023 16:06:36,DUMMY_Gemini_BTCUSD_1h_01_07_22_to_16_06_23.csv,BTC_USD,HOUR,202.05,0.013,03/04/2023 18:00:00,03/04/2023 23:00:00,03/04/2023 20:00:00,STOP_LOSS_HIT,LONG,27948.0,27629.56,28903.31,27629.56,1.798,3.31,1.15,12.15,2,3.1,-4.41,0.075,0.27249299999999993,TAKER
22/10/2022 15:00:00,19/06/2023 16:06:37,DUMMY_Gemini_BTCUSD_1h_01_07_22_to_16_06_23.csv,BTC_USD,HOUR,197.64,0.007,22/10/2022 17:00:00,22/10/2022 22:00:00,22/10/2022 22:00:00,EXPIRED,LONG,19235.0,19196.0,20905.8,18678.07,0.681,7.99,2.98,11.59,2,3.1,-0.37,0.075,0.10098375000000001,TAKER
04/06/2023 11:00:00,19/06/2023 16:06:37,DUMMY_Gemini_BTCUSD_1h_01_07_22_to_16_06_23.csv,BTC_USD,HOUR,197.27,0.009,04/06/2023 18:00:00,04/06/2023 18:00:00,04/06/2023 18:00:00,EXPIRED,LONG,27197.0,27199.0,28516.91,26757.03,1.241,4.63,1.64,11.7,2,3.1,-0.17,0.075,0.18357974999999996,TAKER
09/09/2022 06:00:00,19/06/2023 16:06:37,DUMMY_Gemini_BTCUSD_1h_01_07_22_to_16_06_23.csv,BTC_USD,HOUR,197.1,0.008,09/09/2022 10:00:00,09/09/2022 13:00:00,09/09/2022 13:00:00,EXPIRED,LONG,20696.0,21015.0,22217.0,20189.0,0.84,6.85,2.51,12.04,2,3.1,2.43,0.075,0.12417600000000001,TAKER
20/05/2023 10:00:00,19/06/2023 16:06:37,DUMMY_Gemini_BTCUSD_1h_01_07_22_to_16_06_23.csv,BTC_USD,HOUR,199.53,0.015,20/05/2023 12:00:00,20/05/2023 17:00:00,20/05/2023 17:00:00,EXPIRED,LONG,26901.0,27139.0,27712.92,26630.36,2.022,2.93,1.02,11.88,2,3.2,3.27,0.075,0.30263625,TAKER
14/02/2023 21:00:00,19/06/2023 16:06:37,DUMMY_Gemini_BTCUSD_1h_01_07_22_to_16_06_23.csv,BTC_USD,HOUR,202.8,0.018,15/02/2023 03:00:00,15/02/2023 04:00:00,15/02/2023 04:00:00,EXPIRED,SHORT,22247.0,22088.0,21554.39,22477.87,1.975,3.21,1.03,12.17,2,3.2,2.56,0.075,0.30033449999999995,TAKER
18/01/2023 08:00:00,19/06/2023 16:06:37,DUMMY_Gemini_BTCUSD_1h_01_07_22_to_16_06_23.csv,BTC_USD,HOUR,205.36,0.019,18/01/2023 12:00:00,18/01/2023 15:00:00,18/01/2023 15:00:00,STOP_LOSS_HIT,LONG,21257.0,21037.47,21915.58,21037.47,1.967,3.01,1.04,12.21,2,3.2,-4.47,0.075,0.30291225,TAKER
03/07/2022 01:00:00,19/06/2023 16:06:37,DUMMY_Gemini_BTCUSD_1h_01_07_22_to_16_06_23.csv,BTC_USD,HOUR,200.89,0.009,03/07/2022 03:00:00,03/07/2022 08:00:00,03/07/2022 08:00:00,EXPIRED,LONG,19173.0,18995.0,20567.31,18708.23,0.859,6.78,2.48,12.42,2,3.1,-1.73,0.075,0.12941774999999997,TAKER
16/04/2023 20:00:00,19/06/2023 16:06:37,DUMMY_Gemini_BTCUSD_1h_01_07_22_to_16_06_23.csv,BTC_USD,HOUR,199.16,0.012,16/04/2023 22:00:00,17/04/2023 03:00:00,17/04/2023 00:00:00,STOP_LOSS_HIT,LONG,30333.0,30010.92,31299.25,30010.92,1.828,3.09,1.07,11.32,2,3.2,-4.14,0.075,0.272997,TAKER
04/02/2023 21:00:00,19/06/2023 16:06:37,DUMMY_Gemini_BTCUSD_1h_01_07_22_to_16_06_23.csv,BTC_USD,HOUR,195.02,0.009,04/02/2023 23:00:00,05/02/2023 04:00:00,05/02/2023 04:00:00,EXPIRED,LONG,23425.0,23375.0,24753.37,22982.21,1.081,5.37,1.93,11.8,2,3.1,-0.61,0.075,0.15811874999999997,TAKER
10/06/2023 21:00:00,19/06/2023 16:06:37,DUMMY_Gemini_BTCUSD_1h_01_07_22_to_16_06_23.csv,BTC_USD,HOUR,194.41,0.008,11/06/2023 04:00:00,11/06/2023 04:00:00,11/06/2023 04:00:00,EXPIRED,SHORT,25778.0,25745.0,24364.72,26249.1,1.061,5.8,1.79,11.15,2,3.1,0.11,0.075,0.154668,TAKER
06/12/2022 22:00:00,19/06/2023 16:06:37,DUMMY_Gemini_BTCUSD_1h_01_07_22_to_16_06_23.csv,BTC_USD,HOUR,194.52,0.023,07/12/2022 04:00:00,07/12/2022 05:00:00,07/12/2022 05:00:00,EXPIRED,SHORT,16981.0,17008.0,16462.76,17153.75,2.008,3.15,1.01,11.63,2,3.2,-0.91,0.075,0.29292225,TAKER
20/10/2022 15:00:00,19/06/2023 16:06:37,DUMMY_Gemini_BTCUSD_1h_01_07_22_to_16_06_23.csv,BTC_USD,HOUR,193.61,0.011,20/10/2022 18:00:00,20/10/2022 22:00:00,20/10/2022 22:00:00,EXPIRED,LONG,19258.0,19038.0,20302.46,18909.85,1.094,5.14,1.84,11.33,2,3.1,-2.58,0.075,0.15887849999999998,TAKER
17/09/2022 17:00:00,19/06/2023 16:06:37,DUMMY_Gemini_BTCUSD_1h_01_07_22_to_16_06_23.csv,BTC_USD,HOUR,191.03,0.005,17/09/2022 20:00:00,18/09/2022 00:00:00,18/09/2022 00:00:00,EXPIRED,LONG,20087.0,19984.0,22205.68,19380.77,0.526,9.54,3.64,10.52,2,3.0,-0.59,0.075,0.07532625,TAKER
07/07/2022 16:00:00,19/06/2023 16:06:37,DUMMY_Gemini_BTCUSD_1h_01_07_22_to_16_06_23.csv,BTC_USD,HOUR,190.44,0.017,07/07/2022 18:00:00,07/07/2022 23:00:00,07/07/2022 17:00:00,STOP_LOSS_HIT,LONG,21078.0,20851.22,21758.35,20851.22,1.882,3.13,1.09,11.3,2,3.1,-4.12,0.075,0.2687445,TAKER
02/04/2023 00:00:00,19/06/2023 16:06:37,DUMMY_Gemini_BTCUSD_1h_01_07_22_to_16_06_23.csv,BTC_USD,HOUR,186.32,0.012,02/04/2023 03:00:00,02/04/2023 07:00:00,02/04/2023 07:00:00,EXPIRED,LONG,28383.0,28435.0,29338.88,28064.38,1.828,3.26,1.14,11.22,2,3.1,0.37,0.075,0.255447,TAKER
14/07/2022 22:00:00,19/06/2023 16:06:37,DUMMY_Gemini_BTCUSD_1h_01_07_22_to_16_06_23.csv,BTC_USD,HOUR,186.69,0.016,15/07/2022 02:00:00,15/07/2022 05:00:00,15/07/2022 05:00:00,EXPIRED,LONG,20501.0,20655.0,21205.78,20266.07,1.757,3.32,1.16,11.03,2,3.1,2.22,0.075,0.246012,TAKER
04/05/2023 13:00:00,19/06/2023 16:06:37,DUMMY_Gemini_BTCUSD_1h_01_07_22_to_16_06_23.csv,BTC_USD,HOUR,188.91,0.012,04/05/2023 15:00:00,04/05/2023 20:00:00,04/05/2023 20:00:00,EXPIRED,LONG,28769.0,28878.0,29711.08,28454.98,1.827,3.17,1.1,11.05,2,3.1,1.05,0.075,0.258921,TAKER
15/01/2023 20:00:00,19/06/2023 16:06:37,DUMMY_Gemini_BTCUSD_1h_01_07_22_to_16_06_23.csv,BTC_USD,HOUR,189.96,0.011,16/01/2023 01:00:00,16/01/2023 03:00:00,16/01/2023 03:00:00,EXPIRED,LONG,20909.0,21087.0,21961.53,20558.16,1.211,4.79,1.71,11.41,2,3.1,1.79,0.075,0.17249924999999997,TAKER
28/07/2022 16:00:00,19/06/2023 16:06:37,DUMMY_Gemini_BTCUSD_1h_01_07_22_to_16_06_23.csv,BTC_USD,HOUR,191.75,0.009,28/07/2022 23:00:00,28/07/2022 23:00:00,28/07/2022 23:00:00,EXPIRED,LONG,23765.0,23860.0,25008.21,23350.6,1.115,4.97,1.77,11.03,2,3.1,0.69,0.075,0.16041375,TAKER
22/11/2022 15:00:00,19/06/2023 16:06:37,DUMMY_Gemini_BTCUSD_1h_01_07_22_to_16_06_23.csv,BTC_USD,HOUR,192.44,0.011,22/11/2022 17:00:00,22/11/2022 22:00:00,22/11/2022 22:00:00,EXPIRED,LONG,16248.0,16153.0,17303.03,15896.32,0.929,6.1,2.21,11.47,2,3.1,-1.18,0.075,0.134046,TAKER
06/06/2023 19:00:00,19/06/2023 16:06:37,DUMMY_Gemini_BTCUSD_1h_01_07_22_to_16_06_23.csv,BTC_USD,HOUR,191.26,0.014,07/06/2023 00:00:00,07/06/2023 02:00:00,07/06/2023 02:00:00,EXPIRED,LONG,27091.0,26937.0,27914.36,26816.55,1.983,2.95,1.02,11.24,2,3.2,-2.44,0.075,0.28445550000000003,TAKER
10/04/2023 23:00:00,19/06/2023 16:06:37,DUMMY_Gemini_BTCUSD_1h_01_07_22_to_16_06_23.csv,BTC_USD,HOUR,188.82,0.012,11/04/2023 03:00:00,11/04/2023 06:00:00,11/04/2023 06:00:00,EXPIRED,LONG,29654.0,30070.0,30588.71,29342.43,1.885,3.06,1.06,10.95,2,3.2,4.73,0.075,0.266886,TAKER
13/03/2023 06:00:00,19/06/2023 16:06:37,DUMMY_Gemini_BTCUSD_1h_01_07_22_to_16_06_23.csv,BTC_USD,HOUR,193.55,0.014,13/03/2023 09:00:00,13/03/2023 13:00:00,13/03/2023 09:00:00,STOP_LOSS_HIT,LONG,22520.0,22235.36,23373.92,22235.36,1.629,3.65,1.28,11.72,2,3.1,-4.22,0.075,0.23646,TAKER
18/12/2022 23:00:00,19/06/2023 16:06:37,DUMMY_Gemini_BTCUSD_1h_01_07_22_to_16_06_23.csv,BTC_USD,HOUR,189.33,0.02,19/12/2022 05:00:00,19/12/2022 06:00:00,19/12/2022 06:00:00,EXPIRED,LONG,16746.0,16742.0,17320.84,16554.39,1.769,3.32,1.16,11.25,2,3.1,-0.33,0.075,0.25119,TAKER
07/07/2022 17:00:00,19/06/2023 16:06:37,DUMMY_Gemini_BTCUSD_1h_01_07_22_to_16_06_23.csv,BTC_USD,HOUR,189.0,0.008,07/07/2022 22:00:00,08/07/2022 00:00:00,08/07/2022 00:00:00,EXPIRED,LONG,20893.0,21716.0,22336.4,20411.87,0.884,6.46,2.36,11.42,2,3.1,6.46,0.075,0.125358,TAKER
11/03/2023 03:00:00,19/06/2023 16:06:37,DUMMY_Gemini_BTCUSD_1h_01_07_22_to_16_06_23.csv,BTC_USD,HOUR,195.46,0.009,11/03/2023 05:00:00,11/03/2023 10:00:00,11/03/2023 07:00:00,TAKE_PROFIT_HIT,LONG,20558.0,21908.78,21908.78,20107.74,0.947,6.17,2.24,12.02,2,3.1,12.02,0.075,0.1387665,TAKER
22/10/2022 19:00:00,19/06/2023 16:06:37,DUMMY_Gemini_BTCUSD_1h_01_07_22_to_16_06_23.csv,BTC_USD,HOUR,207.48,0.021,22/10/2022 23:00:00,23/10/2022 02:00:00,23/10/2022 02:00:00,EXPIRED,LONG,19185.0,19200.0,19765.21,18991.6,1.942,2.94,1.02,11.88,2,3.2,0.01,0.075,0.30216375,TAKER
23/05/2023 04:00:00,19/06/2023 16:06:37,DUMMY_Gemini_BTCUSD_1h_01_07_22_to_16_06_23.csv,BTC_USD,HOUR,207.49,0.007,23/05/2023 07:00:00,23/05/2023 11:00:00,23/05/2023 11:00:00,EXPIRED,LONG,27367.0,27340.0,29185.35,26760.89,0.923,6.23,2.26,12.58,2,3.1,-0.33,0.075,0.14367675,TAKER
20/08/2022 15:00:00,19/06/2023 16:06:37,DUMMY_Gemini_BTCUSD_1h_01_07_22_to_16_06_23.csv,BTC_USD,HOUR,207.16,0.014,20/08/2022 21:00:00,20/08/2022 22:00:00,20/08/2022 19:00:00,STOP_LOSS_HIT,LONG,21312.0,21016.57,22198.3,21016.57,1.44,3.99,1.41,12.18,2,3.1,-4.36,0.075,0.22377599999999997,TAKER
04/12/2022 20:00:00,19/06/2023 16:06:37,DUMMY_Gemini_BTCUSD_1h_01_07_22_to_16_06_23.csv,BTC_USD,HOUR,202.8,0.02,05/12/2022 02:00:00,05/12/2022 03:00:00,05/12/2022 03:00:00,EXPIRED,LONG,17084.0,17202.0,17677.95,16886.02,1.685,3.36,1.17,11.62,2,3.1,2.1,0.075,0.25626,TAKER
27/02/2023 15:00:00,19/06/2023 16:06:37,DUMMY_Gemini_BTCUSD_1h_01_07_22_to_16_06_23.csv,BTC_USD,HOUR,204.9,0.008,27/02/2023 17:00:00,27/02/2023 22:00:00,27/02/2023 22:00:00,EXPIRED,LONG,23546.0,23483.0,25038.72,23048.43,0.919,5.96,2.16,11.8,2,3.1,-0.65,0.075,0.14127599999999998,TAKER
18/03/2023 15:00:00,19/06/2023 16:06:37,DUMMY_Gemini_BTCUSD_1h_01_07_22_to_16_06_23.csv,BTC_USD,HOUR,204.25,0.013,18/03/2023 19:00:00,18/03/2023 22:00:00,18/03/2023 16:00:00,STOP_LOSS_HIT,LONG,27334.0,27025.55,28259.36,27025.55,1.74,3.27,1.14,11.76,2,3.1,-4.28,0.075,0.2665065,TAKER
19/05/2023 19:00:00,19/06/2023 16:06:37,DUMMY_Gemini_BTCUSD_1h_01_07_22_to_16_06_23.csv,BTC_USD,HOUR,199.97,0.015,19/05/2023 22:00:00,20/05/2023 02:00:00,20/05/2023 02:00:00,EXPIRED,LONG,26842.0,26851.0,27667.12,26566.96,2.013,2.98,1.04,12.07,2,3.2,-0.17,0.075,0.3019725,TAKER
05/07/2022 00:00:00,19/06/2023 16:06:37,DUMMY_Gemini_BTCUSD_1h_01_07_22_to_16_06_23.csv,BTC_USD,HOUR,199.8,0.009,05/07/2022 01:00:00,05/07/2022 07:00:00,05/07/2022 07:00:00,EXPIRED,LONG,20376.0,20186.0,21757.83,19915.39,0.918,6.35,2.31,12.3,2,3.1,-1.85,0.075,0.137538,TAKER
10/10/2022 08:00:00,19/06/2023 16:06:37,DUMMY_Gemini_BTCUSD_1h_01_07_22_to_16_06_23.csv,BTC_USD,HOUR,197.95,0.01,10/10/2022 10:00:00,10/10/2022 15:00:00,10/10/2022 15:00:00,EXPIRED,LONG,19239.0,19271.0,20402.72,18851.09,0.972,5.7,2.06,11.49,2,3.1,0.18,0.075,0.1442925,TAKER
16/08/2022 04:00:00,19/06/2023 16:06:37,DUMMY_Gemini_BTCUSD_1h_01_07_22_to_16_06_23.csv,BTC_USD,HOUR,198.13,0.014,16/08/2022 10:00:00,16/08/2022 11:00:00,16/08/2022 11:00:00,EXPIRED,LONG,23962.0,24038.0,24803.88,23681.38,1.693,3.39,1.18,11.53,2,3.1,0.81,0.075,0.251601,TAKER
29/01/2023 14:00:00,19/06/2023 16:06:37,DUMMY_Gemini_BTCUSD_1h_01_07_22_to_16_06_23.csv,BTC_USD,HOUR,198.94,0.009,29/01/2023 20:00:00,29/01/2023 21:00:00,29/01/2023 21:00:00,EXPIRED,LONG,23553.0,23814.0,24915.65,23098.78,1.066,5.47,1.97,12.1,2,3.1,2.19,0.075,0.15898274999999998,TAKER
05/07/2022 00:00:00,19/06/2023 16:06:37,DUMMY_Gemini_BTCUSD_1h_01_07_22_to_16_06_23.csv,BTC_USD,HOUR,201.13,0.009,05/07/2022 01:00:00,05/07/2022 07:00:00,05/07/2022 07:00:00,EXPIRED,LONG,20376.0,20186.0,21757.83,19915.39,0.912,6.35,2.31,12.3,2,3.1,-1.85,0.075,0.137538,TAKER
28/09/2022 13:00:00,19/06/2023 16:06:37,DUMMY_Gemini_BTCUSD_1h_01_07_22_to_16_06_23.csv,BTC_USD,HOUR,199.28,0.015,28/09/2022 21:00:00,28/09/2022 20:00:00,28/09/2022 20:00:00,EXPIRED,LONG,19132.0,19564.0,19921.09,18868.97,1.44,3.96,1.39,11.62,2,3.1,6.26,0.075,0.21523499999999995,TAKER
02/12/2022 13:00:00,19/06/2023 16:06:37,DUMMY_Gemini_BTCUSD_1h_01_07_22_to_16_06_23.csv,BTC_USD,HOUR,205.54,0.014,02/12/2022 15:00:00,02/12/2022 20:00:00,02/12/2022 20:00:00,EXPIRED,LONG,16911.0,17035.0,17775.73,16622.76,1.152,4.86,1.73,11.93,2,3.1,1.56,0.075,0.17756550000000001,TAKER
23/12/2022 05:00:00,19/06/2023 16:06:37,DUMMY_Gemini_BTCUSD_1h_01_07_22_to_16_06_23.csv,BTC_USD,HOUR,207.1,0.014,23/12/2022 07:00:00,23/12/2022 12:00:00,23/12/2022 12:00:00,EXPIRED,LONG,16824.0,16873.0,17692.95,16534.35,1.137,4.91,1.75,11.99,2,3.1,0.51,0.075,0.17665199999999998,TAKER
02/05/2023 13:00:00,19/06/2023 16:06:37,DUMMY_Gemini_BTCUSD_1h_01_07_22_to_16_06_23.csv,BTC_USD,HOUR,207.61,0.006,02/05/2023 19:00:00,02/05/2023 20:00:00,02/05/2023 20:00:00,EXPIRED,LONG,28000.0,28689.0,29921.64,27359.46,0.809,6.42,2.34,11.4,2,3.1,4.01,0.075,0.126,TAKER
08/06/2023 18:00:00,19/06/2023 16:06:37,DUMMY_Gemini_BTCUSD_1h_01_07_22_to_16_06_23.csv,BTC_USD,HOUR,211.62,0.008,09/06/2023 02:00:00,09/06/2023 01:00:00,09/06/2023 01:00:00,EXPIRED,SHORT,26558.0,26523.0,24928.75,27101.09,1.004,6.54,2.0,12.87,2,3.1,0.12,0.075,0.159348,TAKER
22/05/2023 18:00:00,19/06/2023 16:06:37,DUMMY_Gemini_BTCUSD_1h_01_07_22_to_16_06_23.csv,BTC_USD,HOUR,211.74,0.009,23/05/2023 00:00:00,23/05/2023 01:00:00,23/05/2023 01:00:00,EXPIRED,SHORT,26879.0,26997.0,25424.85,27363.72,1.142,5.72,1.77,12.91,2,3.1,-1.24,0.075,0.18143324999999996,TAKER
14/08/2022 05:00:00,19/06/2023 16:06:37,DUMMY_Gemini_BTCUSD_1h_01_07_22_to_16_06_23.csv,BTC_USD,HOUR,210.5,0.015,14/08/2022 11:00:00,14/08/2022 12:00:00,14/08/2022 12:00:00,EXPIRED,LONG,24597.0,24539.0,25419.08,24322.98,1.753,3.23,1.13,12.05,2,3.1,-1.15,0.075,0.27671625,TAKER
06/01/2023 20:00:00,19/06/2023 16:06:37,DUMMY_Gemini_BTCUSD_1h_01_07_22_to_16_06_23.csv,BTC_USD,HOUR,209.35,0.023,06/01/2023 23:00:00,07/01/2023 03:00:00,07/01/2023 03:00:00,EXPIRED,LONG,16897.0,16947.0,17448.8,16713.07,1.856,3.16,1.1,12.4,2,3.1,0.86,0.075,0.29147324999999996,TAKER
25/03/2023 16:00:00,19/06/2023 16:06:37,DUMMY_Gemini_BTCUSD_1h_01_07_22_to_16_06_23.csv,BTC_USD,HOUR,210.21,0.007,25/03/2023 20:00:00,25/03/2023 23:00:00,25/03/2023 23:00:00,EXPIRED,LONG,27670.0,27494.0,29381.98,27099.34,0.921,5.83,2.11,11.84,2,3.1,-1.38,0.075,0.1452675,TAKER
29/01/2023 16:00:00,19/06/2023 16:06:37,DUMMY_Gemini_BTCUSD_1h_01_07_22_to_16_06_23.csv,BTC_USD,HOUR,208.83,0.017,29/01/2023 21:00:00,29/01/2023 23:00:00,29/01/2023 23:00:00,EXPIRED,LONG,23594.0,23761.0,24315.98,23353.34,1.921,2.97,1.03,11.97,2,3.2,2.54,0.075,0.30082349999999997,TAKER
04/09/2022 12:00:00,19/06/2023 16:06:37,DUMMY_Gemini_BTCUSD_1h_01_07_22_to_16_06_23.csv,BTC_USD,HOUR,211.37,0.011,04/09/2022 13:00:00,04/09/2022 19:00:00,04/09/2022 19:00:00,EXPIRED,LONG,19875.0,19886.0,21053.64,19482.12,1.034,5.6,2.02,12.8,2,3.1,-0.04,0.075,0.16396874999999997,TAKER
12/05/2023 20:00:00,19/06/2023 16:06:37,DUMMY_Gemini_BTCUSD_1h_01_07_22_to_16_06_23.csv,BTC_USD,HOUR,211.33,0.014,13/05/2023 02:00:00,13/05/2023 03:00:00,13/05/2023 03:00:00,EXPIRED,LONG,26441.0,26825.0,27369.98,26131.34,1.752,3.39,1.19,12.73,2,3.1,5.1,0.075,0.27763050000000006,TAKER
02/06/2023 22:00:00,19/06/2023 16:06:37,DUMMY_Gemini_BTCUSD_1h_01_07_22_to_16_06_23.csv,BTC_USD,HOUR,216.43,0.015,03/06/2023 04:00:00,03/06/2023 05:00:00,03/06/2023 05:00:00,EXPIRED,LONG,27273.0,27172.0,28129.87,26987.38,1.89,3.05,1.06,12.55,2,3.2,-1.82,0.075,0.30682124999999993,TAKER
12/02/2023 04:00:00,19/06/2023 16:06:37,DUMMY_Gemini_BTCUSD_1h_01_07_22_to_16_06_23.csv,BTC_USD,HOUR,214.61,0.015,12/02/2023 08:00:00,12/02/2023 11:00:00,12/02/2023 11:00:00,EXPIRED,LONG,21781.0,21902.0,22620.82,21501.06,1.522,3.71,1.3,12.35,2,3.1,1.57,0.075,0.24503624999999996,TAKER
23/10/2022 19:00:00,19/06/2023 16:06:37,DUMMY_Gemini_BTCUSD_1h_01_07_22_to_16_06_23.csv,BTC_USD,HOUR,216.18,0.021,23/10/2022 21:00:00,24/10/2022 02:00:00,24/10/2022 02:00:00,EXPIRED,LONG,19505.0,19418.0,20121.15,19299.62,1.895,3.06,1.06,12.63,2,3.1,-2.13,0.075,0.30720375,TAKER
13/09/2022 11:00:00,19/06/2023 16:06:37,DUMMY_Gemini_BTCUSD_1h_01_07_22_to_16_06_23.csv,BTC_USD,HOUR,214.05,0.007,13/09/2022 14:00:00,13/09/2022 18:00:00,13/09/2022 12:00:00,STOP_LOSS_HIT,LONG,22534.0,21922.99,24367.05,21922.99,0.737,7.52,2.79,12.71,2,3.1,-4.4,0.075,0.11830349999999999,TAKER
28/02/2023 13:00:00,19/06/2023 16:06:37,DUMMY_Gemini_BTCUSD_1h_01_07_22_to_16_06_23.csv,BTC_USD,HOUR,209.65,0.007,28/02/2023 16:00:00,28/02/2023 20:00:00,28/02/2023 20:00:00,EXPIRED,LONG,23384.0,23273.0,25073.26,22820.92,0.781,6.74,2.47,11.7,2,3.1,-0.9,0.075,0.122766,TAKER
29/01/2023 09:00:00,19/06/2023 16:06:37,DUMMY_Gemini_BTCUSD_1h_01_07_22_to_16_06_23.csv,BTC_USD,HOUR,208.75,0.018,29/01/2023 12:00:00,29/01/2023 16:00:00,29/01/2023 16:00:00,EXPIRED,LONG,23283.0,23594.0,23997.23,23044.92,2.008,2.98,1.03,12.54,2,3.2,5.28,0.075,0.31432049999999995,TAKER
13/03/2023 07:00:00,19/06/2023 16:06:37,DUMMY_Gemini_BTCUSD_1h_01_07_22_to_16_06_23.csv,BTC_USD,HOUR,214.03,0.015,13/03/2023 09:00:00,13/03/2023 14:00:00,13/03/2023 09:00:00,STOP_LOSS_HIT,LONG,22623.0,22343.78,23460.66,22343.78,1.586,3.57,1.25,12.31,2,3.1,-4.44,0.075,0.25450874999999995,TAKER
09/04/2023 03:00:00,19/06/2023 16:06:37,DUMMY_Gemini_BTCUSD_1h_01_07_22_to_16_06_23.csv,BTC_USD,HOUR,209.59,0.006,09/04/2023 06:00:00,09/04/2023 10:00:00,09/04/2023 10:00:00,EXPIRED,LONG,28058.0,27893.0,30103.28,27376.24,0.803,6.79,2.49,12.15,2,3.1,-1.12,0.075,0.126261,TAKER
18/01/2023 14:00:00,19/06/2023 16:06:37,DUMMY_Gemini_BTCUSD_1h_01_07_22_to_16_06_23.csv,BTC_USD,HOUR,208.47,0.01,18/01/2023 21:00:00,18/01/2023 21:00:00,18/01/2023 15:00:00,STOP_LOSS_HIT,LONG,21422.0,21022.98,22619.07,21022.98,1.028,5.29,1.9,11.81,2,3.1,-4.15,0.075,0.16066499999999997,TAKER
22/04/2023 18:00:00,19/06/2023 16:06:37,DUMMY_Gemini_BTCUSD_1h_01_07_22_to_16_06_23.csv,BTC_USD,HOUR,204.32,0.006,22/04/2023 20:00:00,23/04/2023 01:00:00,23/04/2023 01:00:00,EXPIRED,LONG,27614.0,27560.0,29630.69,26941.77,0.811,6.81,2.5,11.98,2,3.1,-0.45,0.075,0.124263,TAKER
14/04/2023 06:00:00,19/06/2023 16:06:37,DUMMY_Gemini_BTCUSD_1h_01_07_22_to_16_06_23.csv,BTC_USD,HOUR,203.87,0.005,14/04/2023 11:00:00,14/04/2023 13:00:00,14/04/2023 13:00:00,EXPIRED,LONG,30966.0,30768.0,33421.24,30147.59,0.759,7.35,2.71,12.16,2,3.1,-1.11,0.075,0.11612250000000002,TAKER
