Open,Last update,Platform,Symbol,Timeframe,Account balance at open,Size,Expected close,Expiry,Close,Status,Side,Opening price,Closing price,Take profit,Stop loss,Leverage,TP price %,SL price %,Expected profit,Risk %,R/R ratio,PnL,Fee %,Fee Amount,Order Type
28/07/2022 01:00:00,18/06/2023 21:39:56,DUMMY_Gemini_BTCUSD_1h_01_07_22_to_16_06_23.csv,BTC_USD,HOUR,200.0,0.015,28/07/2022 09:00:00,28/07/2022 08:00:00,28/07/2022 02:00:00,STOP_LOSS_HIT,SHORT,22783.0,23054.19,21969.44,23054.19,1.709,3.7,1.18,11.95,2,3.1,-4.32,0.075,0.25630875,TAKER
10/09/2022 07:00:00,18/06/2023 21:39:56,DUMMY_Gemini_BTCUSD_1h_01_07_22_to_16_06_23.csv,BTC_USD,HOUR,195.68,0.007,10/09/2022 10:00:00,10/09/2022 14:00:00,10/09/2022 14:00:00,EXPIRED,LONG,21278.0,21248.0,23031.88,20693.37,0.761,7.62,2.83,12.17,2,3.1,-0.32,0.075,0.11170949999999999,TAKER
17/02/2023 22:00:00,18/06/2023 21:39:56,DUMMY_Gemini_BTCUSD_1h_01_07_22_to_16_06_23.csv,BTC_USD,HOUR,195.36,0.013,18/02/2023 03:00:00,18/02/2023 05:00:00,18/02/2023 05:00:00,EXPIRED,LONG,24701.0,24651.0,25596.79,24402.41,1.644,3.5,1.22,11.4,2,3.1,-0.89,0.075,0.24083475,TAKER
14/04/2023 14:00:00,18/06/2023 21:39:56,DUMMY_Gemini_BTCUSD_1h_01_07_22_to_16_06_23.csv,BTC_USD,HOUR,194.47,0.011,14/04/2023 16:00:00,14/04/2023 21:00:00,14/04/2023 15:00:00,STOP_LOSS_HIT,LONG,30634.0,30265.49,31739.55,30265.49,1.733,3.48,1.22,11.91,2,3.1,-4.31,0.075,0.25273049999999997,TAKER
13/03/2023 23:00:00,18/06/2023 21:39:56,DUMMY_Gemini_BTCUSD_1h_01_07_22_to_16_06_23.csv,BTC_USD,HOUR,190.16,0.006,14/03/2023 01:00:00,14/03/2023 06:00:00,14/03/2023 06:00:00,EXPIRED,LONG,24237.0,24493.0,26252.91,23565.03,0.765,7.68,2.85,11.99,2,3.1,1.43,0.075,0.1090665,TAKER
29/01/2023 01:00:00,18/06/2023 21:39:56,DUMMY_Gemini_BTCUSD_1h_01_07_22_to_16_06_23.csv,BTC_USD,HOUR,191.59,0.009,29/01/2023 06:00:00,29/01/2023 08:00:00,29/01/2023 08:00:00,EXPIRED,LONG,23260.0,23163.0,24556.41,22827.86,1.093,5.28,1.89,11.51,2,3.1,-1.03,0.075,0.15700499999999998,TAKER
20/12/2022 05:00:00,18/06/2023 21:39:56,DUMMY_Gemini_BTCUSD_1h_01_07_22_to_16_06_23.csv,BTC_USD,HOUR,190.56,0.02,20/12/2022 08:00:00,20/12/2022 12:00:00,20/12/2022 12:00:00,EXPIRED,LONG,16786.0,16822.0,17372.01,16590.66,1.762,3.37,1.18,11.47,2,3.1,0.47,0.075,0.25179,TAKER
11/04/2023 11:00:00,18/06/2023 21:39:56,DUMMY_Gemini_BTCUSD_1h_01_07_22_to_16_06_23.csv,BTC_USD,HOUR,191.03,0.007,11/04/2023 18:00:00,11/04/2023 18:00:00,11/04/2023 18:00:00,EXPIRED,SHORT,30088.0,30258.0,28343.3,30669.57,1.103,6.16,1.9,12.05,2,3.1,-1.35,0.075,0.15796200000000002,TAKER
26/03/2023 11:00:00,18/06/2023 21:39:56,DUMMY_Gemini_BTCUSD_1h_01_07_22_to_16_06_23.csv,BTC_USD,HOUR,189.68,0.005,26/03/2023 16:00:00,26/03/2023 18:00:00,26/03/2023 18:00:00,EXPIRED,LONG,27890.0,27839.0,30156.56,27134.48,0.735,7.52,2.78,11.23,2,3.1,-0.36,0.075,0.1045875,TAKER
29/07/2022 17:00:00,18/06/2023 21:39:56,DUMMY_Gemini_BTCUSD_1h_01_07_22_to_16_06_23.csv,BTC_USD,HOUR,189.32,0.014,29/07/2022 19:00:00,30/07/2022 00:00:00,30/07/2022 00:00:00,EXPIRED,LONG,23794.0,23939.0,24631.75,23514.75,1.76,3.4,1.19,11.48,2,3.1,1.78,0.075,0.24983699999999998,TAKER
02/05/2023 06:00:00,18/06/2023 21:39:56,DUMMY_Gemini_BTCUSD_1h_01_07_22_to_16_06_23.csv,BTC_USD,HOUR,191.1,0.006,02/05/2023 08:00:00,02/05/2023 13:00:00,02/05/2023 13:00:00,EXPIRED,LONG,28008.0,28000.0,30026.24,27335.26,0.879,6.72,2.46,11.98,2,3.1,-0.17,0.075,0.126036,TAKER
22/11/2022 14:00:00,18/06/2023 21:39:56,DUMMY_Gemini_BTCUSD_1h_01_07_22_to_16_06_23.csv,BTC_USD,HOUR,190.93,0.016,22/11/2022 18:00:00,22/11/2022 21:00:00,22/11/2022 21:00:00,EXPIRED,LONG,16094.0,16143.0,16794.65,15860.45,1.349,4.17,1.47,11.02,2,3.1,0.59,0.075,0.193128,TAKER
26/07/2022 23:00:00,18/06/2023 21:39:56,DUMMY_Gemini_BTCUSD_1h_01_07_22_to_16_06_23.csv,BTC_USD,HOUR,191.52,0.017,27/07/2022 00:00:00,27/07/2022 06:00:00,27/07/2022 03:00:00,STOP_LOSS_HIT,LONG,21274.0,21051.99,21940.04,21051.99,1.888,3.04,1.05,11.05,2,3.2,-4.05,0.075,0.27124349999999997,TAKER
21/08/2022 19:00:00,18/06/2023 21:39:56,DUMMY_Gemini_BTCUSD_1h_01_07_22_to_16_06_23.csv,BTC_USD,HOUR,187.47,0.011,22/08/2022 00:00:00,22/08/2022 02:00:00,22/08/2022 02:00:00,EXPIRED,LONG,21513.0,21471.0,22529.79,21174.07,1.262,4.51,1.6,11.01,2,3.1,-0.64,0.075,0.17748224999999998,TAKER
30/07/2022 19:00:00,18/06/2023 21:39:56,DUMMY_Gemini_BTCUSD_1h_01_07_22_to_16_06_23.csv,BTC_USD,HOUR,186.83,0.012,31/07/2022 03:00:00,31/07/2022 02:00:00,31/07/2022 02:00:00,EXPIRED,SHORT,23939.0,23806.0,22968.01,24262.66,1.538,4.23,1.33,11.44,2,3.1,1.38,0.075,0.215451,TAKER
30/08/2022 10:00:00,18/06/2023 21:39:56,DUMMY_Gemini_BTCUSD_1h_01_07_22_to_16_06_23.csv,BTC_USD,HOUR,188.21,0.016,30/08/2022 18:00:00,30/08/2022 17:00:00,30/08/2022 15:00:00,TAKE_PROFIT_HIT,SHORT,20409.0,19712.43,19712.43,20641.19,1.735,3.53,1.12,10.9,2,3.1,10.9,0.075,0.24490799999999996,TAKER
09/01/2023 10:00:00,18/06/2023 21:39:56,DUMMY_Gemini_BTCUSD_1h_01_07_22_to_16_06_23.csv,BTC_USD,HOUR,199.11,0.02,09/01/2023 15:00:00,09/01/2023 17:00:00,09/01/2023 17:00:00,EXPIRED,LONG,17262.0,17365.0,17846.55,17067.15,1.734,3.28,1.14,11.43,2,3.1,1.8,0.075,0.25893,TAKER
06/07/2022 00:00:00,18/06/2023 21:39:56,DUMMY_Gemini_BTCUSD_1h_01_07_22_to_16_06_23.csv,BTC_USD,HOUR,200.91,0.012,06/07/2022 05:00:00,06/07/2022 07:00:00,06/07/2022 01:00:00,STOP_LOSS_HIT,LONG,20234.0,19899.38,21237.86,19899.38,1.209,4.73,1.68,11.86,2,3.1,-4.2,0.075,0.182106,TAKER
13/03/2023 02:00:00,18/06/2023 21:39:56,DUMMY_Gemini_BTCUSD_1h_01_07_22_to_16_06_23.csv,BTC_USD,HOUR,196.71,0.008,13/03/2023 04:00:00,13/03/2023 09:00:00,13/03/2023 09:00:00,EXPIRED,LONG,22511.0,22234.0,23913.04,22043.66,0.915,5.86,2.12,11.08,2,3.1,-2.35,0.075,0.135066,TAKER
14/11/2022 08:00:00,18/06/2023 21:39:56,DUMMY_Gemini_BTCUSD_1h_01_07_22_to_16_06_23.csv,BTC_USD,HOUR,194.36,0.011,14/11/2022 10:00:00,14/11/2022 15:00:00,14/11/2022 15:00:00,EXPIRED,LONG,16748.0,16567.0,17835.51,16385.5,0.948,6.1,2.21,11.82,2,3.1,-2.13,0.075,0.138171,TAKER
24/09/2022 06:00:00,18/06/2023 21:39:56,DUMMY_Gemini_BTCUSD_1h_01_07_22_to_16_06_23.csv,BTC_USD,HOUR,192.23,0.018,24/09/2022 08:00:00,24/09/2022 13:00:00,24/09/2022 13:00:00,EXPIRED,LONG,19093.0,19133.0,19721.93,18883.36,1.788,3.19,1.11,11.06,2,3.1,0.46,0.075,0.25775549999999997,TAKER
22/01/2023 00:00:00,18/06/2023 21:39:56,DUMMY_Gemini_BTCUSD_1h_01_07_22_to_16_06_23.csv,BTC_USD,HOUR,192.69,0.012,22/01/2023 02:00:00,22/01/2023 07:00:00,22/01/2023 07:00:00,EXPIRED,LONG,22884.0,22903.0,23835.09,22566.97,1.425,3.99,1.4,11.21,2,3.1,0.02,0.075,0.205956,TAKER
21/08/2022 14:00:00,18/06/2023 21:39:56,DUMMY_Gemini_BTCUSD_1h_01_07_22_to_16_06_23.csv,BTC_USD,HOUR,192.71,0.015,21/08/2022 18:00:00,21/08/2022 21:00:00,21/08/2022 21:00:00,EXPIRED,LONG,21419.0,21539.0,22198.64,21159.12,1.667,3.51,1.23,11.45,2,3.1,1.56,0.075,0.24096374999999998,TAKER
26/03/2023 08:00:00,18/06/2023 21:39:56,DUMMY_Gemini_BTCUSD_1h_01_07_22_to_16_06_23.csv,BTC_USD,HOUR,194.27,0.013,26/03/2023 13:00:00,26/03/2023 15:00:00,26/03/2023 15:00:00,EXPIRED,LONG,27693.0,27858.0,28625.4,27382.2,1.853,3.26,1.14,11.85,2,3.1,1.87,0.075,0.27000674999999996,TAKER
25/07/2022 21:00:00,18/06/2023 21:39:56,DUMMY_Gemini_BTCUSD_1h_01_07_22_to_16_06_23.csv,BTC_USD,HOUR,196.14,0.015,26/07/2022 00:00:00,26/07/2022 04:00:00,25/07/2022 22:00:00,STOP_LOSS_HIT,LONG,22024.0,21754.12,22833.64,21754.12,1.684,3.55,1.24,11.9,2,3.1,-4.3,0.075,0.24777000000000002,TAKER
06/10/2022 08:00:00,18/06/2023 21:39:56,DUMMY_Gemini_BTCUSD_1h_01_07_22_to_16_06_23.csv,BTC_USD,HOUR,191.84,0.018,06/10/2022 10:00:00,06/10/2022 15:00:00,06/10/2022 14:00:00,STOP_LOSS_HIT,LONG,20139.0,19920.57,20794.29,19920.57,1.89,3.15,1.1,11.52,2,3.1,-4.2,0.075,0.27187649999999997,TAKER
13/03/2023 00:00:00,18/06/2023 21:39:56,DUMMY_Gemini_BTCUSD_1h_01_07_22_to_16_06_23.csv,BTC_USD,HOUR,187.64,0.014,13/03/2023 02:00:00,13/03/2023 07:00:00,13/03/2023 03:00:00,STOP_LOSS_HIT,LONG,22685.0,22407.74,23516.78,22407.74,1.693,3.54,1.24,11.41,2,3.1,-4.12,0.075,0.2381925,TAKER
16/02/2023 09:00:00,18/06/2023 21:39:56,DUMMY_Gemini_BTCUSD_1h_01_07_22_to_16_06_23.csv,BTC_USD,HOUR,183.52,0.008,16/02/2023 11:00:00,16/02/2023 16:00:00,16/02/2023 16:00:00,EXPIRED,LONG,24662.0,24907.0,26113.77,24178.08,1.075,5.56,2.0,11.47,2,3.1,1.81,0.075,0.147972,TAKER
11/08/2022 09:00:00,18/06/2023 21:39:56,DUMMY_Gemini_BTCUSD_1h_01_07_22_to_16_06_23.csv,BTC_USD,HOUR,185.33,0.012,11/08/2022 11:00:00,11/08/2022 16:00:00,11/08/2022 16:00:00,EXPIRED,LONG,24461.0,24361.0,25373.97,24156.68,1.584,3.6,1.26,10.74,2,3.1,-1.42,0.075,0.22014899999999998,TAKER
23/11/2022 09:00:00,18/06/2023 21:39:56,DUMMY_Gemini_BTCUSD_1h_01_07_22_to_16_06_23.csv,BTC_USD,HOUR,183.91,0.016,23/11/2022 17:00:00,23/11/2022 16:00:00,23/11/2022 16:00:00,EXPIRED,SHORT,16548.0,16313.0,15864.09,16775.97,1.44,4.31,1.36,10.74,2,3.1,3.56,0.075,0.198576,TAKER
12/11/2022 15:00:00,18/06/2023 21:39:56,DUMMY_Gemini_BTCUSD_1h_01_07_22_to_16_06_23.csv,BTC_USD,HOUR,187.47,0.009,12/11/2022 17:00:00,12/11/2022 22:00:00,12/11/2022 22:00:00,EXPIRED,LONG,16878.0,16800.0,18174.59,16445.81,0.81,7.13,2.63,11.56,2,3.1,-0.82,0.075,0.11392649999999999,TAKER
29/10/2022 17:00:00,18/06/2023 21:39:56,DUMMY_Gemini_BTCUSD_1h_01_07_22_to_16_06_23.csv,BTC_USD,HOUR,186.65,0.008,29/10/2022 19:00:00,30/10/2022 00:00:00,30/10/2022 00:00:00,EXPIRED,LONG,20825.0,20721.0,22266.57,20344.48,0.893,6.47,2.36,11.41,2,3.1,-0.96,0.075,0.12494999999999999,TAKER
27/11/2022 03:00:00,18/06/2023 21:39:56,DUMMY_Gemini_BTCUSD_1h_01_07_22_to_16_06_23.csv,BTC_USD,HOUR,185.69,0.02,27/11/2022 08:00:00,27/11/2022 10:00:00,27/11/2022 10:00:00,EXPIRED,LONG,16515.0,16543.0,17060.38,16333.21,1.779,3.2,1.11,10.66,2,3.1,0.31,0.075,0.247725,TAKER
17/12/2022 21:00:00,18/06/2023 21:39:56,DUMMY_Gemini_BTCUSD_1h_01_07_22_to_16_06_23.csv,BTC_USD,HOUR,186.0,0.013,18/12/2022 02:00:00,18/12/2022 04:00:00,18/12/2022 04:00:00,EXPIRED,LONG,16756.0,16769.0,17594.41,16476.53,1.171,4.77,1.7,10.74,2,3.1,0.01,0.075,0.163371,TAKER
28/07/2022 09:00:00,18/06/2023 21:39:56,DUMMY_Gemini_BTCUSD_1h_01_07_22_to_16_06_23.csv,BTC_USD,HOUR,186.01,0.013,28/07/2022 16:00:00,28/07/2022 16:00:00,28/07/2022 13:00:00,STOP_LOSS_HIT,SHORT,22975.0,23257.94,22126.18,23257.94,1.606,3.84,1.22,10.81,2,3.1,-3.9,0.075,0.22400625000000002,TAKER
11/06/2023 07:00:00,18/06/2023 21:39:56,DUMMY_Gemini_BTCUSD_1h_01_07_22_to_16_06_23.csv,BTC_USD,HOUR,182.11,0.009,11/06/2023 12:00:00,11/06/2023 14:00:00,11/06/2023 14:00:00,EXPIRED,LONG,25750.0,25766.0,26989.44,25336.85,1.273,4.59,1.63,10.98,2,3.1,-0.03,0.075,0.17381249999999998,TAKER
24/09/2022 06:00:00,18/06/2023 21:39:56,DUMMY_Gemini_BTCUSD_1h_01_07_22_to_16_06_23.csv,BTC_USD,HOUR,182.08,0.017,24/09/2022 08:00:00,24/09/2022 13:00:00,24/09/2022 13:00:00,EXPIRED,LONG,19093.0,19133.0,19721.93,18883.36,1.783,3.19,1.11,10.45,2,3.1,0.44,0.075,0.24343575,TAKER
18/07/2022 09:00:00,18/06/2023 21:39:56,DUMMY_Gemini_BTCUSD_1h_01_07_22_to_16_06_23.csv,BTC_USD,HOUR,182.52,0.014,18/07/2022 17:00:00,18/07/2022 16:00:00,18/07/2022 15:00:00,STOP_LOSS_HIT,SHORT,22251.0,22504.41,21490.77,22504.41,1.707,3.54,1.13,10.41,2,3.1,-3.78,0.075,0.2336355,TAKER
05/03/2023 15:00:00,18/06/2023 21:39:56,DUMMY_Gemini_BTCUSD_1h_01_07_22_to_16_06_23.csv,BTC_USD,HOUR,178.74,0.01,05/03/2023 16:00:00,05/03/2023 22:00:00,05/03/2023 22:00:00,EXPIRED,LONG,22448.0,22437.0,23503.63,22096.13,1.256,4.49,1.59,10.39,2,3.1,-0.28,0.075,0.16836,TAKER
17/08/2022 01:00:00,18/06/2023 21:39:56,DUMMY_Gemini_BTCUSD_1h_01_07_22_to_16_06_23.csv,BTC_USD,HOUR,178.46,0.013,17/08/2022 09:00:00,17/08/2022 08:00:00,17/08/2022 08:00:00,EXPIRED,LONG,23956.0,23802.0,24777.44,23682.19,1.745,3.32,1.16,10.45,2,3.1,-2.24,0.075,0.233571,TAKER
07/01/2023 19:00:00,18/06/2023 21:39:57,DUMMY_Gemini_BTCUSD_1h_01_07_22_to_16_06_23.csv,BTC_USD,HOUR,176.22,0.012,08/01/2023 00:00:00,08/01/2023 02:00:00,08/01/2023 02:00:00,EXPIRED,LONG,16941.0,16935.0,17855.6,16636.13,1.154,5.12,1.83,10.82,2,3.1,-0.22,0.075,0.152469,TAKER
13/03/2023 01:00:00,18/06/2023 21:39:57,DUMMY_Gemini_BTCUSD_1h_01_07_22_to_16_06_23.csv,BTC_USD,HOUR,176.0,0.015,13/03/2023 02:00:00,13/03/2023 08:00:00,13/03/2023 02:00:00,STOP_LOSS_HIT,LONG,23200.0,22964.57,23906.31,22964.57,1.977,2.95,1.03,10.33,2,3.2,-3.79,0.075,0.26099999999999995,TAKER
29/01/2023 16:00:00,18/06/2023 21:39:57,DUMMY_Gemini_BTCUSD_1h_01_07_22_to_16_06_23.csv,BTC_USD,HOUR,172.21,0.014,29/01/2023 21:00:00,29/01/2023 23:00:00,29/01/2023 23:00:00,EXPIRED,LONG,23594.0,23761.0,24315.98,23353.34,1.918,2.97,1.03,9.86,2,3.2,2.09,0.075,0.247737,TAKER
18/11/2022 07:00:00,18/06/2023 21:39:57,DUMMY_Gemini_BTCUSD_1h_01_07_22_to_16_06_23.csv,BTC_USD,HOUR,174.3,0.019,18/11/2022 13:00:00,18/11/2022 14:00:00,18/11/2022 14:00:00,EXPIRED,SHORT,16729.0,16712.0,16174.64,16913.79,1.824,3.43,1.09,10.29,2,3.1,0.08,0.075,0.23838825,TAKER
04/02/2023 15:00:00,18/06/2023 21:39:57,DUMMY_Gemini_BTCUSD_1h_01_07_22_to_16_06_23.csv,BTC_USD,HOUR,174.38,0.006,04/02/2023 16:00:00,04/02/2023 22:00:00,04/02/2023 22:00:00,EXPIRED,LONG,23430.0,23407.0,25251.11,22822.96,0.806,7.21,2.66,10.82,2,3.1,-0.24,0.075,0.105435,TAKER
04/01/2023 04:00:00,18/06/2023 21:39:57,DUMMY_Gemini_BTCUSD_1h_01_07_22_to_16_06_23.csv,BTC_USD,HOUR,174.14,0.009,04/01/2023 07:00:00,04/01/2023 11:00:00,04/01/2023 11:00:00,EXPIRED,LONG,16856.0,16824.0,18066.79,16452.4,0.871,6.7,2.45,10.78,2,3.1,-0.4,0.075,0.11377799999999999,TAKER
20/10/2022 05:00:00,18/06/2023 21:39:57,DUMMY_Gemini_BTCUSD_1h_01_07_22_to_16_06_23.csv,BTC_USD,HOUR,173.74,0.017,20/10/2022 06:00:00,20/10/2022 12:00:00,20/10/2022 12:00:00,EXPIRED,LONG,19141.0,19136.0,19740.26,18941.25,1.873,3.04,1.05,9.94,2,3.2,-0.33,0.075,0.24404775000000004,TAKER
28/10/2022 18:00:00,18/06/2023 21:39:57,DUMMY_Gemini_BTCUSD_1h_01_07_22_to_16_06_23.csv,BTC_USD,HOUR,173.41,0.011,28/10/2022 23:00:00,29/10/2022 01:00:00,29/10/2022 01:00:00,EXPIRED,LONG,20631.0,20635.0,21544.43,20326.52,1.309,4.24,1.5,9.88,2,3.1,-0.13,0.075,0.17020574999999996,TAKER
29/01/2023 13:00:00,18/06/2023 21:39:57,DUMMY_Gemini_BTCUSD_1h_01_07_22_to_16_06_23.csv,BTC_USD,HOUR,173.28,0.009,29/01/2023 15:00:00,29/01/2023 20:00:00,29/01/2023 20:00:00,EXPIRED,LONG,23558.0,23707.0,24712.42,23173.2,1.224,4.67,1.66,10.23,2,3.1,1.18,0.075,0.15901649999999998,TAKER
11/06/2023 07:00:00,18/06/2023 21:39:57,DUMMY_Gemini_BTCUSD_1h_01_07_22_to_16_06_23.csv,BTC_USD,HOUR,174.46,0.008,11/06/2023 12:00:00,11/06/2023 14:00:00,11/06/2023 14:00:00,EXPIRED,LONG,25750.0,25766.0,26989.44,25336.85,1.181,4.59,1.63,9.76,2,3.1,-0.03,0.075,0.1545,TAKER
21/01/2023 20:00:00,18/06/2023 21:39:57,DUMMY_Gemini_BTCUSD_1h_01_07_22_to_16_06_23.csv,BTC_USD,HOUR,174.43,0.015,22/01/2023 01:00:00,22/01/2023 03:00:00,21/01/2023 22:00:00,STOP_LOSS_HIT,LONG,23137.0,22902.07,23841.79,22902.07,1.99,2.96,1.03,10.31,2,3.2,-3.78,0.075,0.26029125000000003,TAKER
25/08/2022 16:00:00,18/06/2023 21:39:57,DUMMY_Gemini_BTCUSD_1h_01_07_22_to_16_06_23.csv,BTC_USD,HOUR,170.65,0.016,25/08/2022 18:00:00,25/08/2022 23:00:00,25/08/2022 23:00:00,EXPIRED,LONG,21441.0,21566.0,22090.57,21224.48,2.01,2.94,1.02,10.14,2,3.2,1.74,0.075,0.25729199999999997,TAKER
06/12/2022 22:00:00,18/06/2023 21:39:57,DUMMY_Gemini_BTCUSD_1h_01_07_22_to_16_06_23.csv,BTC_USD,HOUR,172.39,0.02,07/12/2022 04:00:00,07/12/2022 05:00:00,07/12/2022 05:00:00,EXPIRED,SHORT,16981.0,17008.0,16462.76,17153.75,1.97,3.15,1.01,10.11,2,3.2,-0.79,0.075,0.25471499999999997,TAKER
09/07/2022 01:00:00,18/06/2023 21:39:57,DUMMY_Gemini_BTCUSD_1h_01_07_22_to_16_06_23.csv,BTC_USD,HOUR,171.6,0.014,09/07/2022 09:00:00,09/07/2022 08:00:00,09/07/2022 08:00:00,EXPIRED,LONG,21504.0,21708.0,22232.31,21261.23,1.754,3.28,1.14,9.97,2,3.1,2.63,0.075,0.22579199999999996,TAKER
11/08/2022 03:00:00,18/06/2023 21:39:57,DUMMY_Gemini_BTCUSD_1h_01_07_22_to_16_06_23.csv,BTC_USD,HOUR,174.23,0.008,11/08/2022 05:00:00,11/08/2022 10:00:00,11/08/2022 10:00:00,EXPIRED,LONG,24335.0,24493.0,25581.58,23919.47,1.117,4.87,1.74,9.83,2,3.1,1.12,0.075,0.14601,TAKER
24/04/2023 01:00:00,18/06/2023 21:39:57,DUMMY_Gemini_BTCUSD_1h_01_07_22_to_16_06_23.csv,BTC_USD,HOUR,175.35,0.004,24/04/2023 04:00:00,24/04/2023 08:00:00,24/04/2023 08:00:00,EXPIRED,LONG,27760.0,27184.0,30220.17,26939.94,0.633,8.14,3.04,9.76,2,3.1,-2.39,0.075,0.08327999999999999,TAKER
29/12/2022 21:00:00,18/06/2023 21:39:57,DUMMY_Gemini_BTCUSD_1h_01_07_22_to_16_06_23.csv,BTC_USD,HOUR,172.96,0.02,30/12/2022 02:00:00,30/12/2022 04:00:00,30/12/2022 04:00:00,EXPIRED,LONG,16584.0,16604.0,17099.95,16412.02,1.918,3.02,1.05,10.07,2,3.2,0.15,0.075,0.24876,TAKER
24/07/2022 03:00:00,18/06/2023 21:39:57,DUMMY_Gemini_BTCUSD_1h_01_07_22_to_16_06_23.csv,BTC_USD,HOUR,173.11,0.015,24/07/2022 09:00:00,24/07/2022 10:00:00,24/07/2022 10:00:00,EXPIRED,LONG,22336.0,22529.0,23046.39,22099.21,1.935,3.08,1.07,10.4,2,3.2,2.64,0.075,0.25127999999999995,TAKER
03/01/2023 12:00:00,18/06/2023 21:39:57,DUMMY_Gemini_BTCUSD_1h_01_07_22_to_16_06_23.csv,BTC_USD,HOUR,175.75,0.02,03/01/2023 16:00:00,03/01/2023 19:00:00,03/01/2023 19:00:00,EXPIRED,LONG,16707.0,16632.0,17243.1,16528.3,1.901,3.11,1.08,10.47,2,3.2,-1.75,0.075,0.25060499999999997,TAKER
09/10/2022 21:00:00,18/06/2023 21:39:57,DUMMY_Gemini_BTCUSD_1h_01_07_22_to_16_06_23.csv,BTC_USD,HOUR,174.0,0.017,10/10/2022 03:00:00,10/10/2022 04:00:00,10/10/2022 04:00:00,EXPIRED,LONG,19489.0,19475.0,20111.0,19281.67,1.904,3.09,1.08,10.33,2,3.1,-0.49,0.075,0.24848475000000003,TAKER
16/06/2023 14:00:00,18/06/2023 21:39:57,DUMMY_Gemini_BTCUSD_1h_01_07_22_to_16_06_23.csv,BTC_USD,HOUR,173.51,0.013,16/06/2023 16:00:00,16/06/2023 21:00:00,16/06/2023 18:00:00,TAKE_PROFIT_HIT,LONG,25585.0,26416.88,26416.88,25307.71,1.917,3.15,1.1,10.56,2,3.1,10.56,0.075,0.24945374999999995,TAKER
18/03/2023 17:00:00,18/06/2023 21:39:57,DUMMY_Gemini_BTCUSD_1h_01_07_22_to_16_06_23.csv,BTC_USD,HOUR,184.07,0.01,18/03/2023 23:00:00,19/03/2023 00:00:00,18/03/2023 22:00:00,STOP_LOSS_HIT,LONG,27392.0,27035.99,28460.05,27035.99,1.488,3.75,1.32,10.48,2,3.1,-3.77,0.075,0.20544,TAKER
27/11/2022 04:00:00,18/06/2023 21:39:57,DUMMY_Gemini_BTCUSD_1h_01_07_22_to_16_06_23.csv,BTC_USD,HOUR,180.3,0.011,27/11/2022 09:00:00,27/11/2022 11:00:00,27/11/2022 11:00:00,EXPIRED,LONG,16562.0,16531.0,17526.38,16240.54,1.01,5.5,1.98,10.47,2,3.1,-0.48,0.075,0.1366365,TAKER
20/08/2022 18:00:00,18/06/2023 21:39:57,DUMMY_Gemini_BTCUSD_1h_01_07_22_to_16_06_23.csv,BTC_USD,HOUR,179.82,0.01,21/08/2022 02:00:00,21/08/2022 01:00:00,21/08/2022 01:00:00,EXPIRED,LONG,21111.0,21266.0,22224.54,20739.82,1.174,5.01,1.79,10.98,2,3.1,1.39,0.075,0.1583325,TAKER
10/09/2022 08:00:00,18/06/2023 21:39:57,DUMMY_Gemini_BTCUSD_1h_01_07_22_to_16_06_23.csv,BTC_USD,HOUR,181.21,0.015,10/09/2022 15:00:00,10/09/2022 15:00:00,10/09/2022 15:00:00,EXPIRED,LONG,21341.0,21232.0,22060.65,21101.12,1.767,3.26,1.14,10.55,2,3.1,-1.88,0.075,0.24008624999999997,TAKER
08/12/2022 19:00:00,18/06/2023 21:39:57,DUMMY_Gemini_BTCUSD_1h_01_07_22_to_16_06_23.csv,BTC_USD,HOUR,179.33,0.008,08/12/2022 22:00:00,09/12/2022 02:00:00,09/12/2022 02:00:00,EXPIRED,LONG,17259.0,17217.0,18674.12,16787.29,0.77,7.58,2.81,11.22,2,3.1,-0.44,0.075,0.103554,TAKER
17/10/2022 17:00:00,18/06/2023 21:39:57,DUMMY_Gemini_BTCUSD_1h_01_07_22_to_16_06_23.csv,BTC_USD,HOUR,178.89,0.01,17/10/2022 22:00:00,18/10/2022 00:00:00,18/10/2022 00:00:00,EXPIRED,LONG,19525.0,19597.0,20594.1,19168.64,1.091,5.19,1.86,10.54,2,3.1,0.57,0.075,0.1464375,TAKER
12/09/2022 12:00:00,18/06/2023 21:39:57,DUMMY_Gemini_BTCUSD_1h_01_07_22_to_16_06_23.csv,BTC_USD,HOUR,179.46,0.014,12/09/2022 20:00:00,12/09/2022 19:00:00,12/09/2022 15:00:00,STOP_LOSS_HIT,LONG,22360.0,22111.51,23105.49,22111.51,1.744,3.23,1.12,10.2,2,3.1,-3.71,0.075,0.23478000000000002,TAKER
30/09/2022 03:00:00,18/06/2023 21:39:57,DUMMY_Gemini_BTCUSD_1h_01_07_22_to_16_06_23.csv,BTC_USD,HOUR,175.75,0.017,30/09/2022 09:00:00,30/09/2022 10:00:00,30/09/2022 10:00:00,EXPIRED,LONG,19400.0,19484.0,20034.91,19188.36,1.877,3.17,1.1,10.55,2,3.1,1.18,0.075,0.24735,TAKER
29/10/2022 04:00:00,18/06/2023 21:39:57,DUMMY_Gemini_BTCUSD_1h_01_07_22_to_16_06_23.csv,BTC_USD,HOUR,176.93,0.008,29/10/2022 06:00:00,29/10/2022 11:00:00,29/10/2022 11:00:00,EXPIRED,LONG,20682.0,20701.0,21990.4,20245.87,0.935,5.95,2.15,10.34,2,3.1,0.03,0.075,0.12409200000000001,TAKER
04/10/2022 02:00:00,18/06/2023 21:39:57,DUMMY_Gemini_BTCUSD_1h_01_07_22_to_16_06_23.csv,BTC_USD,HOUR,176.96,0.017,04/10/2022 10:00:00,04/10/2022 09:00:00,04/10/2022 09:00:00,EXPIRED,LONG,19549.0,19958.0,20162.09,19344.64,1.878,3.04,1.06,10.17,2,3.2,6.7,0.075,0.24924975,TAKER
29/12/2022 21:00:00,18/06/2023 21:39:57,DUMMY_Gemini_BTCUSD_1h_01_07_22_to_16_06_23.csv,BTC_USD,HOUR,183.66,0.021,30/12/2022 02:00:00,30/12/2022 04:00:00,30/12/2022 04:00:00,EXPIRED,LONG,16584.0,16604.0,17099.95,16412.02,1.896,3.02,1.05,10.57,2,3.2,0.16,0.075,0.26119800000000004,TAKER
13/01/2023 01:00:00,18/06/2023 21:39:57,DUMMY_Gemini_BTCUSD_1h_01_07_22_to_16_06_23.csv,BTC_USD,HOUR,183.82,0.012,13/01/2023 07:00:00,13/01/2023 08:00:00,13/01/2023 08:00:00,EXPIRED,LONG,18813.0,18840.0,19754.75,18499.08,1.228,4.77,1.7,11.13,2,3.1,0.15,0.075,0.169317,TAKER
30/11/2022 07:00:00,18/06/2023 21:39:57,DUMMY_Gemini_BTCUSD_1h_01_07_22_to_16_06_23.csv,BTC_USD,HOUR,183.97,0.01,30/11/2022 11:00:00,30/11/2022 14:00:00,30/11/2022 14:00:00,EXPIRED,LONG,16887.0,16855.0,17974.23,16524.59,0.918,6.05,2.19,10.75,2,3.1,-0.45,0.075,0.1266525,TAKER
11/02/2023 14:00:00,18/06/2023 21:39:57,DUMMY_Gemini_BTCUSD_1h_01_07_22_to_16_06_23.csv,BTC_USD,HOUR,183.52,0.005,11/02/2023 17:00:00,11/02/2023 21:00:00,11/02/2023 21:00:00,EXPIRED,LONG,21762.0,21829.0,24034.38,21004.54,0.593,9.45,3.61,11.28,2,3.0,0.25,0.075,0.0816075,TAKER
18/11/2022 06:00:00,18/06/2023 21:39:57,DUMMY_Gemini_BTCUSD_1h_01_07_22_to_16_06_23.csv,BTC_USD,HOUR,183.77,0.011,18/11/2022 14:00:00,18/11/2022 13:00:00,18/11/2022 13:00:00,EXPIRED,SHORT,16755.0,16745.0,15782.74,17079.09,1.003,6.16,1.9,10.56,2,3.1,-0.03,0.075,0.13822874999999998,TAKER
12/12/2022 21:00:00,18/06/2023 21:39:57,DUMMY_Gemini_BTCUSD_1h_01_07_22_to_16_06_23.csv,BTC_USD,HOUR,183.74,0.012,13/12/2022 00:00:00,13/12/2022 04:00:00,13/12/2022 04:00:00,EXPIRED,LONG,17168.0,17171.0,18062.76,16869.75,1.121,4.95,1.77,10.58,2,3.1,-0.12,0.075,0.15451199999999998,TAKER
20/05/2023 13:00:00,18/06/2023 21:39:57,DUMMY_Gemini_BTCUSD_1h_01_07_22_to_16_06_23.csv,BTC_USD,HOUR,183.62,0.008,20/05/2023 18:00:00,20/05/2023 20:00:00,20/05/2023 20:00:00,EXPIRED,LONG,26902.0,27021.0,28323.69,26428.1,1.172,5.02,1.79,11.21,2,3.1,0.79,0.075,0.161412,TAKER
08/04/2023 10:00:00,18/06/2023 21:39:57,DUMMY_Gemini_BTCUSD_1h_01_07_22_to_16_06_23.csv,BTC_USD,HOUR,184.41,0.013,08/04/2023 15:00:00,08/04/2023 17:00:00,08/04/2023 17:00:00,EXPIRED,LONG,28031.0,27950.0,28882.3,27747.24,1.976,2.95,1.02,10.79,2,3.2,-1.33,0.075,0.27330224999999997,TAKER
12/02/2023 04:00:00,18/06/2023 21:39:57,DUMMY_Gemini_BTCUSD_1h_01_07_22_to_16_06_23.csv,BTC_USD,HOUR,183.08,0.013,12/02/2023 08:00:00,12/02/2023 11:00:00,12/02/2023 11:00:00,EXPIRED,LONG,21781.0,21902.0,22620.82,21501.06,1.547,3.71,1.3,10.71,2,3.1,1.36,0.075,0.21236474999999996,TAKER
17/03/2023 09:00:00,18/06/2023 21:39:57,DUMMY_Gemini_BTCUSD_1h_01_07_22_to_16_06_23.csv,BTC_USD,HOUR,184.44,0.013,17/03/2023 14:00:00,17/03/2023 16:00:00,17/03/2023 16:00:00,EXPIRED,LONG,26324.0,26466.0,27205.66,26030.11,1.855,3.24,1.13,11.2,2,3.1,1.59,0.075,0.25665899999999997,TAKER
07/02/2023 19:00:00,18/06/2023 21:39:57,DUMMY_Gemini_BTCUSD_1h_01_07_22_to_16_06_23.csv,BTC_USD,HOUR,186.03,0.015,07/02/2023 21:00:00,08/02/2023 02:00:00,08/02/2023 02:00:00,EXPIRED,LONG,23101.0,23245.0,23846.65,22852.45,1.863,3.13,1.09,10.92,2,3.1,1.9,0.075,0.25988625,TAKER
26/10/2022 11:00:00,18/06/2023 21:39:57,DUMMY_Gemini_BTCUSD_1h_01_07_22_to_16_06_23.csv,BTC_USD,HOUR,187.93,0.016,26/10/2022 13:00:00,26/10/2022 18:00:00,26/10/2022 13:00:00,STOP_LOSS_HIT,LONG,20617.0,20387.79,21304.64,20387.79,1.755,3.23,1.12,10.75,2,3.1,-3.91,0.075,0.247404,TAKER
29/03/2023 03:00:00,18/06/2023 21:39:57,DUMMY_Gemini_BTCUSD_1h_01_07_22_to_16_06_23.csv,BTC_USD,HOUR,184.02,0.011,29/03/2023 05:00:00,29/03/2023 10:00:00,29/03/2023 08:00:00,TAKE_PROFIT_HIT,LONG,27387.0,28354.29,28354.29,27064.57,1.637,3.41,1.19,10.41,2,3.1,10.41,0.075,0.22594275,TAKER
06/01/2023 17:00:00,18/06/2023 21:39:57,DUMMY_Gemini_BTCUSD_1h_01_07_22_to_16_06_23.csv,BTC_USD,HOUR,194.43,0.021,06/01/2023 18:00:00,07/01/2023 00:00:00,07/01/2023 00:00:00,EXPIRED,LONG,16810.0,16979.0,17368.24,16623.92,1.816,3.21,1.12,11.46,2,3.1,3.28,0.075,0.26475750000000003,TAKER
10/08/2022 18:00:00,18/06/2023 21:39:57,DUMMY_Gemini_BTCUSD_1h_01_07_22_to_16_06_23.csv,BTC_USD,HOUR,197.71,0.009,11/08/2022 02:00:00,11/08/2022 01:00:00,10/08/2022 21:00:00,STOP_LOSS_HIT,SHORT,23610.0,24057.73,22266.81,24057.73,1.075,6.03,1.86,11.93,2,3.1,-4.19,0.075,0.1593675,TAKER
22/07/2022 08:00:00,18/06/2023 21:39:57,DUMMY_Gemini_BTCUSD_1h_01_07_22_to_16_06_23.csv,BTC_USD,HOUR,193.52,0.014,22/07/2022 10:00:00,22/07/2022 15:00:00,22/07/2022 15:00:00,EXPIRED,LONG,23295.0,23287.0,24099.57,23026.81,1.685,3.34,1.16,11.02,2,3.1,-0.36,0.075,0.2445975,TAKER
02/09/2022 15:00:00,18/06/2023 21:39:57,DUMMY_Gemini_BTCUSD_1h_01_07_22_to_16_06_23.csv,BTC_USD,HOUR,193.16,0.007,02/09/2022 20:00:00,02/09/2022 22:00:00,02/09/2022 17:00:00,STOP_LOSS_HIT,LONG,20364.0,19811.48,22021.56,19811.48,0.738,7.53,2.79,11.5,2,3.1,-3.97,0.075,0.106911,TAKER
18/03/2023 00:00:00,18/06/2023 21:39:57,DUMMY_Gemini_BTCUSD_1h_01_07_22_to_16_06_23.csv,BTC_USD,HOUR,189.19,0.007,18/03/2023 01:00:00,18/03/2023 07:00:00,18/03/2023 07:00:00,EXPIRED,LONG,27697.0,27415.0,29395.36,27130.88,1.025,5.78,2.09,11.74,2,3.1,-2.12,0.075,0.14540925,TAKER
20/03/2023 10:00:00,18/06/2023 21:39:57,DUMMY_Gemini_BTCUSD_1h_01_07_22_to_16_06_23.csv,BTC_USD,HOUR,187.07,0.009,20/03/2023 12:00:00,20/03/2023 17:00:00,20/03/2023 15:00:00,STOP_LOSS_HIT,LONG,28189.0,27749.25,29508.25,27749.25,1.356,4.47,1.58,11.68,2,3.1,-4.15,0.075,0.19027575,TAKER
14/01/2023 23:00:00,18/06/2023 21:39:57,DUMMY_Gemini_BTCUSD_1h_01_07_22_to_16_06_23.csv,BTC_USD,HOUR,182.92,0.016,15/01/2023 05:00:00,15/01/2023 06:00:00,15/01/2023 00:00:00,STOP_LOSS_HIT,LONG,20962.0,20727.74,21664.8,20727.74,1.834,3.24,1.13,10.99,2,3.1,-4.0,0.075,0.251544,TAKER
02/11/2022 19:00:00,18/06/2023 21:39:57,DUMMY_Gemini_BTCUSD_1h_01_07_22_to_16_06_23.csv,BTC_USD,HOUR,178.92,0.015,03/11/2022 00:00:00,03/11/2022 02:00:00,03/11/2022 02:00:00,EXPIRED,LONG,20254.0,20285.0,20973.14,20014.29,1.698,3.43,1.2,10.56,2,3.1,0.24,0.075,0.2278575,TAKER
23/05/2023 08:00:00,18/06/2023 21:39:57,DUMMY_Gemini_BTCUSD_1h_01_07_22_to_16_06_23.csv,BTC_USD,HOUR,179.16,0.011,23/05/2023 12:00:00,23/05/2023 15:00:00,23/05/2023 15:00:00,EXPIRED,LONG,27327.0,27319.0,28321.68,26995.44,1.678,3.51,1.23,10.72,2,3.1,-0.31,0.075,0.22544774999999997,TAKER
15/10/2022 18:00:00,18/06/2023 21:39:57,DUMMY_Gemini_BTCUSD_1h_01_07_22_to_16_06_23.csv,BTC_USD,HOUR,178.85,0.009,15/10/2022 20:00:00,16/10/2022 01:00:00,16/10/2022 01:00:00,EXPIRED,LONG,19126.0,19145.0,20382.94,18707.02,0.962,6.17,2.24,11.18,2,3.1,0.04,0.075,0.12910049999999998,TAKER
06/06/2023 19:00:00,18/06/2023 21:39:57,DUMMY_Gemini_BTCUSD_1h_01_07_22_to_16_06_23.csv,BTC_USD,HOUR,178.89,0.013,07/06/2023 00:00:00,07/06/2023 02:00:00,07/06/2023 02:00:00,EXPIRED,LONG,27091.0,26937.0,27914.36,26816.55,1.969,2.95,1.02,10.44,2,3.2,-2.27,0.075,0.26413725,TAKER
31/10/2022 11:00:00,18/06/2023 21:39:57,DUMMY_Gemini_BTCUSD_1h_01_07_22_to_16_06_23.csv,BTC_USD,HOUR,176.62,0.008,31/10/2022 14:00:00,31/10/2022 18:00:00,31/10/2022 14:00:00,STOP_LOSS_HIT,LONG,20736.0,20277.33,22112.01,20277.33,0.939,6.22,2.26,10.88,2,3.1,-3.79,0.075,0.124416,TAKER
03/09/2022 06:00:00,18/06/2023 21:39:57,DUMMY_Gemini_BTCUSD_1h_01_07_22_to_16_06_23.csv,BTC_USD,HOUR,172.83,0.01,03/09/2022 13:00:00,03/09/2022 13:00:00,03/09/2022 13:00:00,EXPIRED,LONG,19894.0,19872.0,20926.06,19549.98,1.151,4.93,1.76,10.17,2,3.1,-0.37,0.075,0.14920499999999998,TAKER
25/11/2022 00:00:00,18/06/2023 21:39:57,DUMMY_Gemini_BTCUSD_1h_01_07_22_to_16_06_23.csv,BTC_USD,HOUR,172.46,0.018,25/11/2022 02:00:00,25/11/2022 07:00:00,25/11/2022 06:00:00,STOP_LOSS_HIT,LONG,16535.0,16344.64,17106.09,16344.64,1.726,3.34,1.16,10.06,2,3.1,-3.65,0.075,0.2232225,TAKER
03/08/2022 10:00:00,18/06/2023 21:39:57,DUMMY_Gemini_BTCUSD_1h_01_07_22_to_16_06_23.csv,BTC_USD,HOUR,168.81,0.008,03/08/2022 16:00:00,03/08/2022 17:00:00,03/08/2022 17:00:00,EXPIRED,LONG,23415.0,23454.0,24687.35,22990.88,1.11,5.15,1.84,10.04,2,3.1,0.17,0.075,0.14049,TAKER
08/09/2022 04:00:00,18/06/2023 21:39:57,DUMMY_Gemini_BTCUSD_1h_01_07_22_to_16_06_23.csv,BTC_USD,HOUR,168.98,0.016,08/09/2022 10:00:00,08/09/2022 11:00:00,08/09/2022 11:00:00,EXPIRED,SHORT,19357.0,19311.0,18711.07,19572.31,1.833,3.45,1.1,10.1,2,3.1,0.5,0.075,0.23228399999999996,TAKER
07/03/2023 16:00:00,18/06/2023 21:39:57,DUMMY_Gemini_BTCUSD_1h_01_07_22_to_16_06_23.csv,BTC_USD,HOUR,169.48,0.01,07/03/2023 22:00:00,07/03/2023 23:00:00,07/03/2023 23:00:00,EXPIRED,LONG,22236.0,22212.0,23213.16,21910.28,1.312,4.21,1.49,9.6,2,3.1,-0.41,0.075,0.16677,TAKER
31/07/2022 11:00:00,18/06/2023 21:39:57,DUMMY_Gemini_BTCUSD_1h_01_07_22_to_16_06_23.csv,BTC_USD,HOUR,169.07,0.011,31/07/2022 17:00:00,31/07/2022 18:00:00,31/07/2022 18:00:00,STOP_LOSS_HIT,LONG,23807.0,23510.6,24696.22,23510.6,1.549,3.6,1.26,9.59,2,3.1,-3.46,0.075,0.19640775000000002,TAKER
12/10/2022 06:00:00,18/06/2023 21:39:57,DUMMY_Gemini_BTCUSD_1h_01_07_22_to_16_06_23.csv,BTC_USD,HOUR,165.61,0.01,12/10/2022 14:00:00,12/10/2022 13:00:00,12/10/2022 13:00:00,EXPIRED,LONG,19153.0,19133.0,20152.28,18819.91,1.157,4.96,1.77,9.85,2,3.1,-0.34,0.075,0.14364749999999998,TAKER
14/03/2023 12:00:00,18/06/2023 21:39:57,DUMMY_Gemini_BTCUSD_1h_01_07_22_to_16_06_23.csv,BTC_USD,HOUR,165.27,0.006,14/03/2023 15:00:00,14/03/2023 19:00:00,14/03/2023 18:00:00,STOP_LOSS_HIT,LONG,25972.0,25425.55,27611.35,25425.55,0.943,5.94,2.15,9.72,2,3.1,-3.4,0.075,0.11687399999999998,TAKER
05/12/2022 02:00:00,18/06/2023 21:39:57,DUMMY_Gemini_BTCUSD_1h_01_07_22_to_16_06_23.csv,BTC_USD,HOUR,161.87,0.007,05/12/2022 04:00:00,05/12/2022 09:00:00,05/12/2022 09:00:00,EXPIRED,LONG,17252.0,17311.0,18572.13,16811.96,0.746,7.11,2.62,9.15,2,3.1,0.32,0.075,0.090573,TAKER
02/01/2023 15:00:00,18/06/2023 21:39:57,DUMMY_Gemini_BTCUSD_1h_01_07_22_to_16_06_23.csv,BTC_USD,HOUR,162.19,0.016,02/01/2023 22:00:00,02/01/2023 22:00:00,02/01/2023 22:00:00,EXPIRED,SHORT,16725.0,16691.0,16128.69,16923.77,1.65,3.7,1.17,9.34,2,3.1,0.34,0.075,0.2007,TAKER
06/09/2022 00:00:00,18/06/2023 21:39:57,DUMMY_Gemini_BTCUSD_1h_01_07_22_to_16_06_23.csv,BTC_USD,HOUR,162.53,0.016,06/09/2022 02:00:00,06/09/2022 07:00:00,06/09/2022 01:00:00,STOP_LOSS_HIT,LONG,20100.0,19897.02,20708.94,19897.02,1.979,2.94,1.02,9.5,2,3.2,-3.49,0.075,0.2412,TAKER
13/10/2022 23:00:00,18/06/2023 21:39:57,DUMMY_Gemini_BTCUSD_1h_01_07_22_to_16_06_23.csv,BTC_USD,HOUR,159.04,0.015,14/10/2022 02:00:00,14/10/2022 06:00:00,14/10/2022 06:00:00,EXPIRED,LONG,19383.0,19797.0,20026.99,19168.34,1.828,3.22,1.12,9.44,2,3.1,5.99,0.075,0.21805875,TAKER
26/05/2023 18:00:00,18/06/2023 21:39:57,DUMMY_Gemini_BTCUSD_1h_01_07_22_to_16_06_23.csv,BTC_USD,HOUR,165.03,0.012,27/05/2023 02:00:00,27/05/2023 01:00:00,27/05/2023 01:00:00,EXPIRED,SHORT,26735.0,26710.0,25892.3,27015.9,1.944,3.25,1.04,9.87,2,3.2,0.06,0.075,0.240615,TAKER
27/04/2023 20:00:00,18/06/2023 21:39:57,DUMMY_Gemini_BTCUSD_1h_01_07_22_to_16_06_23.csv,BTC_USD,HOUR,165.09,0.005,27/04/2023 22:00:00,28/04/2023 03:00:00,28/04/2023 03:00:00,EXPIRED,LONG,29630.0,29409.0,31495.92,29008.03,0.897,5.92,2.14,9.22,2,3.1,-1.22,0.075,0.1111125,TAKER
17/10/2022 16:00:00,18/06/2023 21:39:57,DUMMY_Gemini_BTCUSD_1h_01_07_22_to_16_06_23.csv,BTC_USD,HOUR,163.87,0.014,17/10/2022 22:00:00,17/10/2022 23:00:00,17/10/2022 23:00:00,EXPIRED,LONG,19516.0,19554.0,20197.54,19288.82,1.667,3.37,1.18,9.34,2,3.1,0.33,0.075,0.204918,TAKER
09/09/2022 01:00:00,18/06/2023 21:39:57,DUMMY_Gemini_BTCUSD_1h_01_07_22_to_16_06_23.csv,BTC_USD,HOUR,164.2,0.016,09/09/2022 08:00:00,09/09/2022 08:00:00,09/09/2022 04:00:00,TAKE_PROFIT_HIT,LONG,19345.0,19959.82,19959.82,19140.06,1.885,3.08,1.07,9.6,2,3.1,9.6,0.075,0.23213999999999999,TAKER
08/06/2023 23:00:00,18/06/2023 21:39:57,DUMMY_Gemini_BTCUSD_1h_01_07_22_to_16_06_23.csv,BTC_USD,HOUR,173.8,0.007,09/06/2023 01:00:00,09/06/2023 06:00:00,09/06/2023 06:00:00,EXPIRED,LONG,26513.0,26500.0,28089.86,25987.38,1.068,5.61,2.02,10.9,2,3.1,-0.23,0.075,0.13919325000000002,TAKER
17/03/2023 14:00:00,18/06/2023 21:39:57,DUMMY_Gemini_BTCUSD_1h_01_07_22_to_16_06_23.csv,BTC_USD,HOUR,173.57,0.007,17/03/2023 20:00:00,17/03/2023 21:00:00,17/03/2023 21:00:00,EXPIRED,LONG,26355.0,27212.0,27771.31,25882.9,1.063,5.1,1.82,9.78,2,3.1,5.86,0.075,0.13836375,TAKER
25/11/2022 13:00:00,18/06/2023 21:39:57,DUMMY_Gemini_BTCUSD_1h_01_07_22_to_16_06_23.csv,BTC_USD,HOUR,179.43,0.022,25/11/2022 15:00:00,25/11/2022 20:00:00,25/11/2022 20:00:00,EXPIRED,LONG,16486.0,16521.0,16985.91,16319.36,2.021,2.94,1.02,10.73,2,3.2,0.5,0.075,0.272019,TAKER
02/08/2022 18:00:00,18/06/2023 21:39:57,DUMMY_Gemini_BTCUSD_1h_01_07_22_to_16_06_23.csv,BTC_USD,HOUR,179.93,0.005,02/08/2022 20:00:00,03/08/2022 01:00:00,03/08/2022 01:00:00,EXPIRED,LONG,22969.0,22810.0,25300.29,22191.9,0.638,9.21,3.5,11.57,2,3.0,-0.88,0.075,0.08613375,TAKER
01/11/2022 04:00:00,18/06/2023 21:39:57,DUMMY_Gemini_BTCUSD_1h_01_07_22_to_16_06_23.csv,BTC_USD,HOUR,179.05,0.011,01/11/2022 08:00:00,01/11/2022 11:00:00,01/11/2022 11:00:00,EXPIRED,LONG,20498.0,20526.0,21483.43,20169.52,1.259,4.59,1.63,10.67,2,3.1,0.14,0.075,0.16910849999999997,TAKER
30/04/2023 15:00:00,18/06/2023 21:39:57,DUMMY_Gemini_BTCUSD_1h_01_07_22_to_16_06_23.csv,BTC_USD,HOUR,179.19,0.004,30/04/2023 18:00:00,30/04/2023 22:00:00,30/04/2023 22:00:00,EXPIRED,LONG,29688.0,29396.0,32153.7,28866.1,0.663,7.67,2.85,9.77,2,3.1,-1.26,0.075,0.08906399999999999,TAKER
06/04/2023 17:00:00,18/06/2023 21:39:57,DUMMY_Gemini_BTCUSD_1h_01_07_22_to_16_06_23.csv,BTC_USD,HOUR,177.93,0.012,06/04/2023 18:00:00,07/04/2023 00:00:00,07/04/2023 00:00:00,EXPIRED,LONG,28055.0,28113.0,28946.71,27757.77,1.892,3.08,1.07,10.45,2,3.2,0.44,0.075,0.252495,TAKER
29/12/2022 13:00:00,18/06/2023 21:39:57,DUMMY_Gemini_BTCUSD_1h_01_07_22_to_16_06_23.csv,BTC_USD,HOUR,178.37,0.013,29/12/2022 16:00:00,29/12/2022 20:00:00,29/12/2022 20:00:00,EXPIRED,LONG,16616.0,16596.0,17463.78,16333.41,1.211,4.85,1.73,10.86,2,3.1,-0.42,0.075,0.16200599999999998,TAKER
01/06/2023 18:00:00,18/06/2023 21:39:57,DUMMY_Gemini_BTCUSD_1h_01_07_22_to_16_06_23.csv,BTC_USD,HOUR,177.95,0.005,01/06/2023 20:00:00,02/06/2023 01:00:00,02/06/2023 01:00:00,EXPIRED,LONG,26965.0,26813.0,29167.58,26230.81,0.758,7.55,2.8,10.91,2,3.1,-0.86,0.075,0.10111875,TAKER
07/07/2022 19:00:00,18/06/2023 21:39:57,DUMMY_Gemini_BTCUSD_1h_01_07_22_to_16_06_23.csv,BTC_USD,HOUR,177.09,0.007,07/07/2022 22:00:00,08/07/2022 02:00:00,08/07/2022 02:00:00,EXPIRED,LONG,21823.0,21967.0,23272.18,21339.94,0.863,6.23,2.26,10.03,2,3.1,0.89,0.075,0.11457075,TAKER
09/09/2022 12:00:00,18/06/2023 21:39:57,DUMMY_Gemini_BTCUSD_1h_01_07_22_to_16_06_23.csv,BTC_USD,HOUR,177.98,0.015,09/09/2022 15:00:00,09/09/2022 19:00:00,09/09/2022 19:00:00,EXPIRED,LONG,21082.0,21283.0,21816.42,20837.2,1.777,3.37,1.17,10.78,2,3.1,2.78,0.075,0.23717249999999995,TAKER
11/04/2023 12:00:00,18/06/2023 21:39:57,DUMMY_Gemini_BTCUSD_1h_01_07_22_to_16_06_23.csv,BTC_USD,HOUR,180.76,0.005,11/04/2023 14:00:00,11/04/2023 19:00:00,11/04/2023 19:00:00,EXPIRED,LONG,30123.0,30168.0,32270.62,29407.13,0.833,6.66,2.43,10.63,2,3.1,0.11,0.075,0.11296125,TAKER
04/03/2023 03:00:00,18/06/2023 21:39:57,DUMMY_Gemini_BTCUSD_1h_01_07_22_to_16_06_23.csv,BTC_USD,HOUR,180.87,0.015,04/03/2023 06:00:00,04/03/2023 10:00:00,04/03/2023 10:00:00,EXPIRED,LONG,22349.0,22342.0,23069.33,22108.89,1.853,3.12,1.09,10.55,2,3.1,-0.36,0.075,0.25142624999999996,TAKER
11/02/2023 12:00:00,18/06/2023 21:39:57,DUMMY_Gemini_BTCUSD_1h_01_07_22_to_16_06_23.csv,BTC_USD,HOUR,180.51,0.01,11/02/2023 19:00:00,11/02/2023 19:00:00,11/02/2023 19:00:00,EXPIRED,LONG,21722.0,21658.0,22805.82,21360.73,1.203,4.75,1.69,10.68,2,3.1,-0.8,0.075,0.162915,TAKER
21/07/2022 19:00:00,18/06/2023 21:39:57,DUMMY_Gemini_BTCUSD_1h_01_07_22_to_16_06_23.csv,BTC_USD,HOUR,179.71,0.014,22/07/2022 02:00:00,22/07/2022 02:00:00,21/07/2022 22:00:00,STOP_LOSS_HIT,LONG,23209.0,22952.17,23979.51,22952.17,1.808,3.21,1.12,10.54,2,3.1,-3.84,0.075,0.24369449999999998,TAKER
25/08/2022 16:00:00,18/06/2023 21:39:57,DUMMY_Gemini_BTCUSD_1h_01_07_22_to_16_06_23.csv,BTC_USD,HOUR,175.87,0.016,25/08/2022 18:00:00,25/08/2022 23:00:00,25/08/2022 23:00:00,EXPIRED,LONG,21441.0,21566.0,22090.57,21224.48,1.951,2.94,1.02,10.14,2,3.2,1.74,0.075,0.25729199999999997,TAKER
27/05/2023 09:00:00,18/06/2023 21:39:57,DUMMY_Gemini_BTCUSD_1h_01_07_22_to_16_06_23.csv,BTC_USD,HOUR,177.61,0.012,27/05/2023 17:00:00,27/05/2023 16:00:00,27/05/2023 16:00:00,EXPIRED,LONG,26711.0,26671.0,27591.01,26417.67,1.805,3.19,1.11,10.32,2,3.1,-0.72,0.075,0.240399,TAKER
02/09/2022 00:00:00,18/06/2023 21:39:57,DUMMY_Gemini_BTCUSD_1h_01_07_22_to_16_06_23.csv,BTC_USD,HOUR,176.89,0.017,02/09/2022 08:00:00,02/09/2022 07:00:00,02/09/2022 07:00:00,EXPIRED,SHORT,20085.0,20112.0,19452.05,20295.98,1.93,3.25,1.04,10.5,2,3.2,-0.72,0.075,0.25608375,TAKER
02/02/2023 20:00:00,18/06/2023 21:39:57,DUMMY_Gemini_BTCUSD_1h_01_07_22_to_16_06_23.csv,BTC_USD,HOUR,176.17,0.014,02/02/2023 21:00:00,03/02/2023 03:00:00,02/02/2023 21:00:00,STOP_LOSS_HIT,LONG,23887.0,23634.08,24645.76,23634.08,1.898,3.08,1.07,10.37,2,3.2,-3.79,0.075,0.2508135,TAKER
02/11/2022 17:00:00,18/06/2023 21:39:57,DUMMY_Gemini_BTCUSD_1h_01_07_22_to_16_06_23.csv,BTC_USD,HOUR,172.38,0.007,02/11/2022 20:00:00,03/11/2022 00:00:00,03/11/2022 00:00:00,EXPIRED,LONG,20412.0,20200.0,21807.1,19946.97,0.829,6.4,2.33,9.66,2,3.1,-1.59,0.075,0.10716300000000001,TAKER
21/01/2023 00:00:00,18/06/2023 21:39:57,DUMMY_Gemini_BTCUSD_1h_01_07_22_to_16_06_23.csv,BTC_USD,HOUR,170.79,0.014,21/01/2023 03:00:00,21/01/2023 07:00:00,21/01/2023 07:00:00,EXPIRED,SHORT,22591.0,22653.0,21879.08,22828.31,1.852,3.25,1.04,9.73,2,3.1,-1.11,0.075,0.23720549999999999,TAKER
16/10/2022 21:00:00,18/06/2023 21:39:57,DUMMY_Gemini_BTCUSD_1h_01_07_22_to_16_06_23.csv,BTC_USD,HOUR,169.68,0.018,16/10/2022 23:00:00,17/10/2022 04:00:00,17/10/2022 04:00:00,EXPIRED,LONG,19151.0,19233.0,19729.01,18958.33,2.032,2.93,1.02,10.15,2,3.2,1.22,0.075,0.2585385,TAKER
05/08/2022 06:00:00,18/06/2023 21:39:57,DUMMY_Gemini_BTCUSD_1h_01_07_22_to_16_06_23.csv,BTC_USD,HOUR,170.9,0.008,05/08/2022 12:00:00,05/08/2022 13:00:00,05/08/2022 13:00:00,EXPIRED,LONG,23282.0,23052.0,24590.37,22845.88,1.09,5.32,1.91,10.33,2,3.1,-1.98,0.075,0.13969199999999998,TAKER
09/01/2023 18:00:00,18/06/2023 21:39:57,DUMMY_Gemini_BTCUSD_1h_01_07_22_to_16_06_23.csv,BTC_USD,HOUR,168.92,0.009,09/01/2023 21:00:00,10/01/2023 01:00:00,10/01/2023 01:00:00,EXPIRED,LONG,17342.0,17200.0,18487.33,16960.22,0.924,6.2,2.25,10.19,2,3.1,-1.4,0.075,0.11705849999999998,TAKER
10/03/2023 17:00:00,18/06/2023 21:39:57,DUMMY_Gemini_BTCUSD_1h_01_07_22_to_16_06_23.csv,BTC_USD,HOUR,167.52,0.014,10/03/2023 22:00:00,11/03/2023 00:00:00,11/03/2023 00:00:00,EXPIRED,LONG,19911.0,20323.0,20646.12,19665.96,1.664,3.56,1.25,10.08,2,3.1,5.56,0.075,0.2090655,TAKER
14/03/2023 02:00:00,18/06/2023 21:39:57,DUMMY_Gemini_BTCUSD_1h_01_07_22_to_16_06_23.csv,BTC_USD,HOUR,173.08,0.01,14/03/2023 09:00:00,14/03/2023 09:00:00,14/03/2023 09:00:00,EXPIRED,LONG,24399.0,24390.0,25428.96,24055.68,1.41,4.05,1.43,10.12,2,3.1,-0.27,0.075,0.1829925,TAKER
04/06/2023 22:00:00,18/06/2023 21:39:57,DUMMY_Gemini_BTCUSD_1h_01_07_22_to_16_06_23.csv,BTC_USD,HOUR,172.81,0.007,05/06/2023 01:00:00,05/06/2023 05:00:00,05/06/2023 05:00:00,EXPIRED,LONG,27229.0,26817.0,28696.27,26739.91,1.103,5.11,1.83,10.13,2,3.1,-3.03,0.075,0.14295225,TAKER
30/10/2022 08:00:00,18/06/2023 21:39:57,DUMMY_Gemini_BTCUSD_1h_01_07_22_to_16_06_23.csv,BTC_USD,HOUR,169.78,0.011,30/10/2022 09:00:00,30/10/2022 15:00:00,30/10/2022 15:00:00,EXPIRED,LONG,20780.0,20689.0,21734.07,20461.98,1.346,4.39,1.55,10.32,2,3.1,-1.17,0.075,0.171435,TAKER
11/06/2023 23:00:00,18/06/2023 21:39:57,DUMMY_Gemini_BTCUSD_1h_01_07_22_to_16_06_23.csv,BTC_USD,HOUR,168.61,0.012,12/06/2023 04:00:00,12/06/2023 06:00:00,12/06/2023 02:00:00,STOP_LOSS_HIT,LONG,25937.0,25652.55,26790.35,25652.55,1.846,3.19,1.11,10.01,2,3.1,-3.65,0.075,0.23343300000000003,TAKER
23/03/2023 11:00:00,18/06/2023 21:39:57,DUMMY_Gemini_BTCUSD_1h_01_07_22_to_16_06_23.csv,BTC_USD,HOUR,164.96,0.006,23/03/2023 19:00:00,23/03/2023 18:00:00,23/03/2023 15:00:00,STOP_LOSS_HIT,SHORT,27671.0,28185.16,26128.52,28185.16,1.006,5.9,1.82,9.13,2,3.1,-3.21,0.075,0.1245195,TAKER
23/12/2022 05:00:00,18/06/2023 21:39:57,DUMMY_Gemini_BTCUSD_1h_01_07_22_to_16_06_23.csv,BTC_USD,HOUR,161.75,0.011,23/12/2022 07:00:00,23/12/2022 12:00:00,23/12/2022 12:00:00,EXPIRED,LONG,16824.0,16873.0,17692.95,16534.35,1.144,4.91,1.75,9.42,2,3.1,0.4,0.075,0.138798,TAKER
26/11/2022 03:00:00,18/06/2023 21:39:57,DUMMY_Gemini_BTCUSD_1h_01_07_22_to_16_06_23.csv,BTC_USD,HOUR,162.15,0.012,26/11/2022 04:00:00,26/11/2022 10:00:00,26/11/2022 10:00:00,EXPIRED,LONG,16613.0,16591.0,17430.75,16340.42,1.229,4.69,1.67,9.66,2,3.1,-0.41,0.075,0.14951699999999998,TAKER
11/09/2022 16:00:00,18/06/2023 21:39:57,DUMMY_Gemini_BTCUSD_1h_01_07_22_to_16_06_23.csv,BTC_USD,HOUR,161.74,0.011,11/09/2022 18:00:00,11/09/2022 23:00:00,11/09/2022 23:00:00,EXPIRED,LONG,21684.0,21845.0,22561.7,21391.44,1.475,3.89,1.37,9.48,2,3.1,1.59,0.075,0.178893,TAKER
12/10/2022 08:00:00,18/06/2023 21:39:57,DUMMY_Gemini_BTCUSD_1h_01_07_22_to_16_06_23.csv,BTC_USD,HOUR,163.33,0.007,12/10/2022 15:00:00,12/10/2022 15:00:00,12/10/2022 15:00:00,EXPIRED,LONG,19140.0,19142.0,20514.59,18681.8,0.82,6.7,2.45,9.52,2,3.1,-0.09,0.075,0.10048499999999999,TAKER
25/08/2022 22:00:00,18/06/2023 21:39:57,DUMMY_Gemini_BTCUSD_1h_01_07_22_to_16_06_23.csv,BTC_USD,HOUR,163.24,0.013,26/08/2022 01:00:00,26/08/2022 05:00:00,26/08/2022 05:00:00,EXPIRED,LONG,21585.0,21409.0,22346.59,21331.14,1.719,3.41,1.19,9.69,2,3.1,-2.5,0.075,0.21045374999999997,TAKER
08/09/2022 13:00:00,18/06/2023 21:39:57,DUMMY_Gemini_BTCUSD_1h_01_07_22_to_16_06_23.csv,BTC_USD,HOUR,160.74,0.01,08/09/2022 18:00:00,08/09/2022 20:00:00,08/09/2022 20:00:00,EXPIRED,LONG,19226.0,19382.0,20176.61,18909.13,1.196,4.71,1.68,9.36,2,3.1,1.42,0.075,0.144195,TAKER
22/10/2022 19:00:00,18/06/2023 21:39:57,DUMMY_Gemini_BTCUSD_1h_01_07_22_to_16_06_23.csv,BTC_USD,HOUR,162.16,0.017,22/10/2022 23:00:00,23/10/2022 02:00:00,23/10/2022 02:00:00,EXPIRED,LONG,19185.0,19200.0,19765.21,18991.6,2.011,2.94,1.02,9.62,2,3.2,0.01,0.075,0.24460875,TAKER
14/05/2023 14:00:00,18/06/2023 21:39:57,DUMMY_Gemini_BTCUSD_1h_01_07_22_to_16_06_23.csv,BTC_USD,HOUR,162.17,0.007,14/05/2023 17:00:00,14/05/2023 21:00:00,14/05/2023 21:00:00,EXPIRED,LONG,26969.0,26907.0,28374.57,26500.48,1.164,4.95,1.77,9.7,2,3.1,-0.58,0.075,0.14158725,TAKER
22/05/2023 07:00:00,18/06/2023 21:39:57,DUMMY_Gemini_BTCUSD_1h_01_07_22_to_16_06_23.csv,BTC_USD,HOUR,161.59,0.005,22/05/2023 10:00:00,22/05/2023 14:00:00,22/05/2023 14:00:00,EXPIRED,LONG,26846.0,26962.0,28833.11,26183.63,0.831,6.89,2.53,9.83,2,3.1,0.48,0.075,0.1006725,TAKER
12/01/2023 07:00:00,18/06/2023 21:39:57,DUMMY_Gemini_BTCUSD_1h_01_07_22_to_16_06_23.csv,BTC_USD,HOUR,162.07,0.017,12/01/2023 15:00:00,12/01/2023 14:00:00,12/01/2023 13:00:00,STOP_LOSS_HIT,LONG,18125.0,17930.7,18707.89,17930.7,1.901,3.12,1.08,9.68,2,3.2,-3.53,0.075,0.23109375,TAKER
24/11/2022 06:00:00,18/06/2023 21:39:57,DUMMY_Gemini_BTCUSD_1h_01_07_22_to_16_06_23.csv,BTC_USD,HOUR,158.54,0.017,24/11/2022 11:00:00,24/11/2022 13:00:00,24/11/2022 08:00:00,STOP_LOSS_HIT,LONG,16710.0,16518.71,17283.86,16518.71,1.792,3.32,1.16,9.54,2,3.1,-3.46,0.075,0.21305249999999998,TAKER
04/10/2022 20:00:00,18/06/2023 21:39:57,DUMMY_Gemini_BTCUSD_1h_01_07_22_to_16_06_23.csv,BTC_USD,HOUR,155.08,0.009,05/10/2022 00:00:00,05/10/2022 03:00:00,05/10/2022 03:00:00,EXPIRED,LONG,20341.0,20194.0,21361.5,20000.83,1.18,4.78,1.7,9.05,2,3.1,-1.46,0.075,0.13730175,TAKER
30/04/2023 23:00:00,18/06/2023 21:39:57,DUMMY_Gemini_BTCUSD_1h_01_07_22_to_16_06_23.csv,BTC_USD,HOUR,153.62,0.008,01/05/2023 01:00:00,01/05/2023 06:00:00,01/05/2023 01:00:00,STOP_LOSS_HIT,LONG,29241.0,28841.37,30439.88,28841.37,1.523,3.94,1.39,9.42,2,3.1,-3.37,0.075,0.175446,TAKER
02/07/2022 00:00:00,18/06/2023 21:39:57,DUMMY_Gemini_BTCUSD_1h_01_07_22_to_16_06_23.csv,BTC_USD,HOUR,150.25,0.014,02/07/2022 06:00:00,02/07/2022 07:00:00,02/07/2022 07:00:00,EXPIRED,LONG,19157.0,19097.0,19799.28,18942.91,1.785,3.24,1.13,8.79,2,3.1,-1.04,0.075,0.20114849999999998,TAKER
10/05/2023 16:00:00,18/06/2023 21:39:57,DUMMY_Gemini_BTCUSD_1h_01_07_22_to_16_06_23.csv,BTC_USD,HOUR,149.21,0.01,10/05/2023 23:00:00,10/05/2023 23:00:00,10/05/2023 17:00:00,TAKE_PROFIT_HIT,SHORT,28182.0,27247.38,27247.38,28493.54,1.889,3.43,1.09,9.13,2,3.1,9.13,0.075,0.21136499999999997,TAKER
23/11/2022 13:00:00,18/06/2023 21:39:57,DUMMY_Gemini_BTCUSD_1h_01_07_22_to_16_06_23.csv,BTC_USD,HOUR,158.34,0.016,23/11/2022 21:00:00,23/11/2022 20:00:00,23/11/2022 20:00:00,EXPIRED,LONG,16378.0,16613.0,16969.83,16180.72,1.655,3.49,1.22,9.27,2,3.1,3.56,0.075,0.19653600000000002,TAKER
04/03/2023 03:00:00,18/06/2023 21:39:57,DUMMY_Gemini_BTCUSD_1h_01_07_22_to_16_06_23.csv,BTC_USD,HOUR,161.9,0.013,04/03/2023 06:00:00,04/03/2023 10:00:00,04/03/2023 10:00:00,EXPIRED,LONG,22349.0,22342.0,23069.33,22108.89,1.795,3.12,1.09,9.15,2,3.2,-0.31,0.075,0.21790274999999998,TAKER
13/04/2023 15:00:00,18/06/2023 21:39:57,DUMMY_Gemini_BTCUSD_1h_01_07_22_to_16_06_23.csv,BTC_USD,HOUR,161.59,0.005,13/04/2023 18:00:00,13/04/2023 22:00:00,13/04/2023 22:00:00,EXPIRED,LONG,30473.0,30335.0,32534.12,29785.96,0.943,6.34,2.31,10.19,2,3.1,-0.8,0.075,0.11427375,TAKER
27/05/2023 13:00:00,18/06/2023 21:39:57,DUMMY_Gemini_BTCUSD_1h_01_07_22_to_16_06_23.csv,BTC_USD,HOUR,160.79,0.009,27/05/2023 21:00:00,27/05/2023 20:00:00,27/05/2023 20:00:00,EXPIRED,LONG,26637.0,26759.0,27653.61,26298.13,1.491,3.68,1.29,8.97,2,3.1,0.92,0.075,0.17979974999999995,TAKER
15/05/2023 18:00:00,18/06/2023 21:39:57,DUMMY_Gemini_BTCUSD_1h_01_07_22_to_16_06_23.csv,BTC_USD,HOUR,161.71,0.011,16/05/2023 00:00:00,16/05/2023 01:00:00,15/05/2023 23:00:00,STOP_LOSS_HIT,LONG,27452.0,27145.38,28371.87,27145.38,1.867,3.24,1.13,9.89,2,3.1,-3.6,0.075,0.22647899999999996,TAKER
03/06/2023 16:00:00,18/06/2023 21:39:57,DUMMY_Gemini_BTCUSD_1h_01_07_22_to_16_06_23.csv,BTC_USD,HOUR,158.11,0.006,03/06/2023 20:00:00,03/06/2023 23:00:00,03/06/2023 23:00:00,EXPIRED,LONG,27263.0,27080.0,28970.55,26693.82,1.035,5.89,2.13,10.12,2,3.1,-1.22,0.075,0.1226835,TAKER
18/08/2022 10:00:00,18/06/2023 21:39:57,DUMMY_Gemini_BTCUSD_1h_01_07_22_to_16_06_23.csv,BTC_USD,HOUR,156.89,0.006,18/08/2022 15:00:00,18/08/2022 17:00:00,18/08/2022 17:00:00,EXPIRED,LONG,23488.0,23264.0,25117.3,22944.9,0.898,6.49,2.37,9.67,2,3.1,-1.45,0.075,0.105696,TAKER
24/07/2022 08:00:00,18/06/2023 21:39:57,DUMMY_Gemini_BTCUSD_1h_01_07_22_to_16_06_23.csv,BTC_USD,HOUR,155.44,0.006,24/07/2022 13:00:00,24/07/2022 15:00:00,24/07/2022 15:00:00,EXPIRED,LONG,22694.0,22857.0,24166.6,22203.14,0.876,6.09,2.21,8.73,2,3.1,0.88,0.075,0.102123,TAKER
28/04/2023 21:00:00,18/06/2023 21:39:57,DUMMY_Gemini_BTCUSD_1h_01_07_22_to_16_06_23.csv,BTC_USD,HOUR,156.32,0.009,29/04/2023 02:00:00,29/04/2023 04:00:00,29/04/2023 04:00:00,EXPIRED,LONG,29364.0,29396.0,30380.37,29025.21,1.691,3.35,1.17,8.95,2,3.1,0.09,0.075,0.19820699999999994,TAKER
14/12/2022 11:00:00,18/06/2023 21:39:57,DUMMY_Gemini_BTCUSD_1h_01_07_22_to_16_06_23.csv,BTC_USD,HOUR,156.41,0.015,14/12/2022 18:00:00,14/12/2022 18:00:00,14/12/2022 18:00:00,EXPIRED,LONG,17823.0,18212.0,18435.01,17619.0,1.709,3.32,1.16,8.98,2,3.1,5.63,0.075,0.20050874999999999,TAKER
28/07/2022 08:00:00,18/06/2023 21:39:57,DUMMY_Gemini_BTCUSD_1h_01_07_22_to_16_06_23.csv,BTC_USD,HOUR,162.04,0.005,28/07/2022 16:00:00,28/07/2022 15:00:00,28/07/2022 15:00:00,STOP_LOSS_HIT,SHORT,22976.0,23608.34,21079.0,23608.34,0.709,9.0,2.68,9.4,2,3.1,-3.25,0.075,0.08616,TAKER
17/10/2022 13:00:00,18/06/2023 21:39:57,DUMMY_Gemini_BTCUSD_1h_01_07_22_to_16_06_23.csv,BTC_USD,HOUR,158.79,0.006,17/10/2022 15:00:00,17/10/2022 20:00:00,17/10/2022 20:00:00,EXPIRED,LONG,19588.0,19527.0,21302.23,19016.59,0.74,8.05,3.0,10.2,2,3.1,-0.45,0.075,0.088146,TAKER
28/02/2023 14:00:00,18/06/2023 21:39:57,DUMMY_Gemini_BTCUSD_1h_01_07_22_to_16_06_23.csv,BTC_USD,HOUR,158.34,0.005,28/02/2023 16:00:00,28/02/2023 21:00:00,28/02/2023 21:00:00,EXPIRED,LONG,23424.0,23136.0,25229.54,22822.16,0.74,7.16,2.64,8.94,2,3.1,-1.53,0.075,0.08784,TAKER
13/07/2022 10:00:00,18/06/2023 21:39:57,DUMMY_Gemini_BTCUSD_1h_01_07_22_to_16_06_23.csv,BTC_USD,HOUR,156.81,0.006,13/07/2022 15:00:00,13/07/2022 17:00:00,13/07/2022 12:00:00,STOP_LOSS_HIT,LONG,19774.0,19255.66,21329.03,19255.66,0.757,7.29,2.69,9.24,2,3.1,-3.2,0.075,0.088983,TAKER
23/09/2022 21:00:00,18/06/2023 21:39:57,DUMMY_Gemini_BTCUSD_1h_01_07_22_to_16_06_23.csv,BTC_USD,HOUR,153.61,0.016,23/09/2022 23:00:00,24/09/2022 04:00:00,24/09/2022 04:00:00,EXPIRED,LONG,19012.0,19164.0,19588.5,18819.83,1.98,2.94,1.02,9.0,2,3.2,2.2,0.075,0.22814399999999999,TAKER
11/09/2022 00:00:00,18/06/2023 21:39:57,DUMMY_Gemini_BTCUSD_1h_01_07_22_to_16_06_23.csv,BTC_USD,HOUR,155.81,0.008,11/09/2022 07:00:00,11/09/2022 07:00:00,11/09/2022 07:00:00,EXPIRED,LONG,21551.0,21620.0,22685.53,21172.83,1.107,5.0,1.79,8.95,2,3.1,0.42,0.075,0.129306,TAKER
07/07/2022 18:00:00,18/06/2023 21:39:57,DUMMY_Gemini_BTCUSD_1h_01_07_22_to_16_06_23.csv,BTC_USD,HOUR,156.23,0.008,08/07/2022 02:00:00,08/07/2022 01:00:00,07/07/2022 19:00:00,STOP_LOSS_HIT,SHORT,21366.0,21734.23,20261.31,21734.23,1.094,5.45,1.69,8.71,2,3.1,-3.07,0.075,0.128196,TAKER
22/04/2023 21:00:00,18/06/2023 21:39:57,DUMMY_Gemini_BTCUSD_1h_01_07_22_to_16_06_23.csv,BTC_USD,HOUR,153.16,0.009,23/04/2023 02:00:00,23/04/2023 04:00:00,23/04/2023 04:00:00,EXPIRED,LONG,27674.0,27623.0,28716.62,27326.46,1.626,3.63,1.27,9.2,2,3.1,-0.65,0.075,0.18679949999999998,TAKER
20/05/2023 20:00:00,18/06/2023 21:39:57,DUMMY_Gemini_BTCUSD_1h_01_07_22_to_16_06_23.csv,BTC_USD,HOUR,152.51,0.006,20/05/2023 23:00:00,21/05/2023 03:00:00,21/05/2023 03:00:00,EXPIRED,LONG,27021.0,27187.0,28536.98,26515.68,1.063,5.31,1.91,8.97,2,3.1,0.87,0.075,0.1215945,TAKER
22/09/2022 16:00:00,18/06/2023 21:39:58,DUMMY_Gemini_BTCUSD_1h_01_07_22_to_16_06_23.csv,BTC_USD,HOUR,153.38,0.014,22/09/2022 18:00:00,22/09/2022 23:00:00,22/09/2022 23:00:00,EXPIRED,LONG,19036.0,19400.0,19708.34,18811.89,1.738,3.41,1.19,9.21,2,3.1,4.9,0.075,0.199878,TAKER
22/04/2023 21:00:00,18/06/2023 21:39:58,DUMMY_Gemini_BTCUSD_1h_01_07_22_to_16_06_23.csv,BTC_USD,HOUR,158.28,0.009,23/04/2023 02:00:00,23/04/2023 04:00:00,23/04/2023 04:00:00,EXPIRED,LONG,27674.0,27623.0,28716.62,27326.46,1.574,3.63,1.27,9.2,2,3.1,-0.65,0.075,0.18679949999999998,TAKER
09/04/2023 06:00:00,18/06/2023 21:39:58,DUMMY_Gemini_BTCUSD_1h_01_07_22_to_16_06_23.csv,BTC_USD,HOUR,157.63,0.011,09/04/2023 10:00:00,09/04/2023 13:00:00,09/04/2023 13:00:00,EXPIRED,LONG,27911.0,27926.0,28755.11,27629.63,1.948,2.94,1.02,9.05,2,3.2,-0.07,0.075,0.23026574999999996,TAKER
20/02/2023 22:00:00,18/06/2023 21:39:58,DUMMY_Gemini_BTCUSD_1h_01_07_22_to_16_06_23.csv,BTC_USD,HOUR,157.56,0.011,21/02/2023 00:00:00,21/02/2023 05:00:00,21/02/2023 05:00:00,EXPIRED,LONG,24706.0,24952.0,25550.5,24424.5,1.725,3.31,1.15,9.09,2,3.1,2.5,0.075,0.20382449999999996,TAKER
19/10/2022 17:00:00,18/06/2023 21:39:58,DUMMY_Gemini_BTCUSD_1h_01_07_22_to_16_06_23.csv,BTC_USD,HOUR,160.06,0.008,19/10/2022 22:00:00,20/10/2022 00:00:00,20/10/2022 00:00:00,EXPIRED,LONG,19196.0,18950.0,20370.8,18804.4,0.959,5.77,2.08,9.28,2,3.1,-2.08,0.075,0.115176,TAKER
06/09/2022 10:00:00,18/06/2023 21:39:58,DUMMY_Gemini_BTCUSD_1h_01_07_22_to_16_06_23.csv,BTC_USD,HOUR,157.98,0.009,06/09/2022 13:00:00,06/09/2022 17:00:00,06/09/2022 17:00:00,STOP_LOSS_HIT,LONG,19913.0,19543.7,21020.91,19543.7,1.134,5.27,1.89,9.84,2,3.1,-3.46,0.075,0.13441275,TAKER
09/04/2023 01:00:00,18/06/2023 21:39:58,DUMMY_Gemini_BTCUSD_1h_01_07_22_to_16_06_23.csv,BTC_USD,HOUR,154.52,0.006,09/04/2023 05:00:00,09/04/2023 08:00:00,09/04/2023 08:00:00,EXPIRED,LONG,28099.0,27884.0,29717.4,27559.53,1.091,5.45,1.96,9.58,2,3.1,-1.42,0.075,0.1264455,TAKER
27/01/2023 19:00:00,18/06/2023 21:39:58,DUMMY_Gemini_BTCUSD_1h_01_07_22_to_16_06_23.csv,BTC_USD,HOUR,153.1,0.012,27/01/2023 21:00:00,28/01/2023 02:00:00,27/01/2023 22:00:00,STOP_LOSS_HIT,LONG,23268.0,23011.96,24036.11,23011.96,1.824,3.2,1.11,9.01,2,3.2,-3.28,0.075,0.209412,TAKER
10/11/2022 22:00:00,18/06/2023 21:39:58,DUMMY_Gemini_BTCUSD_1h_01_07_22_to_16_06_23.csv,BTC_USD,HOUR,149.82,0.01,11/11/2022 00:00:00,11/11/2022 05:00:00,10/11/2022 23:00:00,STOP_LOSS_HIT,LONG,17791.0,17497.71,18670.86,17497.71,1.187,4.71,1.68,8.67,2,3.1,-3.07,0.075,0.13343249999999998,TAKER
01/01/2023 19:00:00,18/06/2023 21:39:58,DUMMY_Gemini_BTCUSD_1h_01_07_22_to_16_06_23.csv,BTC_USD,HOUR,146.75,0.017,01/01/2023 21:00:00,02/01/2023 02:00:00,02/01/2023 02:00:00,EXPIRED,LONG,16602.0,16589.0,17121.77,16428.74,1.923,3.04,1.05,8.62,2,3.2,-0.43,0.075,0.21167550000000002,TAKER
30/11/2022 02:00:00,18/06/2023 21:39:58,DUMMY_Gemini_BTCUSD_1h_01_07_22_to_16_06_23.csv,BTC_USD,HOUR,146.32,0.008,30/11/2022 03:00:00,30/11/2022 09:00:00,30/11/2022 09:00:00,EXPIRED,LONG,16967.0,16871.0,18047.77,16606.74,0.928,5.99,2.17,8.54,2,3.1,-0.87,0.075,0.10180199999999999,TAKER
20/03/2023 03:00:00,18/06/2023 21:39:58,DUMMY_Gemini_BTCUSD_1h_01_07_22_to_16_06_23.csv,BTC_USD,HOUR,145.45,0.009,20/03/2023 09:00:00,20/03/2023 10:00:00,20/03/2023 08:00:00,TAKE_PROFIT_HIT,LONG,27369.0,28350.33,28350.33,27041.89,1.694,3.46,1.21,8.65,2,3.1,8.65,0.075,0.18474074999999995,TAKER
02/01/2023 02:00:00,18/06/2023 21:39:58,DUMMY_Gemini_BTCUSD_1h_01_07_22_to_16_06_23.csv,BTC_USD,HOUR,154.1,0.008,02/01/2023 04:00:00,02/01/2023 09:00:00,02/01/2023 09:00:00,EXPIRED,LONG,16589.0,16717.0,17778.88,16192.37,0.861,6.69,2.45,9.42,2,3.1,0.92,0.075,0.09953399999999998,TAKER
23/11/2022 04:00:00,18/06/2023 21:39:58,DUMMY_Gemini_BTCUSD_1h_01_07_22_to_16_06_23.csv,BTC_USD,HOUR,155.02,0.007,23/11/2022 06:00:00,23/11/2022 11:00:00,23/11/2022 11:00:00,EXPIRED,LONG,16496.0,16577.0,17798.16,16061.95,0.745,7.32,2.7,9.03,2,3.1,0.48,0.075,0.08660400000000001,TAKER
30/11/2022 21:00:00,18/06/2023 21:39:58,DUMMY_Gemini_BTCUSD_1h_01_07_22_to_16_06_23.csv,BTC_USD,HOUR,155.5,0.007,01/12/2022 00:00:00,01/12/2022 04:00:00,01/12/2022 04:00:00,EXPIRED,LONG,17091.0,17146.0,18423.67,16646.78,0.769,7.23,2.67,9.24,2,3.1,0.3,0.075,0.08972775000000001,TAKER
24/03/2023 00:00:00,18/06/2023 21:39:58,DUMMY_Gemini_BTCUSD_1h_01_07_22_to_16_06_23.csv,BTC_USD,HOUR,155.8,0.01,24/03/2023 02:00:00,24/03/2023 07:00:00,24/03/2023 07:00:00,EXPIRED,LONG,28266.0,28333.0,29198.1,27955.3,1.814,3.19,1.11,9.11,2,3.1,0.46,0.075,0.21199500000000002,TAKER
04/09/2022 21:00:00,18/06/2023 21:39:58,DUMMY_Gemini_BTCUSD_1h_01_07_22_to_16_06_23.csv,BTC_USD,HOUR,156.26,0.014,05/09/2022 01:00:00,05/09/2022 04:00:00,05/09/2022 04:00:00,EXPIRED,LONG,19874.0,19898.0,20546.81,19649.73,1.781,3.27,1.14,9.21,2,3.1,0.13,0.075,0.208677,TAKER
27/11/2022 17:00:00,18/06/2023 21:39:58,DUMMY_Gemini_BTCUSD_1h_01_07_22_to_16_06_23.csv,BTC_USD,HOUR,156.39,0.016,28/11/2022 01:00:00,28/11/2022 00:00:00,28/11/2022 00:00:00,EXPIRED,LONG,16513.0,16441.0,17093.29,16319.57,1.689,3.39,1.19,9.09,2,3.1,-1.35,0.075,0.198156,TAKER
27/09/2022 09:00:00,18/06/2023 21:39:58,DUMMY_Gemini_BTCUSD_1h_01_07_22_to_16_06_23.csv,BTC_USD,HOUR,155.04,0.015,27/09/2022 15:00:00,27/09/2022 16:00:00,27/09/2022 15:00:00,STOP_LOSS_HIT,LONG,20183.0,19978.58,20796.26,19978.58,1.953,2.95,1.02,8.97,2,3.2,-3.29,0.075,0.22705874999999998,TAKER
30/08/2022 02:00:00,18/06/2023 21:39:58,DUMMY_Gemini_BTCUSD_1h_01_07_22_to_16_06_23.csv,BTC_USD,HOUR,151.75,0.012,30/08/2022 07:00:00,30/08/2022 09:00:00,30/08/2022 09:00:00,EXPIRED,LONG,20197.0,20426.0,20956.41,19943.86,1.597,3.62,1.27,8.93,2,3.1,2.57,0.075,0.181773,TAKER
14/07/2022 05:00:00,18/06/2023 21:39:58,DUMMY_Gemini_BTCUSD_1h_01_07_22_to_16_06_23.csv,BTC_USD,HOUR,154.32,0.015,14/07/2022 09:00:00,14/07/2022 12:00:00,14/07/2022 08:00:00,STOP_LOSS_HIT,LONG,20089.0,19881.54,20711.4,19881.54,1.953,3.01,1.04,9.11,2,3.2,-3.34,0.075,0.22600125,TAKER
16/02/2023 09:00:00,18/06/2023 21:39:58,DUMMY_Gemini_BTCUSD_1h_01_07_22_to_16_06_23.csv,BTC_USD,HOUR,150.98,0.006,16/02/2023 11:00:00,16/02/2023 16:00:00,16/02/2023 16:00:00,EXPIRED,LONG,24662.0,24907.0,26113.77,24178.08,0.98,5.56,2.0,8.6,2,3.1,1.36,0.075,0.11097900000000001,TAKER
24/07/2022 11:00:00,18/06/2023 21:39:58,DUMMY_Gemini_BTCUSD_1h_01_07_22_to_16_06_23.csv,BTC_USD,HOUR,152.34,0.006,24/07/2022 19:00:00,24/07/2022 18:00:00,24/07/2022 18:00:00,EXPIRED,SHORT,22662.0,22720.0,21035.29,23204.24,0.893,7.73,2.34,9.66,2,3.1,-0.45,0.075,0.101979,TAKER
15/03/2023 12:00:00,18/06/2023 21:39:58,DUMMY_Gemini_BTCUSD_1h_01_07_22_to_16_06_23.csv,BTC_USD,HOUR,151.89,0.012,15/03/2023 16:00:00,15/03/2023 19:00:00,15/03/2023 14:00:00,STOP_LOSS_HIT,LONG,24923.0,24660.57,25710.31,24660.57,1.969,3.06,1.06,9.22,2,3.2,-3.37,0.075,0.224307,TAKER
