Open,Last update,Platform,Symbol,Timeframe,Account balance at open,Size,Expected close,Expiry,Close,Status,Side,Opening price,Closing price,Take profit,Stop loss,Leverage,TP price %,SL price %,Expected profit,Risk %,R/R ratio,PnL,Fee %,Fee Amount,Order Type
30/03/2023 16:00:00,19/06/2023 17:38:52,Upscale-DUMMY_Gemini_BTCUSD_1h_01_07_22_to_16_06_23.csv,BTC_USD,FOUR_HOUR,200.0,0.033,01/04/2023 08:00:00,01/04/2023 12:00:00,30/03/2023 20:00:00,STOP_LOSS_HIT,SHORT,27973.0,28093.75,27731.5,28093.75,4.616,0.87,0.43,7.28,2,2.2,-4.68,0.075,0.69233175,TAKER
03/04/2023 12:00:00,19/06/2023 17:38:52,Upscale-DUMMY_Gemini_BTCUSD_1h_01_07_22_to_16_06_23.csv,BTC_USD,FOUR_HOUR,195.32,0.032,05/04/2023 08:00:00,05/04/2023 08:00:00,03/04/2023 16:00:00,STOP_LOSS_HIT,LONG,28065.0,27944.46,28306.08,27944.46,4.598,0.85,0.43,7.04,2,2.2,-4.53,0.075,0.6735599999999999,TAKER
30/08/2022 16:00:00,19/06/2023 17:38:53,Upscale-DUMMY_Gemini_BTCUSD_1h_01_07_22_to_16_06_23.csv,BTC_USD,FOUR_HOUR,190.79,0.021,31/08/2022 16:00:00,01/09/2022 12:00:00,30/08/2022 20:00:00,STOP_LOSS_HIT,LONG,19953.0,19769.88,20319.25,19769.88,2.196,1.8,0.93,7.38,2,2.1,-4.16,0.075,0.31425975,TAKER
14/01/2023 12:00:00,19/06/2023 17:38:53,Upscale-DUMMY_Gemini_BTCUSD_1h_01_07_22_to_16_06_23.csv,BTC_USD,FOUR_HOUR,186.63,0.014,16/01/2023 12:00:00,16/01/2023 08:00:00,16/01/2023 00:00:00,TAKE_PROFIT_HIT,LONG,20792.0,21343.45,21343.45,20516.28,1.56,2.58,1.34,7.5,2,2.1,7.5,0.075,0.218316,TAKER
19/07/2022 20:00:00,19/06/2023 17:38:53,Upscale-DUMMY_Gemini_BTCUSD_1h_01_07_22_to_16_06_23.csv,BTC_USD,FOUR_HOUR,194.13,0.013,20/07/2022 12:00:00,21/07/2022 16:00:00,20/07/2022 00:00:00,STOP_LOSS_HIT,LONG,23399.0,23106.96,23983.08,23106.96,1.567,2.44,1.26,7.36,2,2.1,-4.02,0.075,0.22814025000000002,TAKER
08/12/2022 20:00:00,19/06/2023 17:38:54,Upscale-DUMMY_Gemini_BTCUSD_1h_01_07_22_to_16_06_23.csv,BTC_USD,FOUR_HOUR,190.11,0.059,10/12/2022 04:00:00,10/12/2022 16:00:00,09/12/2022 12:00:00,STOP_LOSS_HIT,LONG,17233.0,17168.77,17361.46,17168.77,5.348,0.74,0.37,6.82,2,2.3,-4.55,0.075,0.7625602499999999,TAKER
01/03/2023 08:00:00,19/06/2023 17:38:54,Upscale-DUMMY_Gemini_BTCUSD_1h_01_07_22_to_16_06_23.csv,BTC_USD,FOUR_HOUR,185.56,0.029,02/03/2023 08:00:00,03/03/2023 04:00:00,01/03/2023 12:00:00,STOP_LOSS_HIT,SHORT,23740.0,23867.41,23485.19,23867.41,3.71,1.08,0.53,6.87,2,2.2,-4.21,0.075,0.516345,TAKER
16/02/2023 00:00:00,19/06/2023 17:38:54,Upscale-DUMMY_Gemini_BTCUSD_1h_01_07_22_to_16_06_23.csv,BTC_USD,FOUR_HOUR,181.35,0.008,16/02/2023 16:00:00,17/02/2023 20:00:00,16/02/2023 20:00:00,STOP_LOSS_HIT,LONG,24741.0,24267.96,25687.09,24267.96,1.091,3.68,1.95,7.42,2,2.0,-3.93,0.075,0.148446,TAKER
06/07/2022 00:00:00,19/06/2023 17:38:54,Upscale-DUMMY_Gemini_BTCUSD_1h_01_07_22_to_16_06_23.csv,BTC_USD,FOUR_HOUR,177.42,0.039,06/07/2022 12:00:00,07/07/2022 20:00:00,06/07/2022 04:00:00,TAKE_PROFIT_HIT,LONG,19931.0,20110.74,20110.74,19841.13,4.381,0.89,0.45,6.43,2,2.2,6.43,0.075,0.58298175,TAKER
19/07/2022 20:00:00,19/06/2023 17:38:54,Upscale-DUMMY_Gemini_BTCUSD_1h_01_07_22_to_16_06_23.csv,BTC_USD,FOUR_HOUR,183.85,0.013,20/07/2022 12:00:00,21/07/2022 16:00:00,20/07/2022 00:00:00,STOP_LOSS_HIT,LONG,23399.0,23106.96,23983.08,23106.96,1.655,2.44,1.26,7.36,2,2.1,-4.02,0.075,0.22814025000000002,TAKER
30/11/2022 12:00:00,19/06/2023 17:38:55,Upscale-DUMMY_Gemini_BTCUSD_1h_01_07_22_to_16_06_23.csv,BTC_USD,FOUR_HOUR,179.83,0.018,01/12/2022 20:00:00,02/12/2022 08:00:00,01/12/2022 12:00:00,TAKE_PROFIT_HIT,LONG,16859.0,17263.74,17263.74,16656.63,1.687,2.34,1.21,7.06,2,2.1,7.06,0.075,0.22759649999999998,TAKER
27/09/2022 00:00:00,19/06/2023 17:38:55,Upscale-DUMMY_Gemini_BTCUSD_1h_01_07_22_to_16_06_23.csv,BTC_USD,FOUR_HOUR,186.89,0.019,27/09/2022 20:00:00,28/09/2022 20:00:00,27/09/2022 12:00:00,STOP_LOSS_HIT,LONG,20107.0,19909.33,20502.34,19909.33,2.044,1.93,0.99,7.22,2,2.1,-4.04,0.075,0.28652475,TAKER
28/10/2022 16:00:00,19/06/2023 17:38:55,Upscale-DUMMY_Gemini_BTCUSD_1h_01_07_22_to_16_06_23.csv,BTC_USD,FOUR_HOUR,182.85,0.029,30/10/2022 12:00:00,30/10/2022 12:00:00,29/10/2022 08:00:00,TAKE_PROFIT_HIT,LONG,20608.0,20859.1,20859.1,20482.45,3.268,1.2,0.61,6.83,2,2.1,6.83,0.075,0.448224,TAKER
30/04/2023 20:00:00,19/06/2023 17:38:55,Upscale-DUMMY_Gemini_BTCUSD_1h_01_07_22_to_16_06_23.csv,BTC_USD,FOUR_HOUR,189.68,0.017,01/05/2023 04:00:00,02/05/2023 16:00:00,01/05/2023 00:00:00,STOP_LOSS_HIT,LONG,29241.0,29016.81,29689.38,29016.81,2.621,1.51,0.77,7.25,2,2.1,-4.18,0.075,0.37282275,TAKER
05/05/2023 00:00:00,19/06/2023 17:38:55,Upscale-DUMMY_Gemini_BTCUSD_1h_01_07_22_to_16_06_23.csv,BTC_USD,FOUR_HOUR,185.5,0.007,07/05/2023 00:00:00,06/05/2023 20:00:00,06/05/2023 12:00:00,STOP_LOSS_HIT,LONG,29198.0,28658.24,30277.53,28658.24,1.102,3.57,1.88,7.4,2,2.0,-3.93,0.075,0.1532895,TAKER
10/07/2022 04:00:00,19/06/2023 17:38:55,Upscale-DUMMY_Gemini_BTCUSD_1h_01_07_22_to_16_06_23.csv,BTC_USD,FOUR_HOUR,181.57,0.021,12/07/2022 04:00:00,12/07/2022 00:00:00,10/07/2022 12:00:00,STOP_LOSS_HIT,LONG,21328.0,21158.42,21667.17,21158.42,2.467,1.57,0.8,6.79,2,2.1,-3.9,0.075,0.335916,TAKER
03/04/2023 12:00:00,19/06/2023 17:38:55,Upscale-DUMMY_Gemini_BTCUSD_1h_01_07_22_to_16_06_23.csv,BTC_USD,FOUR_HOUR,177.67,0.029,05/04/2023 08:00:00,05/04/2023 08:00:00,03/04/2023 16:00:00,STOP_LOSS_HIT,LONG,28065.0,27944.46,28306.08,27944.46,4.581,0.85,0.43,6.38,2,2.2,-4.11,0.075,0.61041375,TAKER
04/05/2023 00:00:00,19/06/2023 17:38:56,Upscale-DUMMY_Gemini_BTCUSD_1h_01_07_22_to_16_06_23.csv,BTC_USD,FOUR_HOUR,173.56,0.023,05/05/2023 00:00:00,05/05/2023 20:00:00,04/05/2023 08:00:00,STOP_LOSS_HIT,SHORT,29091.0,29240.42,28792.17,29240.42,3.855,1.04,0.51,6.37,2,2.2,-3.94,0.075,0.5018197499999999,TAKER
22/01/2023 16:00:00,19/06/2023 17:38:56,Upscale-DUMMY_Gemini_BTCUSD_1h_01_07_22_to_16_06_23.csv,BTC_USD,FOUR_HOUR,169.62,0.033,22/01/2023 20:00:00,24/01/2023 12:00:00,22/01/2023 20:00:00,STOP_LOSS_HIT,LONG,22720.0,22618.06,22923.88,22618.06,4.42,0.89,0.45,6.17,2,2.2,-3.93,0.075,0.56232,TAKER
25/08/2022 16:00:00,19/06/2023 17:38:56,Upscale-DUMMY_Gemini_BTCUSD_1h_01_07_22_to_16_06_23.csv,BTC_USD,FOUR_HOUR,165.69,0.041,26/08/2022 04:00:00,27/08/2022 12:00:00,25/08/2022 20:00:00,STOP_LOSS_HIT,SHORT,21601.0,21682.5,21438.0,21682.5,5.345,0.76,0.38,6.02,2,2.2,-4.01,0.075,0.66423075,TAKER
09/12/2022 12:00:00,19/06/2023 17:38:56,Upscale-DUMMY_Gemini_BTCUSD_1h_01_07_22_to_16_06_23.csv,BTC_USD,FOUR_HOUR,161.68,0.044,10/12/2022 00:00:00,11/12/2022 08:00:00,11/12/2022 08:00:00,EXPIRED,SHORT,17182.0,17163.0,17035.69,17255.16,4.676,0.86,0.42,5.87,2,2.2,0.27,0.075,0.5670059999999999,TAKER
13/03/2023 20:00:00,19/06/2023 17:38:56,Upscale-DUMMY_Gemini_BTCUSD_1h_01_07_22_to_16_06_23.csv,BTC_USD,FOUR_HOUR,161.95,0.01,15/03/2023 08:00:00,15/03/2023 16:00:00,14/03/2023 04:00:00,TAKE_PROFIT_HIT,LONG,24237.0,24860.38,24860.38,23925.31,1.497,2.51,1.3,6.05,2,2.1,6.05,0.075,0.1817775,TAKER
02/12/2022 12:00:00,19/06/2023 17:38:56,Upscale-DUMMY_Gemini_BTCUSD_1h_01_07_22_to_16_06_23.csv,BTC_USD,FOUR_HOUR,168.0,0.052,04/12/2022 04:00:00,04/12/2022 08:00:00,02/12/2022 20:00:00,TAKE_PROFIT_HIT,LONG,16945.0,17073.72,17073.72,16880.64,5.245,0.75,0.38,6.03,2,2.2,6.03,0.075,0.660855,TAKER
14/01/2023 04:00:00,19/06/2023 17:38:57,Upscale-DUMMY_Gemini_BTCUSD_1h_01_07_22_to_16_06_23.csv,BTC_USD,FOUR_HOUR,174.03,0.012,15/01/2023 04:00:00,16/01/2023 00:00:00,14/01/2023 08:00:00,STOP_LOSS_HIT,LONG,20911.0,20627.67,21477.66,20627.67,1.442,2.64,1.37,6.61,2,2.1,-3.59,0.075,0.188199,TAKER
31/08/2022 00:00:00,19/06/2023 17:38:57,Upscale-DUMMY_Gemini_BTCUSD_1h_01_07_22_to_16_06_23.csv,BTC_USD,FOUR_HOUR,170.44,0.038,31/08/2022 16:00:00,01/09/2022 20:00:00,31/08/2022 04:00:00,STOP_LOSS_HIT,LONG,20414.0,20324.92,20592.16,20324.92,4.551,0.87,0.44,6.19,2,2.2,-3.97,0.075,0.581799,TAKER
27/09/2022 04:00:00,19/06/2023 17:38:58,Upscale-DUMMY_Gemini_BTCUSD_1h_01_07_22_to_16_06_23.csv,BTC_USD,FOUR_HOUR,166.47,0.027,28/09/2022 00:00:00,29/09/2022 00:00:00,27/09/2022 12:00:00,STOP_LOSS_HIT,LONG,20185.0,20063.89,20427.22,20063.89,3.274,1.19,0.6,6.13,2,2.1,-3.68,0.075,0.40874625000000003,TAKER
27/09/2022 00:00:00,19/06/2023 17:38:58,Upscale-DUMMY_Gemini_BTCUSD_1h_01_07_22_to_16_06_23.csv,BTC_USD,FOUR_HOUR,162.79,0.016,27/09/2022 20:00:00,28/09/2022 20:00:00,27/09/2022 12:00:00,STOP_LOSS_HIT,LONG,20107.0,19909.33,20502.34,19909.33,1.976,1.93,0.99,6.08,2,2.1,-3.4,0.075,0.241284,TAKER
18/07/2022 12:00:00,19/06/2023 17:38:58,Upscale-DUMMY_Gemini_BTCUSD_1h_01_07_22_to_16_06_23.csv,BTC_USD,FOUR_HOUR,159.39,0.008,19/07/2022 08:00:00,20/07/2022 08:00:00,18/07/2022 16:00:00,STOP_LOSS_HIT,LONG,22694.0,22287.87,23506.27,22287.87,1.139,3.46,1.82,6.36,2,2.0,-3.39,0.075,0.13616399999999998,TAKER
19/07/2022 08:00:00,19/06/2023 17:38:58,Upscale-DUMMY_Gemini_BTCUSD_1h_01_07_22_to_16_06_23.csv,BTC_USD,FOUR_HOUR,156.0,0.029,20/07/2022 08:00:00,21/07/2022 04:00:00,19/07/2022 12:00:00,TAKE_PROFIT_HIT,LONG,21981.0,22196.5,22196.5,21873.26,4.086,0.97,0.49,5.77,2,2.2,5.77,0.075,0.47808675,TAKER
18/03/2023 08:00:00,19/06/2023 17:38:58,Upscale-DUMMY_Gemini_BTCUSD_1h_01_07_22_to_16_06_23.csv,BTC_USD,FOUR_HOUR,161.77,0.019,20/03/2023 08:00:00,20/03/2023 04:00:00,18/03/2023 12:00:00,STOP_LOSS_HIT,SHORT,27525.0,27696.81,27181.39,27696.81,3.233,1.26,0.62,6.14,2,2.1,-3.66,0.075,0.39223125000000003,TAKER
27/10/2022 00:00:00,19/06/2023 17:38:59,Upscale-DUMMY_Gemini_BTCUSD_1h_01_07_22_to_16_06_23.csv,BTC_USD,FOUR_HOUR,158.11,0.028,28/10/2022 16:00:00,28/10/2022 20:00:00,27/10/2022 08:00:00,STOP_LOSS_HIT,LONG,20755.0,20642.92,20979.16,20642.92,3.676,1.07,0.54,5.84,2,2.2,-3.57,0.075,0.43585499999999994,TAKER
05/05/2023 00:00:00,19/06/2023 17:39:00,Upscale-DUMMY_Gemini_BTCUSD_1h_01_07_22_to_16_06_23.csv,BTC_USD,FOUR_HOUR,154.54,0.006,07/05/2023 00:00:00,06/05/2023 20:00:00,06/05/2023 12:00:00,STOP_LOSS_HIT,LONG,29198.0,28658.24,30277.53,28658.24,1.134,3.57,1.88,6.35,2,2.0,-3.37,0.075,0.131391,TAKER
30/08/2022 12:00:00,19/06/2023 17:39:00,Upscale-DUMMY_Gemini_BTCUSD_1h_01_07_22_to_16_06_23.csv,BTC_USD,FOUR_HOUR,151.17,0.008,01/09/2022 00:00:00,01/09/2022 08:00:00,01/09/2022 08:00:00,EXPIRED,LONG,19763.0,20071.0,20560.67,19364.17,1.046,3.88,2.06,6.26,2,2.0,2.35,0.075,0.11857800000000002,TAKER
07/01/2023 00:00:00,19/06/2023 17:39:00,Upscale-DUMMY_Gemini_BTCUSD_1h_01_07_22_to_16_06_23.csv,BTC_USD,FOUR_HOUR,153.52,0.018,07/01/2023 16:00:00,08/01/2023 20:00:00,08/01/2023 20:00:00,EXPIRED,LONG,16947.0,17128.0,17285.94,16777.53,1.987,1.96,1.01,5.87,2,2.1,3.03,0.075,0.22878449999999997,TAKER
08/02/2023 16:00:00,19/06/2023 17:39:01,Upscale-DUMMY_Gemini_BTCUSD_1h_01_07_22_to_16_06_23.csv,BTC_USD,FOUR_HOUR,156.55,0.02,10/02/2023 16:00:00,10/02/2023 12:00:00,09/02/2023 00:00:00,STOP_LOSS_HIT,LONG,22883.0,22726.96,23195.09,22726.96,2.923,1.35,0.69,5.9,2,2.1,-3.46,0.075,0.343245,TAKER
26/09/2022 20:00:00,19/06/2023 17:39:01,Upscale-DUMMY_Gemini_BTCUSD_1h_01_07_22_to_16_06_23.csv,BTC_USD,FOUR_HOUR,153.09,0.043,27/09/2022 12:00:00,28/09/2022 16:00:00,27/09/2022 00:00:00,TAKE_PROFIT_HIT,LONG,19229.0,19372.34,19372.34,19157.33,5.401,0.74,0.37,5.54,2,2.3,5.54,0.075,0.6201352499999999,TAKER
08/08/2022 12:00:00,19/06/2023 17:39:01,Upscale-DUMMY_Gemini_BTCUSD_1h_01_07_22_to_16_06_23.csv,BTC_USD,FOUR_HOUR,158.63,0.014,09/08/2022 04:00:00,10/08/2022 08:00:00,08/08/2022 20:00:00,STOP_LOSS_HIT,LONG,24001.0,23776.68,24449.64,23776.68,2.118,1.83,0.94,6.03,2,2.1,-3.39,0.075,0.25201049999999997,TAKER
13/12/2022 00:00:00,19/06/2023 17:39:01,Upscale-DUMMY_Gemini_BTCUSD_1h_01_07_22_to_16_06_23.csv,BTC_USD,FOUR_HOUR,155.24,0.019,13/12/2022 12:00:00,14/12/2022 20:00:00,13/12/2022 08:00:00,TAKE_PROFIT_HIT,LONG,17158.0,17480.07,17480.07,16996.97,2.1,1.84,0.95,5.87,2,2.1,5.87,0.075,0.2445015,TAKER
01/05/2023 00:00:00,19/06/2023 17:39:03,Upscale-DUMMY_Gemini_BTCUSD_1h_01_07_22_to_16_06_23.csv,BTC_USD,FOUR_HOUR,161.11,0.023,02/05/2023 00:00:00,02/05/2023 20:00:00,01/05/2023 04:00:00,STOP_LOSS_HIT,LONG,28575.0,28435.76,28853.48,28435.76,4.079,0.97,0.49,5.91,2,2.2,-3.7,0.075,0.49291874999999996,TAKER
17/07/2022 20:00:00,19/06/2023 17:39:03,Upscale-DUMMY_Gemini_BTCUSD_1h_01_07_22_to_16_06_23.csv,BTC_USD,FOUR_HOUR,157.41,0.04,18/07/2022 08:00:00,19/07/2022 16:00:00,18/07/2022 00:00:00,STOP_LOSS_HIT,SHORT,20786.0,20865.69,20626.63,20865.69,5.282,0.77,0.38,5.75,2,2.2,-3.81,0.075,0.62358,TAKER
15/02/2023 12:00:00,19/06/2023 17:39:03,Upscale-DUMMY_Gemini_BTCUSD_1h_01_07_22_to_16_06_23.csv,BTC_USD,FOUR_HOUR,153.6,0.017,16/02/2023 20:00:00,17/02/2023 08:00:00,15/02/2023 16:00:00,TAKE_PROFIT_HIT,LONG,22830.0,23196.84,23196.84,22646.58,2.527,1.58,0.81,5.95,2,2.1,5.95,0.075,0.29108249999999997,TAKER
21/03/2023 04:00:00,19/06/2023 17:39:03,Upscale-DUMMY_Gemini_BTCUSD_1h_01_07_22_to_16_06_23.csv,BTC_USD,FOUR_HOUR,159.55,0.018,22/03/2023 12:00:00,23/03/2023 00:00:00,21/03/2023 08:00:00,TAKE_PROFIT_HIT,LONG,27605.0,27952.32,27952.32,27431.34,3.114,1.24,0.63,5.88,2,2.1,5.88,0.075,0.37266749999999993,TAKER
27/07/2022 20:00:00,19/06/2023 17:39:03,Upscale-DUMMY_Gemini_BTCUSD_1h_01_07_22_to_16_06_23.csv,BTC_USD,FOUR_HOUR,165.43,0.015,29/07/2022 16:00:00,29/07/2022 16:00:00,28/07/2022 00:00:00,STOP_LOSS_HIT,LONG,22962.0,22743.32,23399.36,22743.32,2.082,1.87,0.96,6.3,2,2.1,-3.54,0.075,0.2583225,TAKER
07/08/2022 00:00:00,19/06/2023 17:39:04,Upscale-DUMMY_Gemini_BTCUSD_1h_01_07_22_to_16_06_23.csv,BTC_USD,FOUR_HOUR,161.89,0.017,09/08/2022 00:00:00,08/08/2022 20:00:00,07/08/2022 16:00:00,STOP_LOSS_HIT,SHORT,23000.0,23194.1,22611.81,23194.1,2.415,1.72,0.84,6.31,2,2.1,-3.59,0.075,0.29325,TAKER
27/10/2022 08:00:00,19/06/2023 17:39:04,Upscale-DUMMY_Gemini_BTCUSD_1h_01_07_22_to_16_06_23.csv,BTC_USD,FOUR_HOUR,158.3,0.029,28/10/2022 20:00:00,29/10/2022 04:00:00,27/10/2022 12:00:00,STOP_LOSS_HIT,LONG,20621.0,20510.36,20842.28,20510.36,3.778,1.06,0.54,5.97,2,2.2,-3.66,0.075,0.44850675,TAKER
27/10/2022 12:00:00,19/06/2023 17:39:04,Upscale-DUMMY_Gemini_BTCUSD_1h_01_07_22_to_16_06_23.csv,BTC_USD,FOUR_HOUR,154.64,0.025,29/10/2022 00:00:00,29/10/2022 08:00:00,27/10/2022 20:00:00,STOP_LOSS_HIT,LONG,20567.0,20445.26,20810.48,20445.26,3.325,1.17,0.6,5.7,2,2.1,-3.43,0.075,0.3856312500000001,TAKER
11/08/2022 16:00:00,19/06/2023 17:39:04,Upscale-DUMMY_Gemini_BTCUSD_1h_01_07_22_to_16_06_23.csv,BTC_USD,FOUR_HOUR,151.21,0.026,13/08/2022 12:00:00,13/08/2022 12:00:00,11/08/2022 20:00:00,STOP_LOSS_HIT,LONG,24235.0,24120.02,24464.96,24120.02,4.167,0.94,0.48,5.51,2,2.2,-3.46,0.075,0.47258249999999996,TAKER
04/05/2023 08:00:00,19/06/2023 17:39:04,Upscale-DUMMY_Gemini_BTCUSD_1h_01_07_22_to_16_06_23.csv,BTC_USD,FOUR_HOUR,147.75,0.007,06/05/2023 04:00:00,06/05/2023 04:00:00,04/05/2023 12:00:00,STOP_LOSS_HIT,LONG,29146.0,28742.44,29953.12,28742.44,1.381,2.69,1.4,5.5,2,2.1,-2.98,0.075,0.1530165,TAKER
19/03/2023 12:00:00,19/06/2023 17:39:04,Upscale-DUMMY_Gemini_BTCUSD_1h_01_07_22_to_16_06_23.csv,BTC_USD,FOUR_HOUR,144.77,0.024,21/03/2023 12:00:00,21/03/2023 08:00:00,19/03/2023 16:00:00,STOP_LOSS_HIT,SHORT,27660.0,27779.78,27420.44,27779.78,4.585,0.87,0.43,5.25,2,2.2,-3.37,0.075,0.49788000000000004,TAKER
30/08/2022 08:00:00,19/06/2023 17:39:04,Upscale-DUMMY_Gemini_BTCUSD_1h_01_07_22_to_16_06_23.csv,BTC_USD,FOUR_HOUR,141.4,0.028,31/08/2022 16:00:00,01/09/2022 04:00:00,30/08/2022 12:00:00,STOP_LOSS_HIT,LONG,20408.0,20308.39,20607.21,20308.39,4.041,0.97,0.49,5.15,2,2.2,-3.22,0.075,0.428568,TAKER
21/01/2023 08:00:00,19/06/2023 17:39:04,Upscale-DUMMY_Gemini_BTCUSD_1h_01_07_22_to_16_06_23.csv,BTC_USD,FOUR_HOUR,138.18,0.031,21/01/2023 12:00:00,23/01/2023 04:00:00,21/01/2023 12:00:00,TAKE_PROFIT_HIT,LONG,22919.0,23096.71,23096.71,22830.15,5.142,0.77,0.39,4.98,2,2.2,4.98,0.075,0.5328667500000001,TAKER
02/12/2022 12:00:00,19/06/2023 17:39:04,Upscale-DUMMY_Gemini_BTCUSD_1h_01_07_22_to_16_06_23.csv,BTC_USD,FOUR_HOUR,143.16,0.044,04/12/2022 04:00:00,04/12/2022 08:00:00,02/12/2022 20:00:00,TAKE_PROFIT_HIT,LONG,16945.0,17073.72,17073.72,16880.64,5.208,0.75,0.38,5.1,2,2.2,5.1,0.075,0.5591849999999999,TAKER
07/07/2022 16:00:00,19/06/2023 17:39:05,Upscale-DUMMY_Gemini_BTCUSD_1h_01_07_22_to_16_06_23.csv,BTC_USD,FOUR_HOUR,148.26,0.027,09/07/2022 00:00:00,09/07/2022 12:00:00,07/07/2022 20:00:00,STOP_LOSS_HIT,LONG,21823.0,21711.11,22046.79,21711.11,3.974,1.02,0.52,5.6,2,2.2,-3.46,0.075,0.44191575,TAKER
08/02/2023 04:00:00,19/06/2023 17:39:05,Upscale-DUMMY_Gemini_BTCUSD_1h_01_07_22_to_16_06_23.csv,BTC_USD,FOUR_HOUR,144.8,0.03,08/02/2023 12:00:00,10/02/2023 00:00:00,08/02/2023 12:00:00,STOP_LOSS_HIT,LONG,23229.0,23132.51,23421.98,23132.51,4.813,0.82,0.42,5.27,2,2.2,-3.42,0.075,0.5226525,TAKER
26/04/2023 20:00:00,19/06/2023 17:39:05,Upscale-DUMMY_Gemini_BTCUSD_1h_01_07_22_to_16_06_23.csv,BTC_USD,FOUR_HOUR,141.38,0.015,27/04/2023 16:00:00,28/04/2023 16:00:00,27/04/2023 00:00:00,TAKE_PROFIT_HIT,LONG,28422.0,28787.21,28787.21,28239.4,3.015,1.27,0.65,5.16,2,2.1,5.16,0.075,0.31974749999999996,TAKER
16/02/2023 00:00:00,19/06/2023 17:39:05,Upscale-DUMMY_Gemini_BTCUSD_1h_01_07_22_to_16_06_23.csv,BTC_USD,FOUR_HOUR,146.54,0.006,16/02/2023 16:00:00,17/02/2023 20:00:00,16/02/2023 20:00:00,STOP_LOSS_HIT,LONG,24741.0,24267.96,25687.09,24267.96,1.013,3.68,1.95,5.57,2,2.0,-2.95,0.075,0.1113345,TAKER
30/04/2023 00:00:00,19/06/2023 17:39:06,Upscale-DUMMY_Gemini_BTCUSD_1h_01_07_22_to_16_06_23.csv,BTC_USD,FOUR_HOUR,143.59,0.008,01/05/2023 08:00:00,01/05/2023 20:00:00,30/04/2023 12:00:00,STOP_LOSS_HIT,SHORT,29189.0,29556.82,28453.37,29556.82,1.626,2.59,1.24,5.71,2,2.1,-3.12,0.075,0.175134,TAKER
21/03/2023 16:00:00,19/06/2023 17:39:06,Upscale-DUMMY_Gemini_BTCUSD_1h_01_07_22_to_16_06_23.csv,BTC_USD,FOUR_HOUR,140.47,0.025,23/03/2023 16:00:00,23/03/2023 12:00:00,21/03/2023 20:00:00,STOP_LOSS_HIT,LONG,28220.0,28105.71,28448.58,28105.71,5.022,0.8,0.41,5.19,2,2.2,-3.39,0.075,0.5291250000000001,TAKER
16/03/2023 20:00:00,19/06/2023 17:39:06,Upscale-DUMMY_Gemini_BTCUSD_1h_01_07_22_to_16_06_23.csv,BTC_USD,FOUR_HOUR,137.08,0.02,17/03/2023 04:00:00,18/03/2023 16:00:00,17/03/2023 00:00:00,STOP_LOSS_HIT,SHORT,25052.0,25190.02,24775.95,25190.02,3.655,1.11,0.55,5.15,2,2.2,-3.14,0.075,0.37578,TAKER
27/09/2022 04:00:00,19/06/2023 17:39:06,Upscale-DUMMY_Gemini_BTCUSD_1h_01_07_22_to_16_06_23.csv,BTC_USD,FOUR_HOUR,133.94,0.022,28/09/2022 00:00:00,29/09/2022 00:00:00,27/09/2022 12:00:00,STOP_LOSS_HIT,LONG,20185.0,20063.89,20427.22,20063.89,3.315,1.19,0.6,5.0,2,2.1,-3.0,0.075,0.33305250000000003,TAKER
21/07/2022 00:00:00,19/06/2023 17:39:06,Upscale-DUMMY_Gemini_BTCUSD_1h_01_07_22_to_16_06_23.csv,BTC_USD,FOUR_HOUR,130.94,0.014,22/07/2022 04:00:00,22/07/2022 20:00:00,21/07/2022 08:00:00,STOP_LOSS_HIT,LONG,22773.0,22589.99,23139.02,22589.99,2.435,1.58,0.81,4.89,2,2.1,-2.8,0.075,0.23911649999999998,TAKER
16/01/2023 08:00:00,19/06/2023 17:39:06,Upscale-DUMMY_Gemini_BTCUSD_1h_01_07_22_to_16_06_23.csv,BTC_USD,FOUR_HOUR,128.14,0.023,16/01/2023 16:00:00,18/01/2023 04:00:00,16/01/2023 12:00:00,STOP_LOSS_HIT,SHORT,20827.0,20937.15,20606.7,20937.15,3.738,1.07,0.53,4.71,2,2.2,-2.89,0.075,0.35926575,TAKER
18/07/2022 04:00:00,19/06/2023 17:39:07,Upscale-DUMMY_Gemini_BTCUSD_1h_01_07_22_to_16_06_23.csv,BTC_USD,FOUR_HOUR,125.25,0.024,20/07/2022 00:00:00,20/07/2022 00:00:00,18/07/2022 08:00:00,STOP_LOSS_HIT,LONG,22247.0,22142.32,22456.37,22142.32,4.263,0.93,0.47,4.62,2,2.2,-2.91,0.075,0.40044599999999997,TAKER
09/04/2023 00:00:00,19/06/2023 17:39:07,Upscale-DUMMY_Gemini_BTCUSD_1h_01_07_22_to_16_06_23.csv,BTC_USD,FOUR_HOUR,122.34,0.012,10/04/2023 08:00:00,10/04/2023 20:00:00,09/04/2023 08:00:00,STOP_LOSS_HIT,LONG,28058.0,27857.51,28458.99,27857.51,2.752,1.41,0.72,4.56,2,2.1,-2.66,0.075,0.252522,TAKER
07/07/2022 00:00:00,19/06/2023 17:39:07,Upscale-DUMMY_Gemini_BTCUSD_1h_01_07_22_to_16_06_23.csv,BTC_USD,FOUR_HOUR,119.68,0.018,08/07/2022 20:00:00,08/07/2022 20:00:00,07/07/2022 04:00:00,STOP_LOSS_HIT,LONG,20461.0,20324.88,20733.24,20324.88,3.077,1.31,0.67,4.62,2,2.1,-2.73,0.075,0.27622349999999996,TAKER
21/07/2022 00:00:00,19/06/2023 17:39:07,Upscale-DUMMY_Gemini_BTCUSD_1h_01_07_22_to_16_06_23.csv,BTC_USD,FOUR_HOUR,116.95,0.013,22/07/2022 04:00:00,22/07/2022 20:00:00,21/07/2022 08:00:00,STOP_LOSS_HIT,LONG,22773.0,22589.99,23139.02,22589.99,2.531,1.58,0.81,4.54,2,2.1,-2.6,0.075,0.22203674999999998,TAKER
02/12/2022 12:00:00,19/06/2023 17:39:07,Upscale-DUMMY_Gemini_BTCUSD_1h_01_07_22_to_16_06_23.csv,BTC_USD,FOUR_HOUR,114.35,0.036,04/12/2022 04:00:00,04/12/2022 08:00:00,02/12/2022 20:00:00,TAKE_PROFIT_HIT,LONG,16945.0,17073.72,17073.72,16880.64,5.335,0.75,0.38,4.18,2,2.2,4.18,0.075,0.457515,TAKER
26/09/2022 16:00:00,19/06/2023 17:39:08,Upscale-DUMMY_Gemini_BTCUSD_1h_01_07_22_to_16_06_23.csv,BTC_USD,FOUR_HOUR,118.53,0.013,28/09/2022 04:00:00,28/09/2022 12:00:00,27/09/2022 00:00:00,TAKE_PROFIT_HIT,LONG,19194.0,19551.79,19551.79,19015.11,2.105,1.83,0.94,4.46,2,2.1,4.46,0.075,0.1871415,TAKER
07/01/2023 00:00:00,19/06/2023 17:39:08,Upscale-DUMMY_Gemini_BTCUSD_1h_01_07_22_to_16_06_23.csv,BTC_USD,FOUR_HOUR,122.99,0.015,07/01/2023 16:00:00,08/01/2023 20:00:00,08/01/2023 20:00:00,EXPIRED,LONG,16947.0,17128.0,17285.94,16777.53,2.067,1.96,1.01,4.89,2,2.1,2.52,0.075,0.19065374999999998,TAKER
21/01/2023 04:00:00,19/06/2023 17:39:08,Upscale-DUMMY_Gemini_BTCUSD_1h_01_07_22_to_16_06_23.csv,BTC_USD,FOUR_HOUR,125.51,0.015,22/01/2023 12:00:00,23/01/2023 00:00:00,21/01/2023 08:00:00,STOP_LOSS_HIT,SHORT,22653.0,22820.78,22317.45,22820.78,2.707,1.5,0.74,4.78,2,2.1,-2.77,0.075,0.25484625,TAKER
07/06/2023 20:00:00,19/06/2023 17:39:08,Upscale-DUMMY_Gemini_BTCUSD_1h_01_07_22_to_16_06_23.csv,BTC_USD,FOUR_HOUR,122.74,0.019,08/06/2023 20:00:00,09/06/2023 16:00:00,08/06/2023 00:00:00,STOP_LOSS_HIT,LONG,26353.0,26226.39,26606.22,26226.39,4.079,0.95,0.48,4.44,2,2.2,-2.78,0.075,0.37553024999999995,TAKER
10/07/2022 00:00:00,19/06/2023 17:39:08,Upscale-DUMMY_Gemini_BTCUSD_1h_01_07_22_to_16_06_23.csv,BTC_USD,FOUR_HOUR,119.96,0.022,10/07/2022 08:00:00,11/07/2022 20:00:00,10/07/2022 08:00:00,STOP_LOSS_HIT,SHORT,21286.0,21393.74,21070.52,21393.74,3.904,1.02,0.5,4.39,2,2.2,-2.72,0.075,0.35121899999999995,TAKER
29/03/2023 16:00:00,19/06/2023 17:39:08,Upscale-DUMMY_Gemini_BTCUSD_1h_01_07_22_to_16_06_23.csv,BTC_USD,FOUR_HOUR,117.24,0.006,30/03/2023 12:00:00,31/03/2023 12:00:00,30/03/2023 00:00:00,TAKE_PROFIT_HIT,LONG,28416.0,29165.46,29165.46,28041.27,1.454,2.57,1.34,4.37,2,2.1,4.37,0.075,0.127872,TAKER
15/02/2023 00:00:00,19/06/2023 17:39:09,Upscale-DUMMY_Gemini_BTCUSD_1h_01_07_22_to_16_06_23.csv,BTC_USD,FOUR_HOUR,121.61,0.009,16/02/2023 16:00:00,16/02/2023 20:00:00,15/02/2023 12:00:00,TAKE_PROFIT_HIT,LONG,22106.0,22637.91,22637.91,21840.05,1.636,2.35,1.22,4.64,2,2.1,4.64,0.075,0.14921549999999997,TAKER
25/08/2022 00:00:00,19/06/2023 17:39:09,Upscale-DUMMY_Gemini_BTCUSD_1h_01_07_22_to_16_06_23.csv,BTC_USD,FOUR_HOUR,126.25,0.032,26/08/2022 08:00:00,26/08/2022 20:00:00,25/08/2022 04:00:00,STOP_LOSS_HIT,SHORT,21464.0,21543.61,21304.78,21543.61,5.44,0.75,0.37,4.58,2,2.3,-3.06,0.075,0.515136,TAKER
19/07/2022 04:00:00,19/06/2023 17:39:09,Upscale-DUMMY_Gemini_BTCUSD_1h_01_07_22_to_16_06_23.csv,BTC_USD,FOUR_HOUR,123.19,0.006,20/07/2022 16:00:00,21/07/2022 00:00:00,19/07/2022 12:00:00,TAKE_PROFIT_HIT,LONG,21779.0,22658.03,22658.03,21339.48,1.061,3.88,2.06,5.18,2,2.0,5.18,0.075,0.0980055,TAKER
02/12/2022 08:00:00,19/06/2023 17:39:09,Upscale-DUMMY_Gemini_BTCUSD_1h_01_07_22_to_16_06_23.csv,BTC_USD,FOUR_HOUR,128.37,0.029,04/12/2022 04:00:00,04/12/2022 04:00:00,02/12/2022 12:00:00,STOP_LOSS_HIT,LONG,17015.0,16927.24,17190.52,16927.24,3.844,1.02,0.52,4.72,2,2.2,-2.92,0.075,0.37007625,TAKER
11/08/2022 20:00:00,19/06/2023 17:39:11,Upscale-DUMMY_Gemini_BTCUSD_1h_01_07_22_to_16_06_23.csv,BTC_USD,FOUR_HOUR,125.45,0.014,13/08/2022 20:00:00,13/08/2022 16:00:00,12/08/2022 08:00:00,STOP_LOSS_HIT,LONG,23960.0,23784.33,24311.35,23784.33,2.674,1.45,0.74,4.67,2,2.1,-2.71,0.075,0.25157999999999997,TAKER
19/07/2022 16:00:00,19/06/2023 17:39:11,Upscale-DUMMY_Gemini_BTCUSD_1h_01_07_22_to_16_06_23.csv,BTC_USD,FOUR_HOUR,122.74,0.008,20/07/2022 12:00:00,21/07/2022 12:00:00,20/07/2022 00:00:00,STOP_LOSS_HIT,LONG,23409.0,23103.87,24019.27,23103.87,1.526,2.54,1.32,4.74,2,2.1,-2.58,0.075,0.140454,TAKER
18/03/2023 12:00:00,19/06/2023 17:39:11,Upscale-DUMMY_Gemini_BTCUSD_1h_01_07_22_to_16_06_23.csv,BTC_USD,FOUR_HOUR,120.16,0.022,20/03/2023 04:00:00,20/03/2023 08:00:00,18/03/2023 16:00:00,STOP_LOSS_HIT,SHORT,27334.0,27444.33,27113.34,27444.33,5.005,0.81,0.4,4.4,2,2.2,-2.88,0.075,0.45101099999999994,TAKER
11/04/2023 00:00:00,19/06/2023 17:39:11,Upscale-DUMMY_Gemini_BTCUSD_1h_01_07_22_to_16_06_23.csv,BTC_USD,FOUR_HOUR,117.28,0.005,11/04/2023 12:00:00,12/04/2023 20:00:00,12/04/2023 20:00:00,EXPIRED,LONG,30127.0,29903.0,31072.09,29654.46,1.284,3.04,1.59,4.61,2,2.0,-1.23,0.075,0.11297624999999999,TAKER
16/01/2023 08:00:00,19/06/2023 17:39:11,Upscale-DUMMY_Gemini_BTCUSD_1h_01_07_22_to_16_06_23.csv,BTC_USD,FOUR_HOUR,116.05,0.021,16/01/2023 16:00:00,18/01/2023 04:00:00,16/01/2023 12:00:00,STOP_LOSS_HIT,SHORT,20827.0,20937.15,20606.7,20937.15,3.769,1.07,0.53,4.3,2,2.2,-2.64,0.075,0.32802525000000005,TAKER
18/07/2022 16:00:00,19/06/2023 17:39:11,Upscale-DUMMY_Gemini_BTCUSD_1h_01_07_22_to_16_06_23.csv,BTC_USD,FOUR_HOUR,113.41,0.007,19/07/2022 08:00:00,20/07/2022 12:00:00,18/07/2022 20:00:00,TAKE_PROFIT_HIT,LONG,21615.0,22224.05,22224.05,21310.48,1.334,2.74,1.43,4.15,2,2.1,4.15,0.075,0.11347875,TAKER
12/08/2022 00:00:00,19/06/2023 17:39:11,Upscale-DUMMY_Gemini_BTCUSD_1h_01_07_22_to_16_06_23.csv,BTC_USD,FOUR_HOUR,117.56,0.013,13/08/2022 08:00:00,13/08/2022 20:00:00,12/08/2022 08:00:00,TAKE_PROFIT_HIT,SHORT,24031.0,23665.61,23665.61,24213.7,2.657,1.54,0.75,4.52,2,2.1,4.52,0.075,0.23430224999999996,TAKER
13/12/2022 20:00:00,19/06/2023 17:39:11,Upscale-DUMMY_Gemini_BTCUSD_1h_01_07_22_to_16_06_23.csv,BTC_USD,FOUR_HOUR,122.08,0.02,15/12/2022 04:00:00,15/12/2022 16:00:00,14/12/2022 12:00:00,STOP_LOSS_HIT,SHORT,17776.0,17898.45,17531.1,17898.45,2.912,1.4,0.68,4.63,2,2.1,-2.72,0.075,0.26664,TAKER
12/08/2022 04:00:00,19/06/2023 17:39:12,Upscale-DUMMY_Gemini_BTCUSD_1h_01_07_22_to_16_06_23.csv,BTC_USD,FOUR_HOUR,119.36,0.018,13/08/2022 12:00:00,14/08/2022 00:00:00,12/08/2022 08:00:00,STOP_LOSS_HIT,SHORT,23969.0,24101.75,23703.5,24101.75,3.615,1.12,0.55,4.46,2,2.2,-2.71,0.075,0.32358149999999997,TAKER
28/09/2022 00:00:00,19/06/2023 17:39:12,Upscale-DUMMY_Gemini_BTCUSD_1h_01_07_22_to_16_06_23.csv,BTC_USD,FOUR_HOUR,116.65,0.02,28/09/2022 04:00:00,29/09/2022 20:00:00,28/09/2022 04:00:00,STOP_LOSS_HIT,SHORT,18748.0,18865.99,18512.01,18865.99,3.214,1.27,0.63,4.44,2,2.1,-2.64,0.075,0.28121999999999997,TAKER
31/08/2022 08:00:00,19/06/2023 17:39:12,Upscale-DUMMY_Gemini_BTCUSD_1h_01_07_22_to_16_06_23.csv,BTC_USD,FOUR_HOUR,114.01,0.011,02/09/2022 08:00:00,02/09/2022 04:00:00,31/08/2022 12:00:00,TAKE_PROFIT_HIT,SHORT,20323.0,19910.02,19910.02,20529.49,1.961,2.07,1.01,4.38,2,2.1,4.38,0.075,0.16766475,TAKER
18/05/2023 20:00:00,19/06/2023 17:39:13,Upscale-DUMMY_Gemini_BTCUSD_1h_01_07_22_to_16_06_23.csv,BTC_USD,FOUR_HOUR,118.39,0.02,19/05/2023 20:00:00,20/05/2023 16:00:00,19/05/2023 12:00:00,STOP_LOSS_HIT,LONG,26831.0,26712.94,27067.11,26712.94,4.533,0.87,0.44,4.32,2,2.2,-2.76,0.075,0.40246499999999996,TAKER
29/03/2023 20:00:00,19/06/2023 17:39:13,Upscale-DUMMY_Gemini_BTCUSD_1h_01_07_22_to_16_06_23.csv,BTC_USD,FOUR_HOUR,115.63,0.007,30/03/2023 16:00:00,31/03/2023 16:00:00,30/03/2023 00:00:00,TAKE_PROFIT_HIT,LONG,28326.0,28984.74,28984.74,27996.63,1.715,2.27,1.18,4.46,2,2.1,4.46,0.075,0.1487115,TAKER
16/01/2023 20:00:00,19/06/2023 17:39:13,Upscale-DUMMY_Gemini_BTCUSD_1h_01_07_22_to_16_06_23.csv,BTC_USD,FOUR_HOUR,120.09,0.015,18/01/2023 08:00:00,18/01/2023 16:00:00,17/01/2023 00:00:00,STOP_LOSS_HIT,LONG,21192.0,21035.54,21504.93,21035.54,2.647,1.46,0.74,4.46,2,2.1,-2.59,0.075,0.23840999999999998,TAKER
05/05/2023 16:00:00,19/06/2023 17:39:13,Upscale-DUMMY_Gemini_BTCUSD_1h_01_07_22_to_16_06_23.csv,BTC_USD,FOUR_HOUR,117.5,0.011,07/05/2023 00:00:00,07/05/2023 12:00:00,06/05/2023 04:00:00,STOP_LOSS_HIT,LONG,29551.0,29337.16,29978.68,29337.16,2.766,1.43,0.73,4.46,2,2.1,-2.6,0.075,0.24379574999999998,TAKER
30/04/2023 16:00:00,19/06/2023 17:39:14,Upscale-DUMMY_Gemini_BTCUSD_1h_01_07_22_to_16_06_23.csv,BTC_USD,FOUR_HOUR,114.9,0.008,02/05/2023 12:00:00,02/05/2023 12:00:00,01/05/2023 00:00:00,STOP_LOSS_HIT,LONG,29380.0,29076.79,29986.41,29076.79,2.046,2.02,1.04,4.67,2,2.1,-2.6,0.075,0.17628,TAKER
10/07/2022 12:00:00,19/06/2023 17:39:14,Upscale-DUMMY_Gemini_BTCUSD_1h_01_07_22_to_16_06_23.csv,BTC_USD,FOUR_HOUR,112.3,0.008,12/07/2022 08:00:00,12/07/2022 08:00:00,11/07/2022 00:00:00,STOP_LOSS_HIT,LONG,20895.0,20597.73,21489.54,20597.73,1.489,2.77,1.44,4.63,2,2.1,-2.5,0.075,0.12536999999999998,TAKER
11/09/2022 16:00:00,19/06/2023 17:39:15,Upscale-DUMMY_Gemini_BTCUSD_1h_01_07_22_to_16_06_23.csv,BTC_USD,FOUR_HOUR,109.8,0.013,13/09/2022 16:00:00,13/09/2022 12:00:00,12/09/2022 00:00:00,TAKE_PROFIT_HIT,LONG,21631.0,21974.98,21974.98,21459.01,2.561,1.57,0.8,4.26,2,2.1,4.26,0.075,0.21090224999999996,TAKER
05/12/2022 12:00:00,19/06/2023 17:39:15,Upscale-DUMMY_Gemini_BTCUSD_1h_01_07_22_to_16_06_23.csv,BTC_USD,FOUR_HOUR,114.06,0.006,06/12/2022 08:00:00,07/12/2022 08:00:00,07/12/2022 08:00:00,STOP_LOSS_HIT,LONG,17086.0,16728.64,17800.71,16728.64,0.899,4.02,2.14,4.21,2,2.0,-2.22,0.075,0.076887,TAKER
13/03/2023 04:00:00,19/06/2023 17:39:17,Upscale-DUMMY_Gemini_BTCUSD_1h_01_07_22_to_16_06_23.csv,BTC_USD,FOUR_HOUR,111.84,0.012,14/03/2023 12:00:00,15/03/2023 00:00:00,13/03/2023 08:00:00,TAKE_PROFIT_HIT,SHORT,22623.0,22264.32,22264.32,22802.34,2.427,1.61,0.79,4.1,2,2.1,4.1,0.075,0.20360699999999998,TAKER
25/08/2022 08:00:00,19/06/2023 17:39:17,Upscale-DUMMY_Gemini_BTCUSD_1h_01_07_22_to_16_06_23.csv,BTC_USD,FOUR_HOUR,115.94,0.016,27/08/2022 00:00:00,27/08/2022 04:00:00,25/08/2022 12:00:00,STOP_LOSS_HIT,LONG,21725.0,21578.48,22018.04,21578.48,2.998,1.33,0.68,4.43,2,2.1,-2.61,0.075,0.2607,TAKER
13/08/2022 08:00:00,19/06/2023 17:39:17,Upscale-DUMMY_Gemini_BTCUSD_1h_01_07_22_to_16_06_23.csv,BTC_USD,FOUR_HOUR,113.33,0.016,13/08/2022 16:00:00,15/08/2022 04:00:00,13/08/2022 16:00:00,TAKE_PROFIT_HIT,LONG,24453.0,24744.18,24744.18,24307.41,3.452,1.18,0.6,4.37,2,2.1,4.37,0.075,0.293436,TAKER
14/02/2023 20:00:00,19/06/2023 17:39:17,Upscale-DUMMY_Gemini_BTCUSD_1h_01_07_22_to_16_06_23.csv,BTC_USD,FOUR_HOUR,117.7,0.011,15/02/2023 12:00:00,16/02/2023 16:00:00,15/02/2023 12:00:00,TAKE_PROFIT_HIT,LONG,22214.0,22641.02,22641.02,22000.49,2.076,1.89,0.97,4.51,2,2.1,4.51,0.075,0.18326549999999997,TAKER
18/03/2023 12:00:00,19/06/2023 17:39:18,Upscale-DUMMY_Gemini_BTCUSD_1h_01_07_22_to_16_06_23.csv,BTC_USD,FOUR_HOUR,122.21,0.022,20/03/2023 04:00:00,20/03/2023 08:00:00,18/03/2023 16:00:00,STOP_LOSS_HIT,SHORT,27334.0,27444.33,27113.34,27444.33,4.921,0.81,0.4,4.4,2,2.2,-2.88,0.075,0.45101099999999994,TAKER
06/11/2022 12:00:00,19/06/2023 17:39:18,Upscale-DUMMY_Gemini_BTCUSD_1h_01_07_22_to_16_06_23.csv,BTC_USD,FOUR_HOUR,119.33,0.008,08/11/2022 08:00:00,08/11/2022 08:00:00,06/11/2022 20:00:00,STOP_LOSS_HIT,LONG,21248.0,20961.15,21821.7,20961.15,1.424,2.63,1.37,4.46,2,2.1,-2.42,0.075,0.12748800000000002,TAKER
14/07/2022 20:00:00,19/06/2023 17:39:18,Upscale-DUMMY_Gemini_BTCUSD_1h_01_07_22_to_16_06_23.csv,BTC_USD,FOUR_HOUR,116.91,0.023,16/07/2022 04:00:00,16/07/2022 16:00:00,15/07/2022 00:00:00,STOP_LOSS_HIT,LONG,20578.0,20477.57,20778.87,20477.57,4.048,0.97,0.49,4.27,2,2.2,-2.66,0.075,0.35497049999999997,TAKER
17/10/2022 20:00:00,19/06/2023 17:39:18,Upscale-DUMMY_Gemini_BTCUSD_1h_01_07_22_to_16_06_23.csv,BTC_USD,FOUR_HOUR,114.25,0.014,18/10/2022 08:00:00,19/10/2022 16:00:00,18/10/2022 12:00:00,STOP_LOSS_HIT,LONG,19554.0,19389.75,19882.51,19389.75,2.396,1.65,0.85,4.39,2,2.1,-2.5,0.075,0.205317,TAKER
29/07/2022 16:00:00,19/06/2023 17:39:18,Upscale-DUMMY_Gemini_BTCUSD_1h_01_07_22_to_16_06_23.csv,BTC_USD,FOUR_HOUR,111.75,0.014,30/07/2022 08:00:00,31/07/2022 12:00:00,29/07/2022 20:00:00,STOP_LOSS_HIT,LONG,23903.0,23744.14,24220.73,23744.14,2.995,1.31,0.67,4.2,2,2.1,-2.48,0.075,0.2509815,TAKER
18/04/2023 12:00:00,19/06/2023 17:39:19,Upscale-DUMMY_Gemini_BTCUSD_1h_01_07_22_to_16_06_23.csv,BTC_USD,FOUR_HOUR,109.27,0.02,19/04/2023 20:00:00,20/04/2023 08:00:00,18/04/2023 16:00:00,STOP_LOSS_HIT,LONG,30198.0,30088.24,30417.52,30088.24,5.527,0.72,0.36,3.94,2,2.3,-2.65,0.075,0.45297000000000004,TAKER
05/12/2022 12:00:00,19/06/2023 17:39:19,Upscale-DUMMY_Gemini_BTCUSD_1h_01_07_22_to_16_06_23.csv,BTC_USD,FOUR_HOUR,106.62,0.006,06/12/2022 08:00:00,07/12/2022 08:00:00,07/12/2022 08:00:00,STOP_LOSS_HIT,LONG,17086.0,16728.64,17800.71,16728.64,0.962,4.02,2.14,4.21,2,2.0,-2.22,0.075,0.076887,TAKER
22/03/2023 12:00:00,19/06/2023 17:39:20,Upscale-DUMMY_Gemini_BTCUSD_1h_01_07_22_to_16_06_23.csv,BTC_USD,FOUR_HOUR,104.4,0.01,24/03/2023 00:00:00,24/03/2023 08:00:00,22/03/2023 16:00:00,STOP_LOSS_HIT,LONG,28665.0,28458.61,29077.78,28458.61,2.746,1.42,0.73,3.91,2,2.1,-2.28,0.075,0.2149875,TAKER
21/03/2023 08:00:00,19/06/2023 17:39:20,Upscale-DUMMY_Gemini_BTCUSD_1h_01_07_22_to_16_06_23.csv,BTC_USD,FOUR_HOUR,102.12,0.016,21/03/2023 20:00:00,23/03/2023 04:00:00,21/03/2023 12:00:00,STOP_LOSS_HIT,LONG,28139.0,28014.32,28388.36,28014.32,4.409,0.88,0.45,3.65,2,2.2,-2.33,0.075,0.33766799999999997,TAKER
