Open,Last update,Platform,Symbol,Timeframe,Account balance at open,Size,Expected close,Expiry,Close,Status,Side,Opening price,Closing price,Take profit,Stop loss,Leverage,TP price %,SL price %,Expected profit,Risk %,R/R ratio,PnL,Fee %,Fee Amount,Order Type
27/01/2023 00:00:00,18/06/2023 13:26:52,Upscale-Upscale-DUMMY_Gemini_BTCUSD_1h_01_07_22_to_16_06_23.csv,BTC_USD,WEEK,200.0,0.0,24/03/2023 00:00:00,17/03/2023 00:00:00,17/03/2023 00:00:00,EXPIRED,LONG,23487.0,28351.0,34972.35,12001.65,0.0,32.84,95.7,0.0,0,0.0,0.0,0.075,0.0,TAKER
20/01/2023 00:00:00,18/06/2023 13:26:52,Upscale-Upscale-DUMMY_Gemini_BTCUSD_1h_01_07_22_to_16_06_23.csv,BTC_USD,WEEK,200.0,0.001,17/03/2023 00:00:00,10/03/2023 00:00:00,10/03/2023 00:00:00,EXPIRED,LONG,23013.0,25052.0,27602.55,18423.45,0.115,16.63,24.91,4.57,2,1.0,2.02,0.075,0.01725975,TAKER
24/03/2023 00:00:00,18/06/2023 13:26:52,Upscale-Upscale-DUMMY_Gemini_BTCUSD_1h_01_07_22_to_16_06_23.csv,BTC_USD,WEEK,202.02,0.0,19/05/2023 00:00:00,12/05/2023 00:00:00,12/05/2023 00:00:00,EXPIRED,LONG,27941.0,26831.0,40815.86,15066.14,0.0,31.54,85.46,0.0,0,0.0,0.0,0.075,0.0,TAKER
20/01/2023 00:00:00,18/06/2023 13:26:52,Upscale-Upscale-DUMMY_Gemini_BTCUSD_1h_01_07_22_to_16_06_23.csv,BTC_USD,WEEK,202.02,0.001,17/03/2023 00:00:00,10/03/2023 00:00:00,10/03/2023 00:00:00,EXPIRED,LONG,23013.0,25052.0,27602.55,18423.45,0.114,16.63,24.91,4.57,2,1.0,2.02,0.075,0.01725975,TAKER
03/03/2023 00:00:00,18/06/2023 13:26:52,Upscale-Upscale-DUMMY_Gemini_BTCUSD_1h_01_07_22_to_16_06_23.csv,BTC_USD,WEEK,204.04,0.003,21/04/2023 00:00:00,21/04/2023 00:00:00,10/03/2023 00:00:00,STOP_LOSS_HIT,SHORT,20290.0,21899.78,18680.22,21899.78,0.298,8.62,7.35,4.78,2,1.0,-4.87,0.075,0.0456525,TAKER
17/02/2023 00:00:00,18/06/2023 13:26:52,Upscale-Upscale-DUMMY_Gemini_BTCUSD_1h_01_07_22_to_16_06_23.csv,BTC_USD,WEEK,199.17,0.002,31/03/2023 00:00:00,07/04/2023 00:00:00,03/03/2023 00:00:00,TAKE_PROFIT_HIT,SHORT,23948.0,22334.58,22334.58,25561.42,0.24,7.22,6.31,3.19,2,1.0,3.19,0.075,0.035922,TAKER
17/02/2023 00:00:00,18/06/2023 13:26:52,Upscale-Upscale-DUMMY_Gemini_BTCUSD_1h_01_07_22_to_16_06_23.csv,BTC_USD,WEEK,202.36,0.003,31/03/2023 00:00:00,07/04/2023 00:00:00,03/03/2023 00:00:00,TAKE_PROFIT_HIT,SHORT,23948.0,22334.58,22334.58,25561.42,0.355,7.22,6.31,4.79,2,1.0,4.79,0.075,0.053883,TAKER
27/01/2023 00:00:00,18/06/2023 13:26:52,Upscale-Upscale-DUMMY_Gemini_BTCUSD_1h_01_07_22_to_16_06_23.csv,BTC_USD,WEEK,207.15,0.0,24/03/2023 00:00:00,17/03/2023 00:00:00,17/03/2023 00:00:00,EXPIRED,LONG,23487.0,28351.0,34972.35,12001.65,0.0,32.84,95.7,0.0,0,0.0,0.0,0.075,0.0,TAKER
03/03/2023 00:00:00,18/06/2023 13:26:52,Upscale-Upscale-DUMMY_Gemini_BTCUSD_1h_01_07_22_to_16_06_23.csv,BTC_USD,WEEK,207.15,0.003,21/04/2023 00:00:00,21/04/2023 00:00:00,10/03/2023 00:00:00,STOP_LOSS_HIT,SHORT,20290.0,21899.78,18680.22,21899.78,0.294,8.62,7.35,4.78,2,1.0,-4.87,0.075,0.0456525,TAKER
03/03/2023 00:00:00,18/06/2023 13:26:52,Upscale-Upscale-DUMMY_Gemini_BTCUSD_1h_01_07_22_to_16_06_23.csv,BTC_USD,WEEK,202.28,0.003,21/04/2023 00:00:00,21/04/2023 00:00:00,10/03/2023 00:00:00,STOP_LOSS_HIT,SHORT,20290.0,21899.78,18680.22,21899.78,0.301,8.62,7.35,4.78,2,1.0,-4.87,0.075,0.0456525,TAKER
17/02/2023 00:00:00,18/06/2023 13:26:52,Upscale-Upscale-DUMMY_Gemini_BTCUSD_1h_01_07_22_to_16_06_23.csv,BTC_USD,WEEK,197.41,0.002,31/03/2023 00:00:00,07/04/2023 00:00:00,03/03/2023 00:00:00,TAKE_PROFIT_HIT,SHORT,23948.0,22334.58,22334.58,25561.42,0.243,7.22,6.31,3.19,2,1.0,3.19,0.075,0.035922,TAKER
17/02/2023 00:00:00,18/06/2023 13:26:52,Upscale-Upscale-DUMMY_Gemini_BTCUSD_1h_01_07_22_to_16_06_23.csv,BTC_USD,WEEK,200.6,0.002,31/03/2023 00:00:00,07/04/2023 00:00:00,03/03/2023 00:00:00,TAKE_PROFIT_HIT,SHORT,23948.0,22334.58,22334.58,25561.42,0.239,7.22,6.31,3.19,2,1.0,3.19,0.075,0.035922,TAKER
27/01/2023 00:00:00,18/06/2023 13:26:52,Upscale-Upscale-DUMMY_Gemini_BTCUSD_1h_01_07_22_to_16_06_23.csv,BTC_USD,WEEK,203.79,0.0,24/03/2023 00:00:00,17/03/2023 00:00:00,17/03/2023 00:00:00,EXPIRED,LONG,23487.0,28351.0,34972.35,12001.65,0.0,32.84,95.7,0.0,0,0.0,0.0,0.075,0.0,TAKER
20/01/2023 00:00:00,18/06/2023 13:26:52,Upscale-Upscale-DUMMY_Gemini_BTCUSD_1h_01_07_22_to_16_06_23.csv,BTC_USD,WEEK,203.79,0.001,17/03/2023 00:00:00,10/03/2023 00:00:00,10/03/2023 00:00:00,EXPIRED,LONG,23013.0,25052.0,27602.55,18423.45,0.113,16.63,24.91,4.57,2,1.0,2.02,0.075,0.01725975,TAKER
20/01/2023 00:00:00,18/06/2023 13:26:52,Upscale-Upscale-DUMMY_Gemini_BTCUSD_1h_01_07_22_to_16_06_23.csv,BTC_USD,WEEK,205.81,0.001,17/03/2023 00:00:00,10/03/2023 00:00:00,10/03/2023 00:00:00,EXPIRED,LONG,23013.0,25052.0,27602.55,18423.45,0.112,16.63,24.91,4.57,2,1.0,2.02,0.075,0.01725975,TAKER
20/01/2023 00:00:00,18/06/2023 13:26:52,Upscale-Upscale-DUMMY_Gemini_BTCUSD_1h_01_07_22_to_16_06_23.csv,BTC_USD,WEEK,207.83,0.001,17/03/2023 00:00:00,10/03/2023 00:00:00,10/03/2023 00:00:00,EXPIRED,LONG,23013.0,25052.0,27602.55,18423.45,0.111,16.63,24.91,4.57,2,1.0,2.02,0.075,0.01725975,TAKER
17/02/2023 00:00:00,18/06/2023 13:26:52,Upscale-Upscale-DUMMY_Gemini_BTCUSD_1h_01_07_22_to_16_06_23.csv,BTC_USD,WEEK,209.85,0.003,31/03/2023 00:00:00,07/04/2023 00:00:00,03/03/2023 00:00:00,TAKE_PROFIT_HIT,SHORT,23948.0,22334.58,22334.58,25561.42,0.342,7.22,6.31,4.79,2,1.0,4.79,0.075,0.053883,TAKER
24/03/2023 00:00:00,18/06/2023 13:26:52,Upscale-Upscale-DUMMY_Gemini_BTCUSD_1h_01_07_22_to_16_06_23.csv,BTC_USD,WEEK,214.64,0.0,19/05/2023 00:00:00,12/05/2023 00:00:00,12/05/2023 00:00:00,EXPIRED,LONG,27941.0,26831.0,40815.86,15066.14,0.0,31.54,85.46,0.0,0,0.0,0.0,0.075,0.0,TAKER
20/01/2023 00:00:00,18/06/2023 13:26:52,Upscale-Upscale-DUMMY_Gemini_BTCUSD_1h_01_07_22_to_16_06_23.csv,BTC_USD,WEEK,214.64,0.001,17/03/2023 00:00:00,10/03/2023 00:00:00,10/03/2023 00:00:00,EXPIRED,LONG,23013.0,25052.0,27602.55,18423.45,0.107,16.63,24.91,4.57,2,1.0,2.02,0.075,0.01725975,TAKER
27/01/2023 00:00:00,18/06/2023 13:26:52,Upscale-Upscale-DUMMY_Gemini_BTCUSD_1h_01_07_22_to_16_06_23.csv,BTC_USD,WEEK,216.66,0.0,24/03/2023 00:00:00,17/03/2023 00:00:00,17/03/2023 00:00:00,EXPIRED,LONG,23487.0,28351.0,34972.35,12001.65,0.0,32.84,95.7,0.0,0,0.0,0.0,0.075,0.0,TAKER
17/02/2023 00:00:00,18/06/2023 13:26:52,Upscale-Upscale-DUMMY_Gemini_BTCUSD_1h_01_07_22_to_16_06_23.csv,BTC_USD,WEEK,216.66,0.003,31/03/2023 00:00:00,07/04/2023 00:00:00,03/03/2023 00:00:00,TAKE_PROFIT_HIT,SHORT,23948.0,22334.58,22334.58,25561.42,0.332,7.22,6.31,4.79,2,1.0,4.79,0.075,0.053883,TAKER
24/03/2023 00:00:00,18/06/2023 13:26:52,Upscale-Upscale-DUMMY_Gemini_BTCUSD_1h_01_07_22_to_16_06_23.csv,BTC_USD,WEEK,221.45,0.0,19/05/2023 00:00:00,12/05/2023 00:00:00,12/05/2023 00:00:00,EXPIRED,LONG,27941.0,26831.0,40815.86,15066.14,0.0,31.54,85.46,0.0,0,0.0,0.0,0.075,0.0,TAKER
17/02/2023 00:00:00,18/06/2023 13:26:52,Upscale-Upscale-DUMMY_Gemini_BTCUSD_1h_01_07_22_to_16_06_23.csv,BTC_USD,WEEK,221.45,0.003,31/03/2023 00:00:00,07/04/2023 00:00:00,03/03/2023 00:00:00,TAKE_PROFIT_HIT,SHORT,23948.0,22334.58,22334.58,25561.42,0.324,7.22,6.31,4.79,2,1.0,4.79,0.075,0.053883,TAKER
20/01/2023 00:00:00,18/06/2023 13:26:52,Upscale-Upscale-DUMMY_Gemini_BTCUSD_1h_01_07_22_to_16_06_23.csv,BTC_USD,WEEK,226.24,0.001,17/03/2023 00:00:00,10/03/2023 00:00:00,10/03/2023 00:00:00,EXPIRED,LONG,23013.0,25052.0,27602.55,18423.45,0.102,16.63,24.91,4.57,2,1.0,2.02,0.075,0.01725975,TAKER
27/01/2023 00:00:00,18/06/2023 13:26:52,Upscale-Upscale-DUMMY_Gemini_BTCUSD_1h_01_07_22_to_16_06_23.csv,BTC_USD,WEEK,228.26,0.0,24/03/2023 00:00:00,17/03/2023 00:00:00,17/03/2023 00:00:00,EXPIRED,LONG,23487.0,28351.0,34972.35,12001.65,0.0,32.84,95.7,0.0,0,0.0,0.0,0.075,0.0,TAKER
27/01/2023 00:00:00,18/06/2023 13:26:52,Upscale-Upscale-DUMMY_Gemini_BTCUSD_1h_01_07_22_to_16_06_23.csv,BTC_USD,WEEK,228.26,0.0,24/03/2023 00:00:00,17/03/2023 00:00:00,17/03/2023 00:00:00,EXPIRED,LONG,23487.0,28351.0,34972.35,12001.65,0.0,32.84,95.7,0.0,0,0.0,0.0,0.075,0.0,TAKER
24/02/2023 00:00:00,18/06/2023 13:26:52,Upscale-Upscale-DUMMY_Gemini_BTCUSD_1h_01_07_22_to_16_06_23.csv,BTC_USD,WEEK,228.26,0.002,21/04/2023 00:00:00,14/04/2023 00:00:00,03/03/2023 00:00:00,TAKE_PROFIT_HIT,SHORT,23468.0,20996.18,20996.18,25939.82,0.206,11.77,9.53,4.91,2,1.0,4.91,0.075,0.035202,TAKER
17/02/2023 00:00:00,18/06/2023 13:26:52,Upscale-Upscale-DUMMY_Gemini_BTCUSD_1h_01_07_22_to_16_06_23.csv,BTC_USD,WEEK,233.17,0.003,31/03/2023 00:00:00,07/04/2023 00:00:00,03/03/2023 00:00:00,TAKE_PROFIT_HIT,SHORT,23948.0,22334.58,22334.58,25561.42,0.308,7.22,6.31,4.79,2,1.0,4.79,0.075,0.053883,TAKER
17/02/2023 00:00:00,18/06/2023 13:26:52,Upscale-Upscale-DUMMY_Gemini_BTCUSD_1h_01_07_22_to_16_06_23.csv,BTC_USD,WEEK,237.96,0.003,31/03/2023 00:00:00,07/04/2023 00:00:00,03/03/2023 00:00:00,TAKE_PROFIT_HIT,SHORT,23948.0,22334.58,22334.58,25561.42,0.302,7.22,6.31,4.79,2,1.0,4.79,0.075,0.053883,TAKER
03/03/2023 00:00:00,18/06/2023 13:26:52,Upscale-Upscale-DUMMY_Gemini_BTCUSD_1h_01_07_22_to_16_06_23.csv,BTC_USD,WEEK,242.75,0.003,21/04/2023 00:00:00,21/04/2023 00:00:00,10/03/2023 00:00:00,STOP_LOSS_HIT,SHORT,20290.0,21899.78,18680.22,21899.78,0.251,8.62,7.35,4.78,2,1.0,-4.87,0.075,0.0456525,TAKER
17/02/2023 00:00:00,18/06/2023 13:26:52,Upscale-Upscale-DUMMY_Gemini_BTCUSD_1h_01_07_22_to_16_06_23.csv,BTC_USD,WEEK,237.88,0.003,31/03/2023 00:00:00,07/04/2023 00:00:00,03/03/2023 00:00:00,TAKE_PROFIT_HIT,SHORT,23948.0,22334.58,22334.58,25561.42,0.302,7.22,6.31,4.79,2,1.0,4.79,0.075,0.053883,TAKER
17/02/2023 00:00:00,18/06/2023 13:26:52,Upscale-Upscale-DUMMY_Gemini_BTCUSD_1h_01_07_22_to_16_06_23.csv,BTC_USD,WEEK,242.67,0.003,31/03/2023 00:00:00,07/04/2023 00:00:00,03/03/2023 00:00:00,TAKE_PROFIT_HIT,SHORT,23948.0,22334.58,22334.58,25561.42,0.296,7.22,6.31,4.79,2,1.0,4.79,0.075,0.053883,TAKER
24/03/2023 00:00:00,18/06/2023 13:26:52,Upscale-Upscale-DUMMY_Gemini_BTCUSD_1h_01_07_22_to_16_06_23.csv,BTC_USD,WEEK,247.46,0.0,19/05/2023 00:00:00,12/05/2023 00:00:00,12/05/2023 00:00:00,EXPIRED,LONG,27941.0,26831.0,40815.86,15066.14,0.0,31.54,85.46,0.0,0,0.0,0.0,0.075,0.0,TAKER
17/02/2023 00:00:00,18/06/2023 13:26:52,Upscale-Upscale-DUMMY_Gemini_BTCUSD_1h_01_07_22_to_16_06_23.csv,BTC_USD,WEEK,247.46,0.003,31/03/2023 00:00:00,07/04/2023 00:00:00,03/03/2023 00:00:00,TAKE_PROFIT_HIT,SHORT,23948.0,22334.58,22334.58,25561.42,0.29,7.22,6.31,4.79,2,1.0,4.79,0.075,0.053883,TAKER
17/02/2023 00:00:00,18/06/2023 13:26:52,Upscale-Upscale-DUMMY_Gemini_BTCUSD_1h_01_07_22_to_16_06_23.csv,BTC_USD,WEEK,252.25,0.003,31/03/2023 00:00:00,07/04/2023 00:00:00,03/03/2023 00:00:00,TAKE_PROFIT_HIT,SHORT,23948.0,22334.58,22334.58,25561.42,0.285,7.22,6.31,4.79,2,1.0,4.79,0.075,0.053883,TAKER
27/01/2023 00:00:00,18/06/2023 13:26:52,Upscale-Upscale-DUMMY_Gemini_BTCUSD_1h_01_07_22_to_16_06_23.csv,BTC_USD,WEEK,257.04,0.0,24/03/2023 00:00:00,17/03/2023 00:00:00,17/03/2023 00:00:00,EXPIRED,LONG,23487.0,28351.0,34972.35,12001.65,0.0,32.84,95.7,0.0,0,0.0,0.0,0.075,0.0,TAKER
27/01/2023 00:00:00,18/06/2023 13:26:52,Upscale-Upscale-DUMMY_Gemini_BTCUSD_1h_01_07_22_to_16_06_23.csv,BTC_USD,WEEK,257.04,0.0,24/03/2023 00:00:00,17/03/2023 00:00:00,17/03/2023 00:00:00,EXPIRED,LONG,23487.0,28351.0,34972.35,12001.65,0.0,32.84,95.7,0.0,0,0.0,0.0,0.075,0.0,TAKER
27/01/2023 00:00:00,18/06/2023 13:26:52,Upscale-Upscale-DUMMY_Gemini_BTCUSD_1h_01_07_22_to_16_06_23.csv,BTC_USD,WEEK,257.04,0.0,24/03/2023 00:00:00,17/03/2023 00:00:00,17/03/2023 00:00:00,EXPIRED,LONG,23487.0,28351.0,34972.35,12001.65,0.0,32.84,95.7,0.0,0,0.0,0.0,0.075,0.0,TAKER
24/02/2023 00:00:00,18/06/2023 13:26:52,Upscale-Upscale-DUMMY_Gemini_BTCUSD_1h_01_07_22_to_16_06_23.csv,BTC_USD,WEEK,257.04,0.002,21/04/2023 00:00:00,14/04/2023 00:00:00,03/03/2023 00:00:00,TAKE_PROFIT_HIT,SHORT,23468.0,20996.18,20996.18,25939.82,0.183,11.77,9.53,4.91,2,1.0,4.91,0.075,0.035202,TAKER
24/03/2023 00:00:00,18/06/2023 13:26:52,Upscale-Upscale-DUMMY_Gemini_BTCUSD_1h_01_07_22_to_16_06_23.csv,BTC_USD,WEEK,261.95,0.0,19/05/2023 00:00:00,12/05/2023 00:00:00,12/05/2023 00:00:00,EXPIRED,LONG,27941.0,26831.0,40815.86,15066.14,0.0,31.54,85.46,0.0,0,0.0,0.0,0.075,0.0,TAKER
24/02/2023 00:00:00,18/06/2023 13:26:52,Upscale-Upscale-DUMMY_Gemini_BTCUSD_1h_01_07_22_to_16_06_23.csv,BTC_USD,WEEK,261.95,0.002,21/04/2023 00:00:00,14/04/2023 00:00:00,03/03/2023 00:00:00,TAKE_PROFIT_HIT,SHORT,23468.0,20996.18,20996.18,25939.82,0.179,11.77,9.53,4.91,2,1.0,4.91,0.075,0.035202,TAKER
20/01/2023 00:00:00,18/06/2023 13:26:52,Upscale-Upscale-DUMMY_Gemini_BTCUSD_1h_01_07_22_to_16_06_23.csv,BTC_USD,WEEK,266.86,0.001,17/03/2023 00:00:00,10/03/2023 00:00:00,10/03/2023 00:00:00,EXPIRED,LONG,23013.0,25052.0,27602.55,18423.45,0.086,16.63,24.91,4.57,2,1.0,2.02,0.075,0.01725975,TAKER
24/02/2023 00:00:00,18/06/2023 13:26:52,Upscale-Upscale-DUMMY_Gemini_BTCUSD_1h_01_07_22_to_16_06_23.csv,BTC_USD,WEEK,268.88,0.002,21/04/2023 00:00:00,14/04/2023 00:00:00,03/03/2023 00:00:00,TAKE_PROFIT_HIT,SHORT,23468.0,20996.18,20996.18,25939.82,0.175,11.77,9.53,4.91,2,1.0,4.91,0.075,0.035202,TAKER
20/01/2023 00:00:00,18/06/2023 13:26:52,Upscale-Upscale-DUMMY_Gemini_BTCUSD_1h_01_07_22_to_16_06_23.csv,BTC_USD,WEEK,273.79,0.001,17/03/2023 00:00:00,10/03/2023 00:00:00,10/03/2023 00:00:00,EXPIRED,LONG,23013.0,25052.0,27602.55,18423.45,0.084,16.63,24.91,4.57,2,1.0,2.02,0.075,0.01725975,TAKER
24/03/2023 00:00:00,18/06/2023 13:26:52,Upscale-Upscale-DUMMY_Gemini_BTCUSD_1h_01_07_22_to_16_06_23.csv,BTC_USD,WEEK,275.81,0.0,19/05/2023 00:00:00,12/05/2023 00:00:00,12/05/2023 00:00:00,EXPIRED,LONG,27941.0,26831.0,40815.86,15066.14,0.0,31.54,85.46,0.0,0,0.0,0.0,0.075,0.0,TAKER
24/02/2023 00:00:00,18/06/2023 13:26:52,Upscale-Upscale-DUMMY_Gemini_BTCUSD_1h_01_07_22_to_16_06_23.csv,BTC_USD,WEEK,275.81,0.002,21/04/2023 00:00:00,14/04/2023 00:00:00,03/03/2023 00:00:00,TAKE_PROFIT_HIT,SHORT,23468.0,20996.18,20996.18,25939.82,0.17,11.77,9.53,4.91,2,1.0,4.91,0.075,0.035202,TAKER
24/02/2023 00:00:00,18/06/2023 13:26:52,Upscale-Upscale-DUMMY_Gemini_BTCUSD_1h_01_07_22_to_16_06_23.csv,BTC_USD,WEEK,280.72,0.002,21/04/2023 00:00:00,14/04/2023 00:00:00,03/03/2023 00:00:00,TAKE_PROFIT_HIT,SHORT,23468.0,20996.18,20996.18,25939.82,0.167,11.77,9.53,4.91,2,1.0,4.91,0.075,0.035202,TAKER
20/01/2023 00:00:00,18/06/2023 13:26:52,Upscale-Upscale-DUMMY_Gemini_BTCUSD_1h_01_07_22_to_16_06_23.csv,BTC_USD,WEEK,285.63,0.001,17/03/2023 00:00:00,10/03/2023 00:00:00,10/03/2023 00:00:00,EXPIRED,LONG,23013.0,25052.0,27602.55,18423.45,0.081,16.63,24.91,4.57,2,1.0,2.02,0.075,0.01725975,TAKER
03/03/2023 00:00:00,18/06/2023 13:26:52,Upscale-Upscale-DUMMY_Gemini_BTCUSD_1h_01_07_22_to_16_06_23.csv,BTC_USD,WEEK,287.65,0.004,21/04/2023 00:00:00,21/04/2023 00:00:00,10/03/2023 00:00:00,STOP_LOSS_HIT,SHORT,20290.0,21899.78,18680.22,21899.78,0.282,8.62,7.35,6.38,2,1.0,-6.5,0.075,0.06087,TAKER
27/01/2023 00:00:00,18/06/2023 13:26:52,Upscale-Upscale-DUMMY_Gemini_BTCUSD_1h_01_07_22_to_16_06_23.csv,BTC_USD,WEEK,281.15,0.0,24/03/2023 00:00:00,17/03/2023 00:00:00,17/03/2023 00:00:00,EXPIRED,LONG,23487.0,28351.0,34972.35,12001.65,0.0,32.84,95.7,0.0,0,0.0,0.0,0.075,0.0,TAKER
27/01/2023 00:00:00,18/06/2023 13:26:52,Upscale-Upscale-DUMMY_Gemini_BTCUSD_1h_01_07_22_to_16_06_23.csv,BTC_USD,WEEK,281.15,0.0,24/03/2023 00:00:00,17/03/2023 00:00:00,17/03/2023 00:00:00,EXPIRED,LONG,23487.0,28351.0,34972.35,12001.65,0.0,32.84,95.7,0.0,0,0.0,0.0,0.075,0.0,TAKER
27/01/2023 00:00:00,18/06/2023 13:26:52,Upscale-Upscale-DUMMY_Gemini_BTCUSD_1h_01_07_22_to_16_06_23.csv,BTC_USD,WEEK,281.15,0.0,24/03/2023 00:00:00,17/03/2023 00:00:00,17/03/2023 00:00:00,EXPIRED,LONG,23487.0,28351.0,34972.35,12001.65,0.0,32.84,95.7,0.0,0,0.0,0.0,0.075,0.0,TAKER
27/01/2023 00:00:00,18/06/2023 13:26:52,Upscale-Upscale-DUMMY_Gemini_BTCUSD_1h_01_07_22_to_16_06_23.csv,BTC_USD,WEEK,281.15,0.0,24/03/2023 00:00:00,17/03/2023 00:00:00,17/03/2023 00:00:00,EXPIRED,LONG,23487.0,28351.0,34972.35,12001.65,0.0,32.84,95.7,0.0,0,0.0,0.0,0.075,0.0,TAKER
24/02/2023 00:00:00,18/06/2023 13:26:52,Upscale-Upscale-DUMMY_Gemini_BTCUSD_1h_01_07_22_to_16_06_23.csv,BTC_USD,WEEK,281.15,0.002,21/04/2023 00:00:00,14/04/2023 00:00:00,03/03/2023 00:00:00,TAKE_PROFIT_HIT,SHORT,23468.0,20996.18,20996.18,25939.82,0.167,11.77,9.53,4.91,2,1.0,4.91,0.075,0.035202,TAKER
24/02/2023 00:00:00,18/06/2023 13:26:52,Upscale-Upscale-DUMMY_Gemini_BTCUSD_1h_01_07_22_to_16_06_23.csv,BTC_USD,WEEK,286.06,0.002,21/04/2023 00:00:00,14/04/2023 00:00:00,03/03/2023 00:00:00,TAKE_PROFIT_HIT,SHORT,23468.0,20996.18,20996.18,25939.82,0.164,11.77,9.53,4.91,2,1.0,4.91,0.075,0.035202,TAKER
20/01/2023 00:00:00,18/06/2023 13:26:52,Upscale-Upscale-DUMMY_Gemini_BTCUSD_1h_01_07_22_to_16_06_23.csv,BTC_USD,WEEK,290.97,0.001,17/03/2023 00:00:00,10/03/2023 00:00:00,10/03/2023 00:00:00,EXPIRED,LONG,23013.0,25052.0,27602.55,18423.45,0.079,16.63,24.91,4.57,2,1.0,2.02,0.075,0.01725975,TAKER
03/03/2023 00:00:00,18/06/2023 13:26:52,Upscale-Upscale-DUMMY_Gemini_BTCUSD_1h_01_07_22_to_16_06_23.csv,BTC_USD,WEEK,292.99,0.004,21/04/2023 00:00:00,21/04/2023 00:00:00,10/03/2023 00:00:00,STOP_LOSS_HIT,SHORT,20290.0,21899.78,18680.22,21899.78,0.277,8.62,7.35,6.38,2,1.0,-6.5,0.075,0.06087,TAKER
20/01/2023 00:00:00,18/06/2023 13:26:52,Upscale-Upscale-DUMMY_Gemini_BTCUSD_1h_01_07_22_to_16_06_23.csv,BTC_USD,WEEK,286.49,0.001,17/03/2023 00:00:00,10/03/2023 00:00:00,10/03/2023 00:00:00,EXPIRED,LONG,23013.0,25052.0,27602.55,18423.45,0.08,16.63,24.91,4.57,2,1.0,2.02,0.075,0.01725975,TAKER
17/02/2023 00:00:00,18/06/2023 13:26:52,Upscale-Upscale-DUMMY_Gemini_BTCUSD_1h_01_07_22_to_16_06_23.csv,BTC_USD,WEEK,288.51,0.004,31/03/2023 00:00:00,07/04/2023 00:00:00,03/03/2023 00:00:00,TAKE_PROFIT_HIT,SHORT,23948.0,22334.58,22334.58,25561.42,0.332,7.22,6.31,6.38,2,1.0,6.38,0.075,0.071844,TAKER
20/01/2023 00:00:00,18/06/2023 13:26:52,Upscale-Upscale-DUMMY_Gemini_BTCUSD_1h_01_07_22_to_16_06_23.csv,BTC_USD,WEEK,294.89,0.001,17/03/2023 00:00:00,10/03/2023 00:00:00,10/03/2023 00:00:00,EXPIRED,LONG,23013.0,25052.0,27602.55,18423.45,0.078,16.63,24.91,4.57,2,1.0,2.02,0.075,0.01725975,TAKER
24/02/2023 00:00:00,18/06/2023 13:26:52,Upscale-Upscale-DUMMY_Gemini_BTCUSD_1h_01_07_22_to_16_06_23.csv,BTC_USD,WEEK,296.91,0.002,21/04/2023 00:00:00,14/04/2023 00:00:00,03/03/2023 00:00:00,TAKE_PROFIT_HIT,SHORT,23468.0,20996.18,20996.18,25939.82,0.158,11.77,9.53,4.91,2,1.0,4.91,0.075,0.035202,TAKER
20/01/2023 00:00:00,18/06/2023 13:26:52,Upscale-Upscale-DUMMY_Gemini_BTCUSD_1h_01_07_22_to_16_06_23.csv,BTC_USD,WEEK,301.82,0.001,17/03/2023 00:00:00,10/03/2023 00:00:00,10/03/2023 00:00:00,EXPIRED,LONG,23013.0,25052.0,27602.55,18423.45,0.076,16.63,24.91,4.57,2,1.0,2.02,0.075,0.01725975,TAKER
24/02/2023 00:00:00,18/06/2023 13:26:52,Upscale-Upscale-DUMMY_Gemini_BTCUSD_1h_01_07_22_to_16_06_23.csv,BTC_USD,WEEK,303.84,0.002,21/04/2023 00:00:00,14/04/2023 00:00:00,03/03/2023 00:00:00,TAKE_PROFIT_HIT,SHORT,23468.0,20996.18,20996.18,25939.82,0.154,11.77,9.53,4.91,2,1.0,4.91,0.075,0.035202,TAKER
20/01/2023 00:00:00,18/06/2023 13:26:52,Upscale-Upscale-DUMMY_Gemini_BTCUSD_1h_01_07_22_to_16_06_23.csv,BTC_USD,WEEK,308.75,0.001,17/03/2023 00:00:00,10/03/2023 00:00:00,10/03/2023 00:00:00,EXPIRED,LONG,23013.0,25052.0,27602.55,18423.45,0.075,16.63,24.91,4.57,1,1.0,2.02,0.075,0.01725975,TAKER
24/03/2023 00:00:00,18/06/2023 13:26:52,Upscale-Upscale-DUMMY_Gemini_BTCUSD_1h_01_07_22_to_16_06_23.csv,BTC_USD,WEEK,310.77,0.0,19/05/2023 00:00:00,12/05/2023 00:00:00,12/05/2023 00:00:00,EXPIRED,LONG,27941.0,26831.0,40815.86,15066.14,0.0,31.54,85.46,0.0,0,0.0,0.0,0.075,0.0,TAKER
24/03/2023 00:00:00,18/06/2023 13:26:52,Upscale-Upscale-DUMMY_Gemini_BTCUSD_1h_01_07_22_to_16_06_23.csv,BTC_USD,WEEK,310.77,0.0,19/05/2023 00:00:00,12/05/2023 00:00:00,12/05/2023 00:00:00,EXPIRED,LONG,27941.0,26831.0,40815.86,15066.14,0.0,31.54,85.46,0.0,0,0.0,0.0,0.075,0.0,TAKER
24/02/2023 00:00:00,18/06/2023 13:26:52,Upscale-Upscale-DUMMY_Gemini_BTCUSD_1h_01_07_22_to_16_06_23.csv,BTC_USD,WEEK,310.77,0.003,21/04/2023 00:00:00,14/04/2023 00:00:00,03/03/2023 00:00:00,TAKE_PROFIT_HIT,SHORT,23468.0,20996.18,20996.18,25939.82,0.227,11.77,9.53,7.36,2,1.0,7.36,0.075,0.052802999999999996,TAKER
17/02/2023 00:00:00,18/06/2023 13:26:52,Upscale-Upscale-DUMMY_Gemini_BTCUSD_1h_01_07_22_to_16_06_23.csv,BTC_USD,WEEK,318.13,0.004,31/03/2023 00:00:00,07/04/2023 00:00:00,03/03/2023 00:00:00,TAKE_PROFIT_HIT,SHORT,23948.0,22334.58,22334.58,25561.42,0.301,7.22,6.31,6.38,2,1.0,6.38,0.075,0.071844,TAKER
24/02/2023 00:00:00,18/06/2023 13:26:52,Upscale-Upscale-DUMMY_Gemini_BTCUSD_1h_01_07_22_to_16_06_23.csv,BTC_USD,WEEK,324.51,0.003,21/04/2023 00:00:00,14/04/2023 00:00:00,03/03/2023 00:00:00,TAKE_PROFIT_HIT,SHORT,23468.0,20996.18,20996.18,25939.82,0.217,11.77,9.53,7.36,2,1.0,7.36,0.075,0.052802999999999996,TAKER
24/03/2023 00:00:00,18/06/2023 13:26:52,Upscale-Upscale-DUMMY_Gemini_BTCUSD_1h_01_07_22_to_16_06_23.csv,BTC_USD,WEEK,331.87,0.001,19/05/2023 00:00:00,12/05/2023 00:00:00,12/05/2023 00:00:00,EXPIRED,LONG,27941.0,26831.0,40815.86,15066.14,0.084,31.54,85.46,12.85,4,1.0,-1.13,0.075,0.02095575,TAKER
20/01/2023 00:00:00,18/06/2023 13:26:52,Upscale-Upscale-DUMMY_Gemini_BTCUSD_1h_01_07_22_to_16_06_23.csv,BTC_USD,WEEK,330.74,0.001,17/03/2023 00:00:00,10/03/2023 00:00:00,10/03/2023 00:00:00,EXPIRED,LONG,23013.0,25052.0,27602.55,18423.45,0.07,16.63,24.91,4.57,1,1.0,2.02,0.075,0.01725975,TAKER
24/02/2023 00:00:00,18/06/2023 13:26:52,Upscale-Upscale-DUMMY_Gemini_BTCUSD_1h_01_07_22_to_16_06_23.csv,BTC_USD,WEEK,332.76,0.003,21/04/2023 00:00:00,14/04/2023 00:00:00,03/03/2023 00:00:00,TAKE_PROFIT_HIT,SHORT,23468.0,20996.18,20996.18,25939.82,0.212,11.77,9.53,7.36,2,1.0,7.36,0.075,0.052802999999999996,TAKER
20/01/2023 00:00:00,18/06/2023 13:26:52,Upscale-Upscale-DUMMY_Gemini_BTCUSD_1h_01_07_22_to_16_06_23.csv,BTC_USD,WEEK,340.12,0.001,17/03/2023 00:00:00,10/03/2023 00:00:00,10/03/2023 00:00:00,EXPIRED,LONG,23013.0,25052.0,27602.55,18423.45,0.068,16.63,24.91,4.57,1,1.0,2.02,0.075,0.01725975,TAKER
27/01/2023 00:00:00,18/06/2023 13:26:52,Upscale-Upscale-DUMMY_Gemini_BTCUSD_1h_01_07_22_to_16_06_23.csv,BTC_USD,WEEK,342.14,0.001,24/03/2023 00:00:00,17/03/2023 00:00:00,17/03/2023 00:00:00,EXPIRED,LONG,23487.0,28351.0,34972.35,12001.65,0.069,32.84,95.7,11.47,3,1.0,4.85,0.075,0.01761525,TAKER
24/02/2023 00:00:00,18/06/2023 13:26:52,Upscale-Upscale-DUMMY_Gemini_BTCUSD_1h_01_07_22_to_16_06_23.csv,BTC_USD,WEEK,346.99,0.003,21/04/2023 00:00:00,14/04/2023 00:00:00,03/03/2023 00:00:00,TAKE_PROFIT_HIT,SHORT,23468.0,20996.18,20996.18,25939.82,0.203,11.77,9.53,7.36,2,1.0,7.36,0.075,0.052802999999999996,TAKER
17/02/2023 00:00:00,18/06/2023 13:26:52,Upscale-Upscale-DUMMY_Gemini_BTCUSD_1h_01_07_22_to_16_06_23.csv,BTC_USD,WEEK,354.35,0.004,31/03/2023 00:00:00,07/04/2023 00:00:00,03/03/2023 00:00:00,TAKE_PROFIT_HIT,SHORT,23948.0,22334.58,22334.58,25561.42,0.27,7.22,6.31,6.38,2,1.0,6.38,0.075,0.071844,TAKER
24/02/2023 00:00:00,18/06/2023 13:26:52,Upscale-Upscale-DUMMY_Gemini_BTCUSD_1h_01_07_22_to_16_06_23.csv,BTC_USD,WEEK,360.73,0.003,21/04/2023 00:00:00,14/04/2023 00:00:00,03/03/2023 00:00:00,TAKE_PROFIT_HIT,SHORT,23468.0,20996.18,20996.18,25939.82,0.195,11.77,9.53,7.36,2,1.0,7.36,0.075,0.052802999999999996,TAKER
20/01/2023 00:00:00,18/06/2023 13:26:52,Upscale-Upscale-DUMMY_Gemini_BTCUSD_1h_01_07_22_to_16_06_23.csv,BTC_USD,WEEK,368.09,0.002,17/03/2023 00:00:00,10/03/2023 00:00:00,10/03/2023 00:00:00,EXPIRED,LONG,23013.0,25052.0,27602.55,18423.45,0.125,16.63,24.91,9.14,2,1.0,4.04,0.075,0.0345195,TAKER
24/03/2023 00:00:00,18/06/2023 13:26:52,Upscale-Upscale-DUMMY_Gemini_BTCUSD_1h_01_07_22_to_16_06_23.csv,BTC_USD,WEEK,372.13,0.001,19/05/2023 00:00:00,12/05/2023 00:00:00,12/05/2023 00:00:00,EXPIRED,LONG,27941.0,26831.0,40815.86,15066.14,0.075,31.54,85.46,12.85,3,1.0,-1.13,0.075,0.02095575,TAKER
20/01/2023 00:00:00,18/06/2023 13:26:52,Upscale-Upscale-DUMMY_Gemini_BTCUSD_1h_01_07_22_to_16_06_23.csv,BTC_USD,WEEK,371.0,0.002,17/03/2023 00:00:00,10/03/2023 00:00:00,10/03/2023 00:00:00,EXPIRED,LONG,23013.0,25052.0,27602.55,18423.45,0.124,16.63,24.91,9.14,2,1.0,4.04,0.075,0.0345195,TAKER
03/03/2023 00:00:00,18/06/2023 13:26:52,Upscale-Upscale-DUMMY_Gemini_BTCUSD_1h_01_07_22_to_16_06_23.csv,BTC_USD,WEEK,375.04,0.005,21/04/2023 00:00:00,21/04/2023 00:00:00,10/03/2023 00:00:00,STOP_LOSS_HIT,SHORT,20290.0,21899.78,18680.22,21899.78,0.271,8.62,7.35,7.97,2,1.0,-8.12,0.075,0.0760875,TAKER
03/03/2023 00:00:00,18/06/2023 13:26:52,Upscale-Upscale-DUMMY_Gemini_BTCUSD_1h_01_07_22_to_16_06_23.csv,BTC_USD,WEEK,366.92,0.005,21/04/2023 00:00:00,21/04/2023 00:00:00,10/03/2023 00:00:00,STOP_LOSS_HIT,SHORT,20290.0,21899.78,18680.22,21899.78,0.276,8.62,7.35,7.97,2,1.0,-8.12,0.075,0.0760875,TAKER
03/03/2023 00:00:00,18/06/2023 13:26:52,Upscale-Upscale-DUMMY_Gemini_BTCUSD_1h_01_07_22_to_16_06_23.csv,BTC_USD,WEEK,358.8,0.004,21/04/2023 00:00:00,21/04/2023 00:00:00,10/03/2023 00:00:00,STOP_LOSS_HIT,SHORT,20290.0,21899.78,18680.22,21899.78,0.226,8.62,7.35,6.38,2,1.0,-6.5,0.075,0.06087,TAKER
17/02/2023 00:00:00,18/06/2023 13:26:52,Upscale-Upscale-DUMMY_Gemini_BTCUSD_1h_01_07_22_to_16_06_23.csv,BTC_USD,WEEK,352.3,0.004,31/03/2023 00:00:00,07/04/2023 00:00:00,03/03/2023 00:00:00,TAKE_PROFIT_HIT,SHORT,23948.0,22334.58,22334.58,25561.42,0.272,7.22,6.31,6.38,2,1.0,6.38,0.075,0.071844,TAKER
24/02/2023 00:00:00,18/06/2023 13:26:52,Upscale-Upscale-DUMMY_Gemini_BTCUSD_1h_01_07_22_to_16_06_23.csv,BTC_USD,WEEK,358.68,0.003,21/04/2023 00:00:00,14/04/2023 00:00:00,03/03/2023 00:00:00,TAKE_PROFIT_HIT,SHORT,23468.0,20996.18,20996.18,25939.82,0.196,11.77,9.53,7.36,2,1.0,7.36,0.075,0.052802999999999996,TAKER
24/03/2023 00:00:00,18/06/2023 13:26:52,Upscale-Upscale-DUMMY_Gemini_BTCUSD_1h_01_07_22_to_16_06_23.csv,BTC_USD,WEEK,366.04,0.001,19/05/2023 00:00:00,12/05/2023 00:00:00,12/05/2023 00:00:00,EXPIRED,LONG,27941.0,26831.0,40815.86,15066.14,0.076,31.54,85.46,12.85,4,1.0,-1.13,0.075,0.02095575,TAKER
27/01/2023 00:00:00,18/06/2023 13:26:52,Upscale-Upscale-DUMMY_Gemini_BTCUSD_1h_01_07_22_to_16_06_23.csv,BTC_USD,WEEK,364.91,0.001,24/03/2023 00:00:00,17/03/2023 00:00:00,17/03/2023 00:00:00,EXPIRED,LONG,23487.0,28351.0,34972.35,12001.65,0.064,32.84,95.7,11.47,3,1.0,4.85,0.075,0.01761525,TAKER
20/01/2023 00:00:00,18/06/2023 13:26:52,Upscale-Upscale-DUMMY_Gemini_BTCUSD_1h_01_07_22_to_16_06_23.csv,BTC_USD,WEEK,369.76,0.002,17/03/2023 00:00:00,10/03/2023 00:00:00,10/03/2023 00:00:00,EXPIRED,LONG,23013.0,25052.0,27602.55,18423.45,0.124,16.63,24.91,9.14,2,1.0,4.04,0.075,0.0345195,TAKER
24/02/2023 00:00:00,18/06/2023 13:26:52,Upscale-Upscale-DUMMY_Gemini_BTCUSD_1h_01_07_22_to_16_06_23.csv,BTC_USD,WEEK,373.8,0.003,21/04/2023 00:00:00,14/04/2023 00:00:00,03/03/2023 00:00:00,TAKE_PROFIT_HIT,SHORT,23468.0,20996.18,20996.18,25939.82,0.188,11.77,9.53,7.36,2,1.0,7.36,0.075,0.052802999999999996,TAKER
03/03/2023 00:00:00,18/06/2023 13:26:52,Upscale-Upscale-DUMMY_Gemini_BTCUSD_1h_01_07_22_to_16_06_23.csv,BTC_USD,WEEK,381.16,0.005,21/04/2023 00:00:00,21/04/2023 00:00:00,10/03/2023 00:00:00,STOP_LOSS_HIT,SHORT,20290.0,21899.78,18680.22,21899.78,0.266,8.62,7.35,7.97,2,1.0,-8.12,0.075,0.0760875,TAKER
24/02/2023 00:00:00,18/06/2023 13:26:52,Upscale-Upscale-DUMMY_Gemini_BTCUSD_1h_01_07_22_to_16_06_23.csv,BTC_USD,WEEK,373.04,0.003,21/04/2023 00:00:00,14/04/2023 00:00:00,03/03/2023 00:00:00,TAKE_PROFIT_HIT,SHORT,23468.0,20996.18,20996.18,25939.82,0.189,11.77,9.53,7.36,2,1.0,7.36,0.075,0.052802999999999996,TAKER
20/01/2023 00:00:00,18/06/2023 13:26:52,Upscale-Upscale-DUMMY_Gemini_BTCUSD_1h_01_07_22_to_16_06_23.csv,BTC_USD,WEEK,380.4,0.002,17/03/2023 00:00:00,10/03/2023 00:00:00,10/03/2023 00:00:00,EXPIRED,LONG,23013.0,25052.0,27602.55,18423.45,0.121,16.63,24.91,9.14,2,1.0,4.04,0.075,0.0345195,TAKER
27/01/2023 00:00:00,18/06/2023 13:26:52,Upscale-Upscale-DUMMY_Gemini_BTCUSD_1h_01_07_22_to_16_06_23.csv,BTC_USD,WEEK,384.44,0.001,24/03/2023 00:00:00,17/03/2023 00:00:00,17/03/2023 00:00:00,EXPIRED,LONG,23487.0,28351.0,34972.35,12001.65,0.061,32.84,95.7,11.47,3,1.0,4.85,0.075,0.01761525,TAKER
27/01/2023 00:00:00,18/06/2023 13:26:52,Upscale-Upscale-DUMMY_Gemini_BTCUSD_1h_01_07_22_to_16_06_23.csv,BTC_USD,WEEK,389.29,0.001,24/03/2023 00:00:00,17/03/2023 00:00:00,17/03/2023 00:00:00,EXPIRED,LONG,23487.0,28351.0,34972.35,12001.65,0.06,32.84,95.7,11.47,3,1.0,4.85,0.075,0.01761525,TAKER
27/01/2023 00:00:00,18/06/2023 13:26:52,Upscale-Upscale-DUMMY_Gemini_BTCUSD_1h_01_07_22_to_16_06_23.csv,BTC_USD,WEEK,394.14,0.001,24/03/2023 00:00:00,17/03/2023 00:00:00,17/03/2023 00:00:00,EXPIRED,LONG,23487.0,28351.0,34972.35,12001.65,0.06,32.84,95.7,11.47,3,1.0,4.85,0.075,0.01761525,TAKER
03/03/2023 00:00:00,18/06/2023 13:26:52,Upscale-Upscale-DUMMY_Gemini_BTCUSD_1h_01_07_22_to_16_06_23.csv,BTC_USD,WEEK,398.99,0.005,21/04/2023 00:00:00,21/04/2023 00:00:00,10/03/2023 00:00:00,STOP_LOSS_HIT,SHORT,20290.0,21899.78,18680.22,21899.78,0.254,8.62,7.35,7.97,2,1.0,-8.12,0.075,0.0760875,TAKER
27/01/2023 00:00:00,18/06/2023 13:26:52,Upscale-Upscale-DUMMY_Gemini_BTCUSD_1h_01_07_22_to_16_06_23.csv,BTC_USD,WEEK,390.87,0.001,24/03/2023 00:00:00,17/03/2023 00:00:00,17/03/2023 00:00:00,EXPIRED,LONG,23487.0,28351.0,34972.35,12001.65,0.06,32.84,95.7,11.47,3,1.0,4.85,0.075,0.01761525,TAKER
24/03/2023 00:00:00,18/06/2023 13:26:52,Upscale-Upscale-DUMMY_Gemini_BTCUSD_1h_01_07_22_to_16_06_23.csv,BTC_USD,WEEK,395.72,0.001,19/05/2023 00:00:00,12/05/2023 00:00:00,12/05/2023 00:00:00,EXPIRED,LONG,27941.0,26831.0,40815.86,15066.14,0.071,31.54,85.46,12.85,3,1.0,-1.13,0.075,0.02095575,TAKER
20/01/2023 00:00:00,18/06/2023 13:26:52,Upscale-Upscale-DUMMY_Gemini_BTCUSD_1h_01_07_22_to_16_06_23.csv,BTC_USD,WEEK,394.59,0.002,17/03/2023 00:00:00,10/03/2023 00:00:00,10/03/2023 00:00:00,EXPIRED,LONG,23013.0,25052.0,27602.55,18423.45,0.117,16.63,24.91,9.14,2,1.0,4.04,0.075,0.0345195,TAKER
20/01/2023 00:00:00,18/06/2023 13:26:52,Upscale-Upscale-DUMMY_Gemini_BTCUSD_1h_01_07_22_to_16_06_23.csv,BTC_USD,WEEK,398.63,0.002,17/03/2023 00:00:00,10/03/2023 00:00:00,10/03/2023 00:00:00,EXPIRED,LONG,23013.0,25052.0,27602.55,18423.45,0.115,16.63,24.91,9.14,2,1.0,4.04,0.075,0.0345195,TAKER
03/03/2023 00:00:00,18/06/2023 13:26:52,Upscale-Upscale-DUMMY_Gemini_BTCUSD_1h_01_07_22_to_16_06_23.csv,BTC_USD,WEEK,402.67,0.005,21/04/2023 00:00:00,21/04/2023 00:00:00,10/03/2023 00:00:00,STOP_LOSS_HIT,SHORT,20290.0,21899.78,18680.22,21899.78,0.252,8.62,7.35,7.97,2,1.0,-8.12,0.075,0.0760875,TAKER
17/02/2023 00:00:00,18/06/2023 13:26:52,Upscale-Upscale-DUMMY_Gemini_BTCUSD_1h_01_07_22_to_16_06_23.csv,BTC_USD,WEEK,394.55,0.005,31/03/2023 00:00:00,07/04/2023 00:00:00,03/03/2023 00:00:00,TAKE_PROFIT_HIT,SHORT,23948.0,22334.58,22334.58,25561.42,0.303,7.22,6.31,7.98,2,1.0,7.98,0.075,0.08980500000000001,TAKER
24/03/2023 00:00:00,18/06/2023 13:26:52,Upscale-Upscale-DUMMY_Gemini_BTCUSD_1h_01_07_22_to_16_06_23.csv,BTC_USD,WEEK,402.53,0.001,19/05/2023 00:00:00,12/05/2023 00:00:00,12/05/2023 00:00:00,EXPIRED,LONG,27941.0,26831.0,40815.86,15066.14,0.069,31.54,85.46,12.85,3,1.0,-1.13,0.075,0.02095575,TAKER
24/02/2023 00:00:00,18/06/2023 13:26:52,Upscale-Upscale-DUMMY_Gemini_BTCUSD_1h_01_07_22_to_16_06_23.csv,BTC_USD,WEEK,401.4,0.003,21/04/2023 00:00:00,14/04/2023 00:00:00,03/03/2023 00:00:00,TAKE_PROFIT_HIT,SHORT,23468.0,20996.18,20996.18,25939.82,0.175,11.77,9.53,7.36,2,1.0,7.36,0.075,0.052802999999999996,TAKER
03/03/2023 00:00:00,18/06/2023 13:26:52,Upscale-Upscale-DUMMY_Gemini_BTCUSD_1h_01_07_22_to_16_06_23.csv,BTC_USD,WEEK,408.76,0.005,21/04/2023 00:00:00,21/04/2023 00:00:00,10/03/2023 00:00:00,STOP_LOSS_HIT,SHORT,20290.0,21899.78,18680.22,21899.78,0.248,8.62,7.35,7.97,2,1.0,-8.12,0.075,0.0760875,TAKER
17/02/2023 00:00:00,18/06/2023 13:26:52,Upscale-Upscale-DUMMY_Gemini_BTCUSD_1h_01_07_22_to_16_06_23.csv,BTC_USD,WEEK,400.64,0.005,31/03/2023 00:00:00,07/04/2023 00:00:00,03/03/2023 00:00:00,TAKE_PROFIT_HIT,SHORT,23948.0,22334.58,22334.58,25561.42,0.299,7.22,6.31,7.98,2,1.0,7.98,0.075,0.08980500000000001,TAKER
17/02/2023 00:00:00,18/06/2023 13:26:52,Upscale-Upscale-DUMMY_Gemini_BTCUSD_1h_01_07_22_to_16_06_23.csv,BTC_USD,WEEK,408.62,0.005,31/03/2023 00:00:00,07/04/2023 00:00:00,03/03/2023 00:00:00,TAKE_PROFIT_HIT,SHORT,23948.0,22334.58,22334.58,25561.42,0.293,7.22,6.31,7.98,2,1.0,7.98,0.075,0.08980500000000001,TAKER
27/01/2023 00:00:00,18/06/2023 13:26:52,Upscale-Upscale-DUMMY_Gemini_BTCUSD_1h_01_07_22_to_16_06_23.csv,BTC_USD,WEEK,416.6,0.001,24/03/2023 00:00:00,17/03/2023 00:00:00,17/03/2023 00:00:00,EXPIRED,LONG,23487.0,28351.0,34972.35,12001.65,0.056,32.84,95.7,11.47,3,1.0,4.85,0.075,0.01761525,TAKER
27/01/2023 00:00:00,18/06/2023 13:26:52,Upscale-Upscale-DUMMY_Gemini_BTCUSD_1h_01_07_22_to_16_06_23.csv,BTC_USD,WEEK,421.45,0.001,24/03/2023 00:00:00,17/03/2023 00:00:00,17/03/2023 00:00:00,EXPIRED,LONG,23487.0,28351.0,34972.35,12001.65,0.056,32.84,95.7,11.47,3,1.0,4.85,0.075,0.01761525,TAKER
24/02/2023 00:00:00,18/06/2023 13:26:52,Upscale-Upscale-DUMMY_Gemini_BTCUSD_1h_01_07_22_to_16_06_23.csv,BTC_USD,WEEK,426.3,0.003,21/04/2023 00:00:00,14/04/2023 00:00:00,03/03/2023 00:00:00,TAKE_PROFIT_HIT,SHORT,23468.0,20996.18,20996.18,25939.82,0.165,11.77,9.53,7.36,2,1.0,7.36,0.075,0.052802999999999996,TAKER
20/01/2023 00:00:00,18/06/2023 13:26:52,Upscale-Upscale-DUMMY_Gemini_BTCUSD_1h_01_07_22_to_16_06_23.csv,BTC_USD,WEEK,433.66,0.002,17/03/2023 00:00:00,10/03/2023 00:00:00,10/03/2023 00:00:00,EXPIRED,LONG,23013.0,25052.0,27602.55,18423.45,0.106,16.63,24.91,9.14,2,1.0,4.04,0.075,0.0345195,TAKER
20/01/2023 00:00:00,18/06/2023 13:26:52,Upscale-Upscale-DUMMY_Gemini_BTCUSD_1h_01_07_22_to_16_06_23.csv,BTC_USD,WEEK,437.7,0.002,17/03/2023 00:00:00,10/03/2023 00:00:00,10/03/2023 00:00:00,EXPIRED,LONG,23013.0,25052.0,27602.55,18423.45,0.105,16.63,24.91,9.14,2,1.0,4.04,0.075,0.0345195,TAKER
24/03/2023 00:00:00,18/06/2023 13:26:52,Upscale-Upscale-DUMMY_Gemini_BTCUSD_1h_01_07_22_to_16_06_23.csv,BTC_USD,WEEK,441.74,0.001,19/05/2023 00:00:00,12/05/2023 00:00:00,12/05/2023 00:00:00,EXPIRED,LONG,27941.0,26831.0,40815.86,15066.14,0.063,31.54,85.46,12.85,3,1.0,-1.13,0.075,0.02095575,TAKER
27/01/2023 00:00:00,18/06/2023 13:26:52,Upscale-Upscale-DUMMY_Gemini_BTCUSD_1h_01_07_22_to_16_06_23.csv,BTC_USD,WEEK,440.61,0.001,24/03/2023 00:00:00,17/03/2023 00:00:00,17/03/2023 00:00:00,EXPIRED,LONG,23487.0,28351.0,34972.35,12001.65,0.053,32.84,95.7,11.47,3,1.0,4.85,0.075,0.01761525,TAKER
27/01/2023 00:00:00,18/06/2023 13:26:52,Upscale-Upscale-DUMMY_Gemini_BTCUSD_1h_01_07_22_to_16_06_23.csv,BTC_USD,WEEK,445.46,0.001,24/03/2023 00:00:00,17/03/2023 00:00:00,17/03/2023 00:00:00,EXPIRED,LONG,23487.0,28351.0,34972.35,12001.65,0.053,32.84,95.7,11.47,3,1.0,4.85,0.075,0.01761525,TAKER
17/02/2023 00:00:00,18/06/2023 13:26:52,Upscale-Upscale-DUMMY_Gemini_BTCUSD_1h_01_07_22_to_16_06_23.csv,BTC_USD,WEEK,450.31,0.006,31/03/2023 00:00:00,07/04/2023 00:00:00,03/03/2023 00:00:00,TAKE_PROFIT_HIT,SHORT,23948.0,22334.58,22334.58,25561.42,0.319,7.22,6.31,9.57,2,1.0,9.57,0.075,0.107766,TAKER
24/03/2023 00:00:00,18/06/2023 13:26:52,Upscale-Upscale-DUMMY_Gemini_BTCUSD_1h_01_07_22_to_16_06_23.csv,BTC_USD,WEEK,459.88,0.001,19/05/2023 00:00:00,12/05/2023 00:00:00,12/05/2023 00:00:00,EXPIRED,LONG,27941.0,26831.0,40815.86,15066.14,0.061,31.54,85.46,12.85,3,1.0,-1.13,0.075,0.02095575,TAKER
27/01/2023 00:00:00,18/06/2023 13:26:52,Upscale-Upscale-DUMMY_Gemini_BTCUSD_1h_01_07_22_to_16_06_23.csv,BTC_USD,WEEK,458.75,0.001,24/03/2023 00:00:00,17/03/2023 00:00:00,17/03/2023 00:00:00,EXPIRED,LONG,23487.0,28351.0,34972.35,12001.65,0.051,32.84,95.7,11.47,3,1.0,4.85,0.075,0.01761525,TAKER
24/02/2023 00:00:00,18/06/2023 13:26:52,Upscale-Upscale-DUMMY_Gemini_BTCUSD_1h_01_07_22_to_16_06_23.csv,BTC_USD,WEEK,463.6,0.004,21/04/2023 00:00:00,14/04/2023 00:00:00,03/03/2023 00:00:00,TAKE_PROFIT_HIT,SHORT,23468.0,20996.18,20996.18,25939.82,0.202,11.77,9.53,9.82,2,1.0,9.82,0.075,0.070404,TAKER
17/02/2023 00:00:00,18/06/2023 13:26:52,Upscale-Upscale-DUMMY_Gemini_BTCUSD_1h_01_07_22_to_16_06_23.csv,BTC_USD,WEEK,473.42,0.006,31/03/2023 00:00:00,07/04/2023 00:00:00,03/03/2023 00:00:00,TAKE_PROFIT_HIT,SHORT,23948.0,22334.58,22334.58,25561.42,0.304,7.22,6.31,9.57,2,1.0,9.57,0.075,0.107766,TAKER
03/03/2023 00:00:00,18/06/2023 13:26:52,Upscale-Upscale-DUMMY_Gemini_BTCUSD_1h_01_07_22_to_16_06_23.csv,BTC_USD,WEEK,482.99,0.006,21/04/2023 00:00:00,21/04/2023 00:00:00,10/03/2023 00:00:00,STOP_LOSS_HIT,SHORT,20290.0,21899.78,18680.22,21899.78,0.252,8.62,7.35,9.57,2,1.0,-9.75,0.075,0.091305,TAKER
24/03/2023 00:00:00,18/06/2023 13:26:52,Upscale-Upscale-DUMMY_Gemini_BTCUSD_1h_01_07_22_to_16_06_23.csv,BTC_USD,WEEK,473.24,0.001,19/05/2023 00:00:00,12/05/2023 00:00:00,12/05/2023 00:00:00,EXPIRED,LONG,27941.0,26831.0,40815.86,15066.14,0.059,31.54,85.46,12.85,3,1.0,-1.13,0.075,0.02095575,TAKER
24/02/2023 00:00:00,18/06/2023 13:26:52,Upscale-Upscale-DUMMY_Gemini_BTCUSD_1h_01_07_22_to_16_06_23.csv,BTC_USD,WEEK,472.11,0.004,21/04/2023 00:00:00,14/04/2023 00:00:00,03/03/2023 00:00:00,TAKE_PROFIT_HIT,SHORT,23468.0,20996.18,20996.18,25939.82,0.199,11.77,9.53,9.82,2,1.0,9.82,0.075,0.070404,TAKER
17/02/2023 00:00:00,18/06/2023 13:26:52,Upscale-Upscale-DUMMY_Gemini_BTCUSD_1h_01_07_22_to_16_06_23.csv,BTC_USD,WEEK,481.93,0.006,31/03/2023 00:00:00,07/04/2023 00:00:00,03/03/2023 00:00:00,TAKE_PROFIT_HIT,SHORT,23948.0,22334.58,22334.58,25561.42,0.298,7.22,6.31,9.57,2,1.0,9.57,0.075,0.107766,TAKER
24/03/2023 00:00:00,18/06/2023 13:26:52,Upscale-Upscale-DUMMY_Gemini_BTCUSD_1h_01_07_22_to_16_06_23.csv,BTC_USD,WEEK,491.5,0.001,19/05/2023 00:00:00,12/05/2023 00:00:00,12/05/2023 00:00:00,EXPIRED,LONG,27941.0,26831.0,40815.86,15066.14,0.057,31.54,85.46,12.85,3,1.0,-1.13,0.075,0.02095575,TAKER
24/02/2023 00:00:00,18/06/2023 13:26:52,Upscale-Upscale-DUMMY_Gemini_BTCUSD_1h_01_07_22_to_16_06_23.csv,BTC_USD,WEEK,490.37,0.004,21/04/2023 00:00:00,14/04/2023 00:00:00,03/03/2023 00:00:00,TAKE_PROFIT_HIT,SHORT,23468.0,20996.18,20996.18,25939.82,0.191,11.77,9.53,9.82,2,1.0,9.82,0.075,0.070404,TAKER
17/02/2023 00:00:00,18/06/2023 13:26:52,Upscale-Upscale-DUMMY_Gemini_BTCUSD_1h_01_07_22_to_16_06_23.csv,BTC_USD,WEEK,500.19,0.006,31/03/2023 00:00:00,07/04/2023 00:00:00,03/03/2023 00:00:00,TAKE_PROFIT_HIT,SHORT,23948.0,22334.58,22334.58,25561.42,0.287,7.22,6.31,9.57,2,1.0,9.57,0.075,0.107766,TAKER
24/02/2023 00:00:00,18/06/2023 13:26:52,Upscale-Upscale-DUMMY_Gemini_BTCUSD_1h_01_07_22_to_16_06_23.csv,BTC_USD,WEEK,509.76,0.004,21/04/2023 00:00:00,14/04/2023 00:00:00,03/03/2023 00:00:00,TAKE_PROFIT_HIT,SHORT,23468.0,20996.18,20996.18,25939.82,0.184,11.77,9.53,9.82,2,1.0,9.82,0.075,0.070404,TAKER
27/01/2023 00:00:00,18/06/2023 13:26:52,Upscale-Upscale-DUMMY_Gemini_BTCUSD_1h_01_07_22_to_16_06_23.csv,BTC_USD,WEEK,519.58,0.001,24/03/2023 00:00:00,17/03/2023 00:00:00,17/03/2023 00:00:00,EXPIRED,LONG,23487.0,28351.0,34972.35,12001.65,0.045,32.84,95.7,11.47,2,1.0,4.85,0.075,0.01761525,TAKER
17/02/2023 00:00:00,18/06/2023 13:26:52,Upscale-Upscale-DUMMY_Gemini_BTCUSD_1h_01_07_22_to_16_06_23.csv,BTC_USD,WEEK,524.43,0.007,31/03/2023 00:00:00,07/04/2023 00:00:00,03/03/2023 00:00:00,TAKE_PROFIT_HIT,SHORT,23948.0,22334.58,22334.58,25561.42,0.32,7.22,6.31,11.17,2,1.0,11.17,0.075,0.125727,TAKER
17/02/2023 00:00:00,18/06/2023 13:26:52,Upscale-Upscale-DUMMY_Gemini_BTCUSD_1h_01_07_22_to_16_06_23.csv,BTC_USD,WEEK,535.6,0.007,31/03/2023 00:00:00,07/04/2023 00:00:00,03/03/2023 00:00:00,TAKE_PROFIT_HIT,SHORT,23948.0,22334.58,22334.58,25561.42,0.313,7.22,6.31,11.17,2,1.0,11.17,0.075,0.125727,TAKER
03/03/2023 00:00:00,18/06/2023 13:26:52,Upscale-Upscale-DUMMY_Gemini_BTCUSD_1h_01_07_22_to_16_06_23.csv,BTC_USD,WEEK,546.77,0.007,21/04/2023 00:00:00,21/04/2023 00:00:00,10/03/2023 00:00:00,STOP_LOSS_HIT,SHORT,20290.0,21899.78,18680.22,21899.78,0.26,8.62,7.35,11.16,2,1.0,-11.37,0.075,0.1065225,TAKER
27/01/2023 00:00:00,18/06/2023 13:26:52,Upscale-Upscale-DUMMY_Gemini_BTCUSD_1h_01_07_22_to_16_06_23.csv,BTC_USD,WEEK,535.4,0.001,24/03/2023 00:00:00,17/03/2023 00:00:00,17/03/2023 00:00:00,EXPIRED,LONG,23487.0,28351.0,34972.35,12001.65,0.044,32.84,95.7,11.47,2,1.0,4.85,0.075,0.01761525,TAKER
20/01/2023 00:00:00,18/06/2023 13:26:52,Upscale-Upscale-DUMMY_Gemini_BTCUSD_1h_01_07_22_to_16_06_23.csv,BTC_USD,WEEK,540.25,0.002,17/03/2023 00:00:00,10/03/2023 00:00:00,10/03/2023 00:00:00,EXPIRED,LONG,23013.0,25052.0,27602.55,18423.45,0.085,16.63,24.91,9.14,2,1.0,4.04,0.075,0.0345195,TAKER
20/01/2023 00:00:00,18/06/2023 13:26:52,Upscale-Upscale-DUMMY_Gemini_BTCUSD_1h_01_07_22_to_16_06_23.csv,BTC_USD,WEEK,544.29,0.002,17/03/2023 00:00:00,10/03/2023 00:00:00,10/03/2023 00:00:00,EXPIRED,LONG,23013.0,25052.0,27602.55,18423.45,0.085,16.63,24.91,9.14,2,1.0,4.04,0.075,0.0345195,TAKER
24/02/2023 00:00:00,18/06/2023 13:26:52,Upscale-Upscale-DUMMY_Gemini_BTCUSD_1h_01_07_22_to_16_06_23.csv,BTC_USD,WEEK,548.33,0.004,21/04/2023 00:00:00,14/04/2023 00:00:00,03/03/2023 00:00:00,TAKE_PROFIT_HIT,SHORT,23468.0,20996.18,20996.18,25939.82,0.171,11.77,9.53,9.82,2,1.0,9.82,0.075,0.070404,TAKER
27/01/2023 00:00:00,18/06/2023 13:26:52,Upscale-Upscale-DUMMY_Gemini_BTCUSD_1h_01_07_22_to_16_06_23.csv,BTC_USD,WEEK,558.15,0.001,24/03/2023 00:00:00,17/03/2023 00:00:00,17/03/2023 00:00:00,EXPIRED,LONG,23487.0,28351.0,34972.35,12001.65,0.042,32.84,95.7,11.47,2,1.0,4.85,0.075,0.01761525,TAKER
24/02/2023 00:00:00,18/06/2023 13:26:52,Upscale-Upscale-DUMMY_Gemini_BTCUSD_1h_01_07_22_to_16_06_23.csv,BTC_USD,WEEK,563.0,0.005,21/04/2023 00:00:00,14/04/2023 00:00:00,03/03/2023 00:00:00,TAKE_PROFIT_HIT,SHORT,23468.0,20996.18,20996.18,25939.82,0.208,11.77,9.53,12.27,2,1.0,12.27,0.075,0.088005,TAKER
17/02/2023 00:00:00,18/06/2023 13:26:52,Upscale-Upscale-DUMMY_Gemini_BTCUSD_1h_01_07_22_to_16_06_23.csv,BTC_USD,WEEK,575.27,0.007,31/03/2023 00:00:00,07/04/2023 00:00:00,03/03/2023 00:00:00,TAKE_PROFIT_HIT,SHORT,23948.0,22334.58,22334.58,25561.42,0.291,7.22,6.31,11.17,2,1.0,11.17,0.075,0.125727,TAKER
20/01/2023 00:00:00,18/06/2023 13:26:52,Upscale-Upscale-DUMMY_Gemini_BTCUSD_1h_01_07_22_to_16_06_23.csv,BTC_USD,WEEK,586.44,0.003,17/03/2023 00:00:00,10/03/2023 00:00:00,10/03/2023 00:00:00,EXPIRED,LONG,23013.0,25052.0,27602.55,18423.45,0.118,16.63,24.91,13.72,2,1.0,6.07,0.075,0.05177925,TAKER
17/02/2023 00:00:00,18/06/2023 13:26:52,Upscale-Upscale-DUMMY_Gemini_BTCUSD_1h_01_07_22_to_16_06_23.csv,BTC_USD,WEEK,592.51,0.007,31/03/2023 00:00:00,07/04/2023 00:00:00,03/03/2023 00:00:00,TAKE_PROFIT_HIT,SHORT,23948.0,22334.58,22334.58,25561.42,0.283,7.22,6.31,11.17,2,1.0,11.17,0.075,0.125727,TAKER
