Open,Last update,Platform,Symbol,Timeframe,Account balance at open,Size,Expected close,Expiry,Close,Status,Side,Opening price,Closing price,Take profit,Stop loss,Leverage,TP price %,SL price %,Expected profit,Risk %,R/R ratio,PnL,Fee %,Fee Amount,Order Type
17/02/2023 00:00:00,17/06/2023 18:06:50,Upscale-Upscale-DUMMY_Gemini_BTCUSD_1h_01_07_22_to_16_06_23.csv,BTC_USD,WEEK,200.0,0.002,31/03/2023 00:00:00,07/04/2023 00:00:00,03/03/2023 00:00:00,TAKE_PROFIT_HIT,SHORT,23948.0,22334.58,22334.58,25561.42,0.239,7.22,6.31,3.19,2,1.0,3.19,0.075,0.035922,TAKER
24/02/2023 00:00:00,17/06/2023 18:06:50,Upscale-Upscale-DUMMY_Gemini_BTCUSD_1h_01_07_22_to_16_06_23.csv,BTC_USD,WEEK,203.19,0.002,21/04/2023 00:00:00,14/04/2023 00:00:00,03/03/2023 00:00:00,TAKE_PROFIT_HIT,SHORT,23468.0,20996.18,20996.18,25939.82,0.231,11.77,9.53,4.91,2,1.0,4.91,0.075,0.035202,TAKER
24/03/2023 00:00:00,17/06/2023 18:06:50,Upscale-Upscale-DUMMY_Gemini_BTCUSD_1h_01_07_22_to_16_06_23.csv,BTC_USD,WEEK,208.1,0.0,19/05/2023 00:00:00,12/05/2023 00:00:00,12/05/2023 00:00:00,EXPIRED,LONG,27941.0,26831.0,39981.24,15900.77,0.0,30.11,75.72,0.0,0,0.0,0.0,0.075,0.0,TAKER
17/02/2023 00:00:00,17/06/2023 18:06:50,Upscale-Upscale-DUMMY_Gemini_BTCUSD_1h_01_07_22_to_16_06_23.csv,BTC_USD,WEEK,208.1,0.003,31/03/2023 00:00:00,07/04/2023 00:00:00,03/03/2023 00:00:00,TAKE_PROFIT_HIT,SHORT,23948.0,22334.58,22334.58,25561.42,0.345,7.22,6.31,4.79,2,1.0,4.79,0.075,0.053883,TAKER
20/01/2023 00:00:00,17/06/2023 18:06:50,Upscale-Upscale-DUMMY_Gemini_BTCUSD_1h_01_07_22_to_16_06_23.csv,BTC_USD,WEEK,212.89,0.001,17/03/2023 00:00:00,10/03/2023 00:00:00,10/03/2023 00:00:00,EXPIRED,LONG,23013.0,25052.0,27602.55,18423.45,0.108,16.63,24.91,4.57,2,1.0,2.02,0.075,0.01725975,TAKER
03/03/2023 00:00:00,17/06/2023 18:06:50,Upscale-Upscale-DUMMY_Gemini_BTCUSD_1h_01_07_22_to_16_06_23.csv,BTC_USD,WEEK,214.91,0.003,21/04/2023 00:00:00,21/04/2023 00:00:00,10/03/2023 00:00:00,STOP_LOSS_HIT,SHORT,20290.0,21899.78,18680.22,21899.78,0.283,8.62,7.35,4.78,2,1.0,-4.87,0.075,0.0456525,TAKER
20/01/2023 00:00:00,17/06/2023 18:06:50,Upscale-Upscale-DUMMY_Gemini_BTCUSD_1h_01_07_22_to_16_06_23.csv,BTC_USD,WEEK,210.04,0.001,17/03/2023 00:00:00,10/03/2023 00:00:00,10/03/2023 00:00:00,EXPIRED,LONG,23013.0,25052.0,27602.55,18423.45,0.11,16.63,24.91,4.57,2,1.0,2.02,0.075,0.01725975,TAKER
20/01/2023 00:00:00,17/06/2023 18:06:50,Upscale-Upscale-DUMMY_Gemini_BTCUSD_1h_01_07_22_to_16_06_23.csv,BTC_USD,WEEK,212.06,0.001,17/03/2023 00:00:00,10/03/2023 00:00:00,10/03/2023 00:00:00,EXPIRED,LONG,23013.0,25052.0,27602.55,18423.45,0.109,16.63,24.91,4.57,2,1.0,2.02,0.075,0.01725975,TAKER
20/01/2023 00:00:00,17/06/2023 18:06:50,Upscale-Upscale-DUMMY_Gemini_BTCUSD_1h_01_07_22_to_16_06_23.csv,BTC_USD,WEEK,214.08,0.001,17/03/2023 00:00:00,10/03/2023 00:00:00,10/03/2023 00:00:00,EXPIRED,LONG,23013.0,25052.0,27602.55,18423.45,0.107,16.63,24.91,4.57,2,1.0,2.02,0.075,0.01725975,TAKER
24/02/2023 00:00:00,17/06/2023 18:06:50,Upscale-Upscale-DUMMY_Gemini_BTCUSD_1h_01_07_22_to_16_06_23.csv,BTC_USD,WEEK,216.1,0.002,21/04/2023 00:00:00,14/04/2023 00:00:00,03/03/2023 00:00:00,TAKE_PROFIT_HIT,SHORT,23468.0,20996.18,20996.18,25939.82,0.217,11.77,9.53,4.91,2,1.0,4.91,0.075,0.035202,TAKER
24/03/2023 00:00:00,17/06/2023 18:06:50,Upscale-Upscale-DUMMY_Gemini_BTCUSD_1h_01_07_22_to_16_06_23.csv,BTC_USD,WEEK,221.01,0.0,19/05/2023 00:00:00,12/05/2023 00:00:00,12/05/2023 00:00:00,EXPIRED,LONG,27941.0,26831.0,39981.24,15900.77,0.0,30.11,75.72,0.0,0,0.0,0.0,0.075,0.0,TAKER
03/03/2023 00:00:00,17/06/2023 18:06:50,Upscale-Upscale-DUMMY_Gemini_BTCUSD_1h_01_07_22_to_16_06_23.csv,BTC_USD,WEEK,221.01,0.003,21/04/2023 00:00:00,21/04/2023 00:00:00,10/03/2023 00:00:00,STOP_LOSS_HIT,SHORT,20290.0,21899.78,18680.22,21899.78,0.275,8.62,7.35,4.78,2,1.0,-4.87,0.075,0.0456525,TAKER
20/01/2023 00:00:00,17/06/2023 18:06:50,Upscale-Upscale-DUMMY_Gemini_BTCUSD_1h_01_07_22_to_16_06_23.csv,BTC_USD,WEEK,216.14,0.001,17/03/2023 00:00:00,10/03/2023 00:00:00,10/03/2023 00:00:00,EXPIRED,LONG,23013.0,25052.0,27602.55,18423.45,0.106,16.63,24.91,4.57,2,1.0,2.02,0.075,0.01725975,TAKER
03/03/2023 00:00:00,17/06/2023 18:06:50,Upscale-Upscale-DUMMY_Gemini_BTCUSD_1h_01_07_22_to_16_06_23.csv,BTC_USD,WEEK,218.16,0.003,21/04/2023 00:00:00,21/04/2023 00:00:00,10/03/2023 00:00:00,STOP_LOSS_HIT,SHORT,20290.0,21899.78,18680.22,21899.78,0.279,8.62,7.35,4.78,2,1.0,-4.87,0.075,0.0456525,TAKER
03/03/2023 00:00:00,17/06/2023 18:06:50,Upscale-Upscale-DUMMY_Gemini_BTCUSD_1h_01_07_22_to_16_06_23.csv,BTC_USD,WEEK,213.29,0.003,21/04/2023 00:00:00,21/04/2023 00:00:00,10/03/2023 00:00:00,STOP_LOSS_HIT,SHORT,20290.0,21899.78,18680.22,21899.78,0.285,8.62,7.35,4.78,2,1.0,-4.87,0.075,0.0456525,TAKER
17/02/2023 00:00:00,17/06/2023 18:06:50,Upscale-Upscale-DUMMY_Gemini_BTCUSD_1h_01_07_22_to_16_06_23.csv,BTC_USD,WEEK,208.42,0.003,31/03/2023 00:00:00,07/04/2023 00:00:00,03/03/2023 00:00:00,TAKE_PROFIT_HIT,SHORT,23948.0,22334.58,22334.58,25561.42,0.345,7.22,6.31,4.79,2,1.0,4.79,0.075,0.053883,TAKER
03/03/2023 00:00:00,17/06/2023 18:06:50,Upscale-Upscale-DUMMY_Gemini_BTCUSD_1h_01_07_22_to_16_06_23.csv,BTC_USD,WEEK,213.21,0.003,21/04/2023 00:00:00,21/04/2023 00:00:00,10/03/2023 00:00:00,STOP_LOSS_HIT,SHORT,20290.0,21899.78,18680.22,21899.78,0.285,8.62,7.35,4.78,2,1.0,-4.87,0.075,0.0456525,TAKER
20/01/2023 00:00:00,17/06/2023 18:06:50,Upscale-Upscale-DUMMY_Gemini_BTCUSD_1h_01_07_22_to_16_06_23.csv,BTC_USD,WEEK,208.34,0.001,17/03/2023 00:00:00,10/03/2023 00:00:00,10/03/2023 00:00:00,EXPIRED,LONG,23013.0,25052.0,27602.55,18423.45,0.11,16.63,24.91,4.57,2,1.0,2.02,0.075,0.01725975,TAKER
27/01/2023 00:00:00,17/06/2023 18:06:50,Upscale-Upscale-DUMMY_Gemini_BTCUSD_1h_01_07_22_to_16_06_23.csv,BTC_USD,WEEK,210.36,0.0,24/03/2023 00:00:00,17/03/2023 00:00:00,17/03/2023 00:00:00,EXPIRED,LONG,23487.0,28351.0,34225.92,12748.09,0.0,31.38,84.24,0.0,0,0.0,0.0,0.075,0.0,TAKER
17/02/2023 00:00:00,17/06/2023 18:06:50,Upscale-Upscale-DUMMY_Gemini_BTCUSD_1h_01_07_22_to_16_06_23.csv,BTC_USD,WEEK,210.36,0.003,31/03/2023 00:00:00,07/04/2023 00:00:00,03/03/2023 00:00:00,TAKE_PROFIT_HIT,SHORT,23948.0,22334.58,22334.58,25561.42,0.342,7.22,6.31,4.79,2,1.0,4.79,0.075,0.053883,TAKER
27/01/2023 00:00:00,17/06/2023 18:06:50,Upscale-Upscale-DUMMY_Gemini_BTCUSD_1h_01_07_22_to_16_06_23.csv,BTC_USD,WEEK,215.15,0.0,24/03/2023 00:00:00,17/03/2023 00:00:00,17/03/2023 00:00:00,EXPIRED,LONG,23487.0,28351.0,34225.92,12748.09,0.0,31.38,84.24,0.0,0,0.0,0.0,0.075,0.0,TAKER
27/01/2023 00:00:00,17/06/2023 18:06:50,Upscale-Upscale-DUMMY_Gemini_BTCUSD_1h_01_07_22_to_16_06_23.csv,BTC_USD,WEEK,215.15,0.0,24/03/2023 00:00:00,17/03/2023 00:00:00,17/03/2023 00:00:00,EXPIRED,LONG,23487.0,28351.0,34225.92,12748.09,0.0,31.38,84.24,0.0,0,0.0,0.0,0.075,0.0,TAKER
24/02/2023 00:00:00,17/06/2023 18:06:50,Upscale-Upscale-DUMMY_Gemini_BTCUSD_1h_01_07_22_to_16_06_23.csv,BTC_USD,WEEK,215.15,0.002,21/04/2023 00:00:00,14/04/2023 00:00:00,03/03/2023 00:00:00,TAKE_PROFIT_HIT,SHORT,23468.0,20996.18,20996.18,25939.82,0.218,11.77,9.53,4.91,2,1.0,4.91,0.075,0.035202,TAKER
24/03/2023 00:00:00,17/06/2023 18:06:50,Upscale-Upscale-DUMMY_Gemini_BTCUSD_1h_01_07_22_to_16_06_23.csv,BTC_USD,WEEK,220.06,0.0,19/05/2023 00:00:00,12/05/2023 00:00:00,12/05/2023 00:00:00,EXPIRED,LONG,27941.0,26831.0,39981.24,15900.77,0.0,30.11,75.72,0.0,0,0.0,0.0,0.075,0.0,TAKER
24/02/2023 00:00:00,17/06/2023 18:06:50,Upscale-Upscale-DUMMY_Gemini_BTCUSD_1h_01_07_22_to_16_06_23.csv,BTC_USD,WEEK,220.06,0.002,21/04/2023 00:00:00,14/04/2023 00:00:00,03/03/2023 00:00:00,TAKE_PROFIT_HIT,SHORT,23468.0,20996.18,20996.18,25939.82,0.213,11.77,9.53,4.91,2,1.0,4.91,0.075,0.035202,TAKER
03/03/2023 00:00:00,17/06/2023 18:06:50,Upscale-Upscale-DUMMY_Gemini_BTCUSD_1h_01_07_22_to_16_06_23.csv,BTC_USD,WEEK,224.97,0.003,21/04/2023 00:00:00,21/04/2023 00:00:00,10/03/2023 00:00:00,STOP_LOSS_HIT,SHORT,20290.0,21899.78,18680.22,21899.78,0.271,8.62,7.35,4.78,2,1.0,-4.87,0.075,0.0456525,TAKER
20/01/2023 00:00:00,17/06/2023 18:06:50,Upscale-Upscale-DUMMY_Gemini_BTCUSD_1h_01_07_22_to_16_06_23.csv,BTC_USD,WEEK,220.1,0.001,17/03/2023 00:00:00,10/03/2023 00:00:00,10/03/2023 00:00:00,EXPIRED,LONG,23013.0,25052.0,27602.55,18423.45,0.105,16.63,24.91,4.57,2,1.0,2.02,0.075,0.01725975,TAKER
03/03/2023 00:00:00,17/06/2023 18:06:50,Upscale-Upscale-DUMMY_Gemini_BTCUSD_1h_01_07_22_to_16_06_23.csv,BTC_USD,WEEK,222.12,0.003,21/04/2023 00:00:00,21/04/2023 00:00:00,10/03/2023 00:00:00,STOP_LOSS_HIT,SHORT,20290.0,21899.78,18680.22,21899.78,0.274,8.62,7.35,4.78,2,1.0,-4.87,0.075,0.0456525,TAKER
03/03/2023 00:00:00,17/06/2023 18:06:50,Upscale-Upscale-DUMMY_Gemini_BTCUSD_1h_01_07_22_to_16_06_23.csv,BTC_USD,WEEK,217.25,0.003,21/04/2023 00:00:00,21/04/2023 00:00:00,10/03/2023 00:00:00,STOP_LOSS_HIT,SHORT,20290.0,21899.78,18680.22,21899.78,0.28,8.62,7.35,4.78,2,1.0,-4.87,0.075,0.0456525,TAKER
27/01/2023 00:00:00,17/06/2023 18:06:50,Upscale-Upscale-DUMMY_Gemini_BTCUSD_1h_01_07_22_to_16_06_23.csv,BTC_USD,WEEK,212.38,0.0,24/03/2023 00:00:00,17/03/2023 00:00:00,17/03/2023 00:00:00,EXPIRED,LONG,23487.0,28351.0,34225.92,12748.09,0.0,31.38,84.24,0.0,0,0.0,0.0,0.075,0.0,TAKER
27/01/2023 00:00:00,17/06/2023 18:06:50,Upscale-Upscale-DUMMY_Gemini_BTCUSD_1h_01_07_22_to_16_06_23.csv,BTC_USD,WEEK,212.38,0.0,24/03/2023 00:00:00,17/03/2023 00:00:00,17/03/2023 00:00:00,EXPIRED,LONG,23487.0,28351.0,34225.92,12748.09,0.0,31.38,84.24,0.0,0,0.0,0.0,0.075,0.0,TAKER
17/02/2023 00:00:00,17/06/2023 18:06:50,Upscale-Upscale-DUMMY_Gemini_BTCUSD_1h_01_07_22_to_16_06_23.csv,BTC_USD,WEEK,212.38,0.003,31/03/2023 00:00:00,07/04/2023 00:00:00,03/03/2023 00:00:00,TAKE_PROFIT_HIT,SHORT,23948.0,22334.58,22334.58,25561.42,0.338,7.22,6.31,4.79,2,1.0,4.79,0.075,0.053883,TAKER
20/01/2023 00:00:00,17/06/2023 18:06:50,Upscale-Upscale-DUMMY_Gemini_BTCUSD_1h_01_07_22_to_16_06_23.csv,BTC_USD,WEEK,217.17,0.001,17/03/2023 00:00:00,10/03/2023 00:00:00,10/03/2023 00:00:00,EXPIRED,LONG,23013.0,25052.0,27602.55,18423.45,0.106,16.63,24.91,4.57,2,1.0,2.02,0.075,0.01725975,TAKER
24/02/2023 00:00:00,17/06/2023 18:06:50,Upscale-Upscale-DUMMY_Gemini_BTCUSD_1h_01_07_22_to_16_06_23.csv,BTC_USD,WEEK,219.19,0.002,21/04/2023 00:00:00,14/04/2023 00:00:00,03/03/2023 00:00:00,TAKE_PROFIT_HIT,SHORT,23468.0,20996.18,20996.18,25939.82,0.214,11.77,9.53,4.91,2,1.0,4.91,0.075,0.035202,TAKER
03/03/2023 00:00:00,17/06/2023 18:06:50,Upscale-Upscale-DUMMY_Gemini_BTCUSD_1h_01_07_22_to_16_06_23.csv,BTC_USD,WEEK,224.1,0.003,21/04/2023 00:00:00,21/04/2023 00:00:00,10/03/2023 00:00:00,STOP_LOSS_HIT,SHORT,20290.0,21899.78,18680.22,21899.78,0.272,8.62,7.35,4.78,2,1.0,-4.87,0.075,0.0456525,TAKER
27/01/2023 00:00:00,17/06/2023 18:06:50,Upscale-Upscale-DUMMY_Gemini_BTCUSD_1h_01_07_22_to_16_06_23.csv,BTC_USD,WEEK,219.23,0.0,24/03/2023 00:00:00,17/03/2023 00:00:00,17/03/2023 00:00:00,EXPIRED,LONG,23487.0,28351.0,34225.92,12748.09,0.0,31.38,84.24,0.0,0,0.0,0.0,0.075,0.0,TAKER
27/01/2023 00:00:00,17/06/2023 18:06:50,Upscale-Upscale-DUMMY_Gemini_BTCUSD_1h_01_07_22_to_16_06_23.csv,BTC_USD,WEEK,219.23,0.0,24/03/2023 00:00:00,17/03/2023 00:00:00,17/03/2023 00:00:00,EXPIRED,LONG,23487.0,28351.0,34225.92,12748.09,0.0,31.38,84.24,0.0,0,0.0,0.0,0.075,0.0,TAKER
24/03/2023 00:00:00,17/06/2023 18:06:50,Upscale-Upscale-DUMMY_Gemini_BTCUSD_1h_01_07_22_to_16_06_23.csv,BTC_USD,WEEK,219.23,0.0,19/05/2023 00:00:00,12/05/2023 00:00:00,12/05/2023 00:00:00,EXPIRED,LONG,27941.0,26831.0,39981.24,15900.77,0.0,30.11,75.72,0.0,0,0.0,0.0,0.075,0.0,TAKER
24/03/2023 00:00:00,17/06/2023 18:06:50,Upscale-Upscale-DUMMY_Gemini_BTCUSD_1h_01_07_22_to_16_06_23.csv,BTC_USD,WEEK,219.23,0.0,19/05/2023 00:00:00,12/05/2023 00:00:00,12/05/2023 00:00:00,EXPIRED,LONG,27941.0,26831.0,39981.24,15900.77,0.0,30.11,75.72,0.0,0,0.0,0.0,0.075,0.0,TAKER
20/01/2023 00:00:00,17/06/2023 18:06:50,Upscale-Upscale-DUMMY_Gemini_BTCUSD_1h_01_07_22_to_16_06_23.csv,BTC_USD,WEEK,219.23,0.001,17/03/2023 00:00:00,10/03/2023 00:00:00,10/03/2023 00:00:00,EXPIRED,LONG,23013.0,25052.0,27602.55,18423.45,0.105,16.63,24.91,4.57,2,1.0,2.02,0.075,0.01725975,TAKER
24/02/2023 00:00:00,17/06/2023 18:06:50,Upscale-Upscale-DUMMY_Gemini_BTCUSD_1h_01_07_22_to_16_06_23.csv,BTC_USD,WEEK,221.25,0.002,21/04/2023 00:00:00,14/04/2023 00:00:00,03/03/2023 00:00:00,TAKE_PROFIT_HIT,SHORT,23468.0,20996.18,20996.18,25939.82,0.212,11.77,9.53,4.91,2,1.0,4.91,0.075,0.035202,TAKER
24/02/2023 00:00:00,17/06/2023 18:06:50,Upscale-Upscale-DUMMY_Gemini_BTCUSD_1h_01_07_22_to_16_06_23.csv,BTC_USD,WEEK,226.16,0.002,21/04/2023 00:00:00,14/04/2023 00:00:00,03/03/2023 00:00:00,TAKE_PROFIT_HIT,SHORT,23468.0,20996.18,20996.18,25939.82,0.208,11.77,9.53,4.91,2,1.0,4.91,0.075,0.035202,TAKER
24/02/2023 00:00:00,17/06/2023 18:06:50,Upscale-Upscale-DUMMY_Gemini_BTCUSD_1h_01_07_22_to_16_06_23.csv,BTC_USD,WEEK,231.07,0.002,21/04/2023 00:00:00,14/04/2023 00:00:00,03/03/2023 00:00:00,TAKE_PROFIT_HIT,SHORT,23468.0,20996.18,20996.18,25939.82,0.203,11.77,9.53,4.91,2,1.0,4.91,0.075,0.035202,TAKER
24/02/2023 00:00:00,17/06/2023 18:06:50,Upscale-Upscale-DUMMY_Gemini_BTCUSD_1h_01_07_22_to_16_06_23.csv,BTC_USD,WEEK,235.98,0.002,21/04/2023 00:00:00,14/04/2023 00:00:00,03/03/2023 00:00:00,TAKE_PROFIT_HIT,SHORT,23468.0,20996.18,20996.18,25939.82,0.199,11.77,9.53,4.91,2,1.0,4.91,0.075,0.035202,TAKER
03/03/2023 00:00:00,17/06/2023 18:06:50,Upscale-Upscale-DUMMY_Gemini_BTCUSD_1h_01_07_22_to_16_06_23.csv,BTC_USD,WEEK,240.89,0.003,21/04/2023 00:00:00,21/04/2023 00:00:00,10/03/2023 00:00:00,STOP_LOSS_HIT,SHORT,20290.0,21899.78,18680.22,21899.78,0.253,8.62,7.35,4.78,2,1.0,-4.87,0.075,0.0456525,TAKER
27/01/2023 00:00:00,17/06/2023 18:06:50,Upscale-Upscale-DUMMY_Gemini_BTCUSD_1h_01_07_22_to_16_06_23.csv,BTC_USD,WEEK,236.02,0.0,24/03/2023 00:00:00,17/03/2023 00:00:00,17/03/2023 00:00:00,EXPIRED,LONG,23487.0,28351.0,34225.92,12748.09,0.0,31.38,84.24,0.0,0,0.0,0.0,0.075,0.0,TAKER
17/02/2023 00:00:00,17/06/2023 18:06:50,Upscale-Upscale-DUMMY_Gemini_BTCUSD_1h_01_07_22_to_16_06_23.csv,BTC_USD,WEEK,236.02,0.003,31/03/2023 00:00:00,07/04/2023 00:00:00,03/03/2023 00:00:00,TAKE_PROFIT_HIT,SHORT,23948.0,22334.58,22334.58,25561.42,0.304,7.22,6.31,4.79,2,1.0,4.79,0.075,0.053883,TAKER
03/03/2023 00:00:00,17/06/2023 18:06:50,Upscale-Upscale-DUMMY_Gemini_BTCUSD_1h_01_07_22_to_16_06_23.csv,BTC_USD,WEEK,240.81,0.003,21/04/2023 00:00:00,21/04/2023 00:00:00,10/03/2023 00:00:00,STOP_LOSS_HIT,SHORT,20290.0,21899.78,18680.22,21899.78,0.253,8.62,7.35,4.78,2,1.0,-4.87,0.075,0.0456525,TAKER
24/03/2023 00:00:00,17/06/2023 18:06:50,Upscale-Upscale-DUMMY_Gemini_BTCUSD_1h_01_07_22_to_16_06_23.csv,BTC_USD,WEEK,235.94,0.0,19/05/2023 00:00:00,12/05/2023 00:00:00,12/05/2023 00:00:00,EXPIRED,LONG,27941.0,26831.0,39981.24,15900.77,0.0,30.11,75.72,0.0,0,0.0,0.0,0.075,0.0,TAKER
20/01/2023 00:00:00,17/06/2023 18:06:50,Upscale-Upscale-DUMMY_Gemini_BTCUSD_1h_01_07_22_to_16_06_23.csv,BTC_USD,WEEK,235.94,0.001,17/03/2023 00:00:00,10/03/2023 00:00:00,10/03/2023 00:00:00,EXPIRED,LONG,23013.0,25052.0,27602.55,18423.45,0.098,16.63,24.91,4.57,2,1.0,2.02,0.075,0.01725975,TAKER
17/02/2023 00:00:00,17/06/2023 18:06:50,Upscale-Upscale-DUMMY_Gemini_BTCUSD_1h_01_07_22_to_16_06_23.csv,BTC_USD,WEEK,237.96,0.003,31/03/2023 00:00:00,07/04/2023 00:00:00,03/03/2023 00:00:00,TAKE_PROFIT_HIT,SHORT,23948.0,22334.58,22334.58,25561.42,0.302,7.22,6.31,4.79,2,1.0,4.79,0.075,0.053883,TAKER
17/02/2023 00:00:00,17/06/2023 18:06:50,Upscale-Upscale-DUMMY_Gemini_BTCUSD_1h_01_07_22_to_16_06_23.csv,BTC_USD,WEEK,242.75,0.003,31/03/2023 00:00:00,07/04/2023 00:00:00,03/03/2023 00:00:00,TAKE_PROFIT_HIT,SHORT,23948.0,22334.58,22334.58,25561.42,0.296,7.22,6.31,4.79,2,1.0,4.79,0.075,0.053883,TAKER
27/01/2023 00:00:00,17/06/2023 18:06:50,Upscale-Upscale-DUMMY_Gemini_BTCUSD_1h_01_07_22_to_16_06_23.csv,BTC_USD,WEEK,247.54,0.0,24/03/2023 00:00:00,17/03/2023 00:00:00,17/03/2023 00:00:00,EXPIRED,LONG,23487.0,28351.0,34225.92,12748.09,0.0,31.38,84.24,0.0,0,0.0,0.0,0.075,0.0,TAKER
24/02/2023 00:00:00,17/06/2023 18:06:50,Upscale-Upscale-DUMMY_Gemini_BTCUSD_1h_01_07_22_to_16_06_23.csv,BTC_USD,WEEK,247.54,0.002,21/04/2023 00:00:00,14/04/2023 00:00:00,03/03/2023 00:00:00,TAKE_PROFIT_HIT,SHORT,23468.0,20996.18,20996.18,25939.82,0.19,11.77,9.53,4.91,2,1.0,4.91,0.075,0.035202,TAKER
20/01/2023 00:00:00,17/06/2023 18:06:50,Upscale-Upscale-DUMMY_Gemini_BTCUSD_1h_01_07_22_to_16_06_23.csv,BTC_USD,WEEK,252.45,0.001,17/03/2023 00:00:00,10/03/2023 00:00:00,10/03/2023 00:00:00,EXPIRED,LONG,23013.0,25052.0,27602.55,18423.45,0.091,16.63,24.91,4.57,2,1.0,2.02,0.075,0.01725975,TAKER
17/02/2023 00:00:00,17/06/2023 18:06:50,Upscale-Upscale-DUMMY_Gemini_BTCUSD_1h_01_07_22_to_16_06_23.csv,BTC_USD,WEEK,254.47,0.003,31/03/2023 00:00:00,07/04/2023 00:00:00,03/03/2023 00:00:00,TAKE_PROFIT_HIT,SHORT,23948.0,22334.58,22334.58,25561.42,0.282,7.22,6.31,4.79,2,1.0,4.79,0.075,0.053883,TAKER
03/03/2023 00:00:00,17/06/2023 18:06:50,Upscale-Upscale-DUMMY_Gemini_BTCUSD_1h_01_07_22_to_16_06_23.csv,BTC_USD,WEEK,259.26,0.003,21/04/2023 00:00:00,21/04/2023 00:00:00,10/03/2023 00:00:00,STOP_LOSS_HIT,SHORT,20290.0,21899.78,18680.22,21899.78,0.235,8.62,7.35,4.78,2,1.0,-4.87,0.075,0.0456525,TAKER
03/03/2023 00:00:00,17/06/2023 18:06:50,Upscale-Upscale-DUMMY_Gemini_BTCUSD_1h_01_07_22_to_16_06_23.csv,BTC_USD,WEEK,254.39,0.003,21/04/2023 00:00:00,21/04/2023 00:00:00,10/03/2023 00:00:00,STOP_LOSS_HIT,SHORT,20290.0,21899.78,18680.22,21899.78,0.239,8.62,7.35,4.78,2,1.0,-4.87,0.075,0.0456525,TAKER
24/02/2023 00:00:00,17/06/2023 18:06:50,Upscale-Upscale-DUMMY_Gemini_BTCUSD_1h_01_07_22_to_16_06_23.csv,BTC_USD,WEEK,249.52,0.002,21/04/2023 00:00:00,14/04/2023 00:00:00,03/03/2023 00:00:00,TAKE_PROFIT_HIT,SHORT,23468.0,20996.18,20996.18,25939.82,0.188,11.77,9.53,4.91,2,1.0,4.91,0.075,0.035202,TAKER
24/02/2023 00:00:00,17/06/2023 18:06:50,Upscale-Upscale-DUMMY_Gemini_BTCUSD_1h_01_07_22_to_16_06_23.csv,BTC_USD,WEEK,254.43,0.002,21/04/2023 00:00:00,14/04/2023 00:00:00,03/03/2023 00:00:00,TAKE_PROFIT_HIT,SHORT,23468.0,20996.18,20996.18,25939.82,0.184,11.77,9.53,4.91,2,1.0,4.91,0.075,0.035202,TAKER
24/03/2023 00:00:00,17/06/2023 18:06:50,Upscale-Upscale-DUMMY_Gemini_BTCUSD_1h_01_07_22_to_16_06_23.csv,BTC_USD,WEEK,259.34,0.0,19/05/2023 00:00:00,12/05/2023 00:00:00,12/05/2023 00:00:00,EXPIRED,LONG,27941.0,26831.0,39981.24,15900.77,0.0,30.11,75.72,0.0,0,0.0,0.0,0.075,0.0,TAKER
17/02/2023 00:00:00,17/06/2023 18:06:50,Upscale-Upscale-DUMMY_Gemini_BTCUSD_1h_01_07_22_to_16_06_23.csv,BTC_USD,WEEK,259.34,0.003,31/03/2023 00:00:00,07/04/2023 00:00:00,03/03/2023 00:00:00,TAKE_PROFIT_HIT,SHORT,23948.0,22334.58,22334.58,25561.42,0.277,7.22,6.31,4.79,2,1.0,4.79,0.075,0.053883,TAKER
27/01/2023 00:00:00,17/06/2023 18:06:50,Upscale-Upscale-DUMMY_Gemini_BTCUSD_1h_01_07_22_to_16_06_23.csv,BTC_USD,WEEK,264.13,0.0,24/03/2023 00:00:00,17/03/2023 00:00:00,17/03/2023 00:00:00,EXPIRED,LONG,23487.0,28351.0,34225.92,12748.09,0.0,31.38,84.24,0.0,0,0.0,0.0,0.075,0.0,TAKER
17/02/2023 00:00:00,17/06/2023 18:06:50,Upscale-Upscale-DUMMY_Gemini_BTCUSD_1h_01_07_22_to_16_06_23.csv,BTC_USD,WEEK,264.13,0.003,31/03/2023 00:00:00,07/04/2023 00:00:00,03/03/2023 00:00:00,TAKE_PROFIT_HIT,SHORT,23948.0,22334.58,22334.58,25561.42,0.272,7.22,6.31,4.79,2,1.0,4.79,0.075,0.053883,TAKER
27/01/2023 00:00:00,17/06/2023 18:06:50,Upscale-Upscale-DUMMY_Gemini_BTCUSD_1h_01_07_22_to_16_06_23.csv,BTC_USD,WEEK,268.92,0.001,24/03/2023 00:00:00,17/03/2023 00:00:00,17/03/2023 00:00:00,EXPIRED,LONG,23487.0,28351.0,34225.92,12748.09,0.087,31.38,84.24,10.72,4,1.0,4.85,0.075,0.01761525,TAKER
20/01/2023 00:00:00,17/06/2023 18:06:50,Upscale-Upscale-DUMMY_Gemini_BTCUSD_1h_01_07_22_to_16_06_23.csv,BTC_USD,WEEK,273.77,0.001,17/03/2023 00:00:00,10/03/2023 00:00:00,10/03/2023 00:00:00,EXPIRED,LONG,23013.0,25052.0,27602.55,18423.45,0.084,16.63,24.91,4.57,2,1.0,2.02,0.075,0.01725975,TAKER
27/01/2023 00:00:00,17/06/2023 18:06:50,Upscale-Upscale-DUMMY_Gemini_BTCUSD_1h_01_07_22_to_16_06_23.csv,BTC_USD,WEEK,275.79,0.001,24/03/2023 00:00:00,17/03/2023 00:00:00,17/03/2023 00:00:00,EXPIRED,LONG,23487.0,28351.0,34225.92,12748.09,0.085,31.38,84.24,10.72,4,1.0,4.85,0.075,0.01761525,TAKER
24/02/2023 00:00:00,17/06/2023 18:06:50,Upscale-Upscale-DUMMY_Gemini_BTCUSD_1h_01_07_22_to_16_06_23.csv,BTC_USD,WEEK,280.64,0.002,21/04/2023 00:00:00,14/04/2023 00:00:00,03/03/2023 00:00:00,TAKE_PROFIT_HIT,SHORT,23468.0,20996.18,20996.18,25939.82,0.167,11.77,9.53,4.91,2,1.0,4.91,0.075,0.035202,TAKER
20/01/2023 00:00:00,17/06/2023 18:06:50,Upscale-Upscale-DUMMY_Gemini_BTCUSD_1h_01_07_22_to_16_06_23.csv,BTC_USD,WEEK,285.55,0.001,17/03/2023 00:00:00,10/03/2023 00:00:00,10/03/2023 00:00:00,EXPIRED,LONG,23013.0,25052.0,27602.55,18423.45,0.081,16.63,24.91,4.57,2,1.0,2.02,0.075,0.01725975,TAKER
24/02/2023 00:00:00,17/06/2023 18:06:50,Upscale-Upscale-DUMMY_Gemini_BTCUSD_1h_01_07_22_to_16_06_23.csv,BTC_USD,WEEK,287.57,0.002,21/04/2023 00:00:00,14/04/2023 00:00:00,03/03/2023 00:00:00,TAKE_PROFIT_HIT,SHORT,23468.0,20996.18,20996.18,25939.82,0.163,11.77,9.53,4.91,2,1.0,4.91,0.075,0.035202,TAKER
24/02/2023 00:00:00,17/06/2023 18:06:50,Upscale-Upscale-DUMMY_Gemini_BTCUSD_1h_01_07_22_to_16_06_23.csv,BTC_USD,WEEK,292.48,0.002,21/04/2023 00:00:00,14/04/2023 00:00:00,03/03/2023 00:00:00,TAKE_PROFIT_HIT,SHORT,23468.0,20996.18,20996.18,25939.82,0.16,11.77,9.53,4.91,2,1.0,4.91,0.075,0.035202,TAKER
17/02/2023 00:00:00,17/06/2023 18:06:50,Upscale-Upscale-DUMMY_Gemini_BTCUSD_1h_01_07_22_to_16_06_23.csv,BTC_USD,WEEK,297.39,0.004,31/03/2023 00:00:00,07/04/2023 00:00:00,03/03/2023 00:00:00,TAKE_PROFIT_HIT,SHORT,23948.0,22334.58,22334.58,25561.42,0.322,7.22,6.31,6.38,2,1.0,6.38,0.075,0.071844,TAKER
17/02/2023 00:00:00,17/06/2023 18:06:50,Upscale-Upscale-DUMMY_Gemini_BTCUSD_1h_01_07_22_to_16_06_23.csv,BTC_USD,WEEK,303.77,0.004,31/03/2023 00:00:00,07/04/2023 00:00:00,03/03/2023 00:00:00,TAKE_PROFIT_HIT,SHORT,23948.0,22334.58,22334.58,25561.42,0.315,7.22,6.31,6.38,2,1.0,6.38,0.075,0.071844,TAKER
20/01/2023 00:00:00,17/06/2023 18:06:50,Upscale-Upscale-DUMMY_Gemini_BTCUSD_1h_01_07_22_to_16_06_23.csv,BTC_USD,WEEK,310.15,0.001,17/03/2023 00:00:00,10/03/2023 00:00:00,10/03/2023 00:00:00,EXPIRED,LONG,23013.0,25052.0,27602.55,18423.45,0.074,16.63,24.91,4.57,1,1.0,2.02,0.075,0.01725975,TAKER
24/03/2023 00:00:00,17/06/2023 18:06:50,Upscale-Upscale-DUMMY_Gemini_BTCUSD_1h_01_07_22_to_16_06_23.csv,BTC_USD,WEEK,312.17,0.001,19/05/2023 00:00:00,12/05/2023 00:00:00,12/05/2023 00:00:00,EXPIRED,LONG,27941.0,26831.0,39981.24,15900.77,0.09,30.11,75.72,12.02,4,1.0,-1.13,0.075,0.02095575,TAKER
24/02/2023 00:00:00,17/06/2023 18:06:50,Upscale-Upscale-DUMMY_Gemini_BTCUSD_1h_01_07_22_to_16_06_23.csv,BTC_USD,WEEK,311.04,0.003,21/04/2023 00:00:00,14/04/2023 00:00:00,03/03/2023 00:00:00,TAKE_PROFIT_HIT,SHORT,23468.0,20996.18,20996.18,25939.82,0.226,11.77,9.53,7.36,2,1.0,7.36,0.075,0.052802999999999996,TAKER
20/01/2023 00:00:00,17/06/2023 18:06:50,Upscale-Upscale-DUMMY_Gemini_BTCUSD_1h_01_07_22_to_16_06_23.csv,BTC_USD,WEEK,318.4,0.001,17/03/2023 00:00:00,10/03/2023 00:00:00,10/03/2023 00:00:00,EXPIRED,LONG,23013.0,25052.0,27602.55,18423.45,0.072,16.63,24.91,4.57,1,1.0,2.02,0.075,0.01725975,TAKER
17/02/2023 00:00:00,17/06/2023 18:06:50,Upscale-Upscale-DUMMY_Gemini_BTCUSD_1h_01_07_22_to_16_06_23.csv,BTC_USD,WEEK,320.42,0.004,31/03/2023 00:00:00,07/04/2023 00:00:00,03/03/2023 00:00:00,TAKE_PROFIT_HIT,SHORT,23948.0,22334.58,22334.58,25561.42,0.299,7.22,6.31,6.38,2,1.0,6.38,0.075,0.071844,TAKER
24/03/2023 00:00:00,17/06/2023 18:06:50,Upscale-Upscale-DUMMY_Gemini_BTCUSD_1h_01_07_22_to_16_06_23.csv,BTC_USD,WEEK,326.8,0.001,19/05/2023 00:00:00,12/05/2023 00:00:00,12/05/2023 00:00:00,EXPIRED,LONG,27941.0,26831.0,39981.24,15900.77,0.085,30.11,75.72,12.02,4,1.0,-1.13,0.075,0.02095575,TAKER
17/02/2023 00:00:00,17/06/2023 18:06:50,Upscale-Upscale-DUMMY_Gemini_BTCUSD_1h_01_07_22_to_16_06_23.csv,BTC_USD,WEEK,325.67,0.004,31/03/2023 00:00:00,07/04/2023 00:00:00,03/03/2023 00:00:00,TAKE_PROFIT_HIT,SHORT,23948.0,22334.58,22334.58,25561.42,0.294,7.22,6.31,6.38,2,1.0,6.38,0.075,0.071844,TAKER
24/03/2023 00:00:00,17/06/2023 18:06:50,Upscale-Upscale-DUMMY_Gemini_BTCUSD_1h_01_07_22_to_16_06_23.csv,BTC_USD,WEEK,332.05,0.001,19/05/2023 00:00:00,12/05/2023 00:00:00,12/05/2023 00:00:00,EXPIRED,LONG,27941.0,26831.0,39981.24,15900.77,0.084,30.11,75.72,12.02,4,1.0,-1.13,0.075,0.02095575,TAKER
20/01/2023 00:00:00,17/06/2023 18:06:50,Upscale-Upscale-DUMMY_Gemini_BTCUSD_1h_01_07_22_to_16_06_23.csv,BTC_USD,WEEK,330.92,0.001,17/03/2023 00:00:00,10/03/2023 00:00:00,10/03/2023 00:00:00,EXPIRED,LONG,23013.0,25052.0,27602.55,18423.45,0.07,16.63,24.91,4.57,1,1.0,2.02,0.075,0.01725975,TAKER
03/03/2023 00:00:00,17/06/2023 18:06:50,Upscale-Upscale-DUMMY_Gemini_BTCUSD_1h_01_07_22_to_16_06_23.csv,BTC_USD,WEEK,332.94,0.004,21/04/2023 00:00:00,21/04/2023 00:00:00,10/03/2023 00:00:00,STOP_LOSS_HIT,SHORT,20290.0,21899.78,18680.22,21899.78,0.244,8.62,7.35,6.38,2,1.0,-6.5,0.075,0.06087,TAKER
27/01/2023 00:00:00,17/06/2023 18:06:50,Upscale-Upscale-DUMMY_Gemini_BTCUSD_1h_01_07_22_to_16_06_23.csv,BTC_USD,WEEK,326.44,0.001,24/03/2023 00:00:00,17/03/2023 00:00:00,17/03/2023 00:00:00,EXPIRED,LONG,23487.0,28351.0,34225.92,12748.09,0.072,31.38,84.24,10.72,3,1.0,4.85,0.075,0.01761525,TAKER
27/01/2023 00:00:00,17/06/2023 18:06:50,Upscale-Upscale-DUMMY_Gemini_BTCUSD_1h_01_07_22_to_16_06_23.csv,BTC_USD,WEEK,331.29,0.001,24/03/2023 00:00:00,17/03/2023 00:00:00,17/03/2023 00:00:00,EXPIRED,LONG,23487.0,28351.0,34225.92,12748.09,0.071,31.38,84.24,10.72,3,1.0,4.85,0.075,0.01761525,TAKER
24/03/2023 00:00:00,17/06/2023 18:06:50,Upscale-Upscale-DUMMY_Gemini_BTCUSD_1h_01_07_22_to_16_06_23.csv,BTC_USD,WEEK,336.14,0.001,19/05/2023 00:00:00,12/05/2023 00:00:00,12/05/2023 00:00:00,EXPIRED,LONG,27941.0,26831.0,39981.24,15900.77,0.083,30.11,75.72,12.02,4,1.0,-1.13,0.075,0.02095575,TAKER
27/01/2023 00:00:00,17/06/2023 18:06:50,Upscale-Upscale-DUMMY_Gemini_BTCUSD_1h_01_07_22_to_16_06_23.csv,BTC_USD,WEEK,335.01,0.001,24/03/2023 00:00:00,17/03/2023 00:00:00,17/03/2023 00:00:00,EXPIRED,LONG,23487.0,28351.0,34225.92,12748.09,0.07,31.38,84.24,10.72,3,1.0,4.85,0.075,0.01761525,TAKER
24/02/2023 00:00:00,17/06/2023 18:06:50,Upscale-Upscale-DUMMY_Gemini_BTCUSD_1h_01_07_22_to_16_06_23.csv,BTC_USD,WEEK,339.86,0.003,21/04/2023 00:00:00,14/04/2023 00:00:00,03/03/2023 00:00:00,TAKE_PROFIT_HIT,SHORT,23468.0,20996.18,20996.18,25939.82,0.207,11.77,9.53,7.36,2,1.0,7.36,0.075,0.052802999999999996,TAKER
20/01/2023 00:00:00,17/06/2023 18:06:50,Upscale-Upscale-DUMMY_Gemini_BTCUSD_1h_01_07_22_to_16_06_23.csv,BTC_USD,WEEK,347.22,0.002,17/03/2023 00:00:00,10/03/2023 00:00:00,10/03/2023 00:00:00,EXPIRED,LONG,23013.0,25052.0,27602.55,18423.45,0.133,16.63,24.91,9.14,3,1.0,4.04,0.075,0.0345195,TAKER
27/01/2023 00:00:00,17/06/2023 18:06:50,Upscale-Upscale-DUMMY_Gemini_BTCUSD_1h_01_07_22_to_16_06_23.csv,BTC_USD,WEEK,351.26,0.001,24/03/2023 00:00:00,17/03/2023 00:00:00,17/03/2023 00:00:00,EXPIRED,LONG,23487.0,28351.0,34225.92,12748.09,0.067,31.38,84.24,10.72,3,1.0,4.85,0.075,0.01761525,TAKER
24/03/2023 00:00:00,17/06/2023 18:06:50,Upscale-Upscale-DUMMY_Gemini_BTCUSD_1h_01_07_22_to_16_06_23.csv,BTC_USD,WEEK,356.11,0.001,19/05/2023 00:00:00,12/05/2023 00:00:00,12/05/2023 00:00:00,EXPIRED,LONG,27941.0,26831.0,39981.24,15900.77,0.078,30.11,75.72,12.02,3,1.0,-1.13,0.075,0.02095575,TAKER
24/03/2023 00:00:00,17/06/2023 18:06:50,Upscale-Upscale-DUMMY_Gemini_BTCUSD_1h_01_07_22_to_16_06_23.csv,BTC_USD,WEEK,354.98,0.001,19/05/2023 00:00:00,12/05/2023 00:00:00,12/05/2023 00:00:00,EXPIRED,LONG,27941.0,26831.0,39981.24,15900.77,0.079,30.11,75.72,12.02,3,1.0,-1.13,0.075,0.02095575,TAKER
27/01/2023 00:00:00,17/06/2023 18:06:50,Upscale-Upscale-DUMMY_Gemini_BTCUSD_1h_01_07_22_to_16_06_23.csv,BTC_USD,WEEK,353.85,0.001,24/03/2023 00:00:00,17/03/2023 00:00:00,17/03/2023 00:00:00,EXPIRED,LONG,23487.0,28351.0,34225.92,12748.09,0.066,31.38,84.24,10.72,3,1.0,4.85,0.075,0.01761525,TAKER
20/01/2023 00:00:00,17/06/2023 18:06:50,Upscale-Upscale-DUMMY_Gemini_BTCUSD_1h_01_07_22_to_16_06_23.csv,BTC_USD,WEEK,358.7,0.002,17/03/2023 00:00:00,10/03/2023 00:00:00,10/03/2023 00:00:00,EXPIRED,LONG,23013.0,25052.0,27602.55,18423.45,0.128,16.63,24.91,9.14,3,1.0,4.04,0.075,0.0345195,TAKER
24/03/2023 00:00:00,17/06/2023 18:06:50,Upscale-Upscale-DUMMY_Gemini_BTCUSD_1h_01_07_22_to_16_06_23.csv,BTC_USD,WEEK,362.74,0.001,19/05/2023 00:00:00,12/05/2023 00:00:00,12/05/2023 00:00:00,EXPIRED,LONG,27941.0,26831.0,39981.24,15900.77,0.077,30.11,75.72,12.02,3,1.0,-1.13,0.075,0.02095575,TAKER
24/03/2023 00:00:00,17/06/2023 18:06:50,Upscale-Upscale-DUMMY_Gemini_BTCUSD_1h_01_07_22_to_16_06_23.csv,BTC_USD,WEEK,361.61,0.001,19/05/2023 00:00:00,12/05/2023 00:00:00,12/05/2023 00:00:00,EXPIRED,LONG,27941.0,26831.0,39981.24,15900.77,0.077,30.11,75.72,12.02,3,1.0,-1.13,0.075,0.02095575,TAKER
24/03/2023 00:00:00,17/06/2023 18:06:50,Upscale-Upscale-DUMMY_Gemini_BTCUSD_1h_01_07_22_to_16_06_23.csv,BTC_USD,WEEK,360.48,0.001,19/05/2023 00:00:00,12/05/2023 00:00:00,12/05/2023 00:00:00,EXPIRED,LONG,27941.0,26831.0,39981.24,15900.77,0.078,30.11,75.72,12.02,3,1.0,-1.13,0.075,0.02095575,TAKER
27/01/2023 00:00:00,17/06/2023 18:06:50,Upscale-Upscale-DUMMY_Gemini_BTCUSD_1h_01_07_22_to_16_06_23.csv,BTC_USD,WEEK,359.35,0.001,24/03/2023 00:00:00,17/03/2023 00:00:00,17/03/2023 00:00:00,EXPIRED,LONG,23487.0,28351.0,34225.92,12748.09,0.065,31.38,84.24,10.72,3,1.0,4.85,0.075,0.01761525,TAKER
24/02/2023 00:00:00,17/06/2023 18:06:50,Upscale-Upscale-DUMMY_Gemini_BTCUSD_1h_01_07_22_to_16_06_23.csv,BTC_USD,WEEK,364.2,0.003,21/04/2023 00:00:00,14/04/2023 00:00:00,03/03/2023 00:00:00,TAKE_PROFIT_HIT,SHORT,23468.0,20996.18,20996.18,25939.82,0.193,11.77,9.53,7.36,2,1.0,7.36,0.075,0.052802999999999996,TAKER
24/03/2023 00:00:00,17/06/2023 18:06:50,Upscale-Upscale-DUMMY_Gemini_BTCUSD_1h_01_07_22_to_16_06_23.csv,BTC_USD,WEEK,371.56,0.001,19/05/2023 00:00:00,12/05/2023 00:00:00,12/05/2023 00:00:00,EXPIRED,LONG,27941.0,26831.0,39981.24,15900.77,0.075,30.11,75.72,12.02,3,1.0,-1.13,0.075,0.02095575,TAKER
20/01/2023 00:00:00,17/06/2023 18:06:50,Upscale-Upscale-DUMMY_Gemini_BTCUSD_1h_01_07_22_to_16_06_23.csv,BTC_USD,WEEK,370.43,0.002,17/03/2023 00:00:00,10/03/2023 00:00:00,10/03/2023 00:00:00,EXPIRED,LONG,23013.0,25052.0,27602.55,18423.45,0.124,16.63,24.91,9.14,2,1.0,4.04,0.075,0.0345195,TAKER
20/01/2023 00:00:00,17/06/2023 18:06:50,Upscale-Upscale-DUMMY_Gemini_BTCUSD_1h_01_07_22_to_16_06_23.csv,BTC_USD,WEEK,374.47,0.002,17/03/2023 00:00:00,10/03/2023 00:00:00,10/03/2023 00:00:00,EXPIRED,LONG,23013.0,25052.0,27602.55,18423.45,0.123,16.63,24.91,9.14,2,1.0,4.04,0.075,0.0345195,TAKER
24/03/2023 00:00:00,17/06/2023 18:06:50,Upscale-Upscale-DUMMY_Gemini_BTCUSD_1h_01_07_22_to_16_06_23.csv,BTC_USD,WEEK,378.51,0.001,19/05/2023 00:00:00,12/05/2023 00:00:00,12/05/2023 00:00:00,EXPIRED,LONG,27941.0,26831.0,39981.24,15900.77,0.074,30.11,75.72,12.02,3,1.0,-1.13,0.075,0.02095575,TAKER
24/03/2023 00:00:00,17/06/2023 18:06:50,Upscale-Upscale-DUMMY_Gemini_BTCUSD_1h_01_07_22_to_16_06_23.csv,BTC_USD,WEEK,377.38,0.001,19/05/2023 00:00:00,12/05/2023 00:00:00,12/05/2023 00:00:00,EXPIRED,LONG,27941.0,26831.0,39981.24,15900.77,0.074,30.11,75.72,12.02,3,1.0,-1.13,0.075,0.02095575,TAKER
17/02/2023 00:00:00,17/06/2023 18:06:50,Upscale-Upscale-DUMMY_Gemini_BTCUSD_1h_01_07_22_to_16_06_23.csv,BTC_USD,WEEK,376.25,0.005,31/03/2023 00:00:00,07/04/2023 00:00:00,03/03/2023 00:00:00,TAKE_PROFIT_HIT,SHORT,23948.0,22334.58,22334.58,25561.42,0.318,7.22,6.31,7.98,2,1.0,7.98,0.075,0.08980500000000001,TAKER
24/02/2023 00:00:00,17/06/2023 18:06:50,Upscale-Upscale-DUMMY_Gemini_BTCUSD_1h_01_07_22_to_16_06_23.csv,BTC_USD,WEEK,384.23,0.003,21/04/2023 00:00:00,14/04/2023 00:00:00,03/03/2023 00:00:00,TAKE_PROFIT_HIT,SHORT,23468.0,20996.18,20996.18,25939.82,0.183,11.77,9.53,7.36,2,1.0,7.36,0.075,0.052802999999999996,TAKER
17/02/2023 00:00:00,17/06/2023 18:06:50,Upscale-Upscale-DUMMY_Gemini_BTCUSD_1h_01_07_22_to_16_06_23.csv,BTC_USD,WEEK,391.59,0.005,31/03/2023 00:00:00,07/04/2023 00:00:00,03/03/2023 00:00:00,TAKE_PROFIT_HIT,SHORT,23948.0,22334.58,22334.58,25561.42,0.306,7.22,6.31,7.98,2,1.0,7.98,0.075,0.08980500000000001,TAKER
20/01/2023 00:00:00,17/06/2023 18:06:50,Upscale-Upscale-DUMMY_Gemini_BTCUSD_1h_01_07_22_to_16_06_23.csv,BTC_USD,WEEK,399.57,0.002,17/03/2023 00:00:00,10/03/2023 00:00:00,10/03/2023 00:00:00,EXPIRED,LONG,23013.0,25052.0,27602.55,18423.45,0.115,16.63,24.91,9.14,2,1.0,4.04,0.075,0.0345195,TAKER
17/02/2023 00:00:00,17/06/2023 18:06:50,Upscale-Upscale-DUMMY_Gemini_BTCUSD_1h_01_07_22_to_16_06_23.csv,BTC_USD,WEEK,403.61,0.005,31/03/2023 00:00:00,07/04/2023 00:00:00,03/03/2023 00:00:00,TAKE_PROFIT_HIT,SHORT,23948.0,22334.58,22334.58,25561.42,0.297,7.22,6.31,7.98,2,1.0,7.98,0.075,0.08980500000000001,TAKER
03/03/2023 00:00:00,17/06/2023 18:06:50,Upscale-Upscale-DUMMY_Gemini_BTCUSD_1h_01_07_22_to_16_06_23.csv,BTC_USD,WEEK,411.59,0.005,21/04/2023 00:00:00,21/04/2023 00:00:00,10/03/2023 00:00:00,STOP_LOSS_HIT,SHORT,20290.0,21899.78,18680.22,21899.78,0.246,8.62,7.35,7.97,2,1.0,-8.12,0.075,0.0760875,TAKER
20/01/2023 00:00:00,17/06/2023 18:06:50,Upscale-Upscale-DUMMY_Gemini_BTCUSD_1h_01_07_22_to_16_06_23.csv,BTC_USD,WEEK,403.47,0.002,17/03/2023 00:00:00,10/03/2023 00:00:00,10/03/2023 00:00:00,EXPIRED,LONG,23013.0,25052.0,27602.55,18423.45,0.114,16.63,24.91,9.14,2,1.0,4.04,0.075,0.0345195,TAKER
24/02/2023 00:00:00,17/06/2023 18:06:50,Upscale-Upscale-DUMMY_Gemini_BTCUSD_1h_01_07_22_to_16_06_23.csv,BTC_USD,WEEK,407.51,0.003,21/04/2023 00:00:00,14/04/2023 00:00:00,03/03/2023 00:00:00,TAKE_PROFIT_HIT,SHORT,23468.0,20996.18,20996.18,25939.82,0.173,11.77,9.53,7.36,2,1.0,7.36,0.075,0.052802999999999996,TAKER
24/03/2023 00:00:00,17/06/2023 18:06:50,Upscale-Upscale-DUMMY_Gemini_BTCUSD_1h_01_07_22_to_16_06_23.csv,BTC_USD,WEEK,414.87,0.001,19/05/2023 00:00:00,12/05/2023 00:00:00,12/05/2023 00:00:00,EXPIRED,LONG,27941.0,26831.0,39981.24,15900.77,0.067,30.11,75.72,12.02,3,1.0,-1.13,0.075,0.02095575,TAKER
24/03/2023 00:00:00,17/06/2023 18:06:50,Upscale-Upscale-DUMMY_Gemini_BTCUSD_1h_01_07_22_to_16_06_23.csv,BTC_USD,WEEK,413.74,0.001,19/05/2023 00:00:00,12/05/2023 00:00:00,12/05/2023 00:00:00,EXPIRED,LONG,27941.0,26831.0,39981.24,15900.77,0.068,30.11,75.72,12.02,3,1.0,-1.13,0.075,0.02095575,TAKER
24/02/2023 00:00:00,17/06/2023 18:06:50,Upscale-Upscale-DUMMY_Gemini_BTCUSD_1h_01_07_22_to_16_06_23.csv,BTC_USD,WEEK,412.61,0.003,21/04/2023 00:00:00,14/04/2023 00:00:00,03/03/2023 00:00:00,TAKE_PROFIT_HIT,SHORT,23468.0,20996.18,20996.18,25939.82,0.171,11.77,9.53,7.36,2,1.0,7.36,0.075,0.052802999999999996,TAKER
20/01/2023 00:00:00,17/06/2023 18:06:50,Upscale-Upscale-DUMMY_Gemini_BTCUSD_1h_01_07_22_to_16_06_23.csv,BTC_USD,WEEK,419.97,0.002,17/03/2023 00:00:00,10/03/2023 00:00:00,10/03/2023 00:00:00,EXPIRED,LONG,23013.0,25052.0,27602.55,18423.45,0.11,16.63,24.91,9.14,2,1.0,4.04,0.075,0.0345195,TAKER
24/03/2023 00:00:00,17/06/2023 18:06:50,Upscale-Upscale-DUMMY_Gemini_BTCUSD_1h_01_07_22_to_16_06_23.csv,BTC_USD,WEEK,424.01,0.001,19/05/2023 00:00:00,12/05/2023 00:00:00,12/05/2023 00:00:00,EXPIRED,LONG,27941.0,26831.0,39981.24,15900.77,0.066,30.11,75.72,12.02,3,1.0,-1.13,0.075,0.02095575,TAKER
27/01/2023 00:00:00,17/06/2023 18:06:50,Upscale-Upscale-DUMMY_Gemini_BTCUSD_1h_01_07_22_to_16_06_23.csv,BTC_USD,WEEK,422.88,0.001,24/03/2023 00:00:00,17/03/2023 00:00:00,17/03/2023 00:00:00,EXPIRED,LONG,23487.0,28351.0,34225.92,12748.09,0.056,31.38,84.24,10.72,3,1.0,4.85,0.075,0.01761525,TAKER
24/02/2023 00:00:00,17/06/2023 18:06:50,Upscale-Upscale-DUMMY_Gemini_BTCUSD_1h_01_07_22_to_16_06_23.csv,BTC_USD,WEEK,427.73,0.003,21/04/2023 00:00:00,14/04/2023 00:00:00,03/03/2023 00:00:00,TAKE_PROFIT_HIT,SHORT,23468.0,20996.18,20996.18,25939.82,0.165,11.77,9.53,7.36,2,1.0,7.36,0.075,0.052802999999999996,TAKER
17/02/2023 00:00:00,17/06/2023 18:06:50,Upscale-Upscale-DUMMY_Gemini_BTCUSD_1h_01_07_22_to_16_06_23.csv,BTC_USD,WEEK,435.09,0.005,31/03/2023 00:00:00,07/04/2023 00:00:00,03/03/2023 00:00:00,TAKE_PROFIT_HIT,SHORT,23948.0,22334.58,22334.58,25561.42,0.275,7.22,6.31,7.98,2,1.0,7.98,0.075,0.08980500000000001,TAKER
24/02/2023 00:00:00,17/06/2023 18:06:50,Upscale-Upscale-DUMMY_Gemini_BTCUSD_1h_01_07_22_to_16_06_23.csv,BTC_USD,WEEK,443.07,0.004,21/04/2023 00:00:00,14/04/2023 00:00:00,03/03/2023 00:00:00,TAKE_PROFIT_HIT,SHORT,23468.0,20996.18,20996.18,25939.82,0.212,11.77,9.53,9.82,2,1.0,9.82,0.075,0.070404,TAKER
27/01/2023 00:00:00,17/06/2023 18:06:50,Upscale-Upscale-DUMMY_Gemini_BTCUSD_1h_01_07_22_to_16_06_23.csv,BTC_USD,WEEK,452.89,0.001,24/03/2023 00:00:00,17/03/2023 00:00:00,17/03/2023 00:00:00,EXPIRED,LONG,23487.0,28351.0,34225.92,12748.09,0.052,31.38,84.24,10.72,2,1.0,4.85,0.075,0.01761525,TAKER
24/02/2023 00:00:00,17/06/2023 18:06:50,Upscale-Upscale-DUMMY_Gemini_BTCUSD_1h_01_07_22_to_16_06_23.csv,BTC_USD,WEEK,457.74,0.004,21/04/2023 00:00:00,14/04/2023 00:00:00,03/03/2023 00:00:00,TAKE_PROFIT_HIT,SHORT,23468.0,20996.18,20996.18,25939.82,0.205,11.77,9.53,9.82,2,1.0,9.82,0.075,0.070404,TAKER
24/02/2023 00:00:00,17/06/2023 18:06:50,Upscale-Upscale-DUMMY_Gemini_BTCUSD_1h_01_07_22_to_16_06_23.csv,BTC_USD,WEEK,467.56,0.004,21/04/2023 00:00:00,14/04/2023 00:00:00,03/03/2023 00:00:00,TAKE_PROFIT_HIT,SHORT,23468.0,20996.18,20996.18,25939.82,0.201,11.77,9.53,9.82,2,1.0,9.82,0.075,0.070404,TAKER
17/02/2023 00:00:00,17/06/2023 18:06:50,Upscale-Upscale-DUMMY_Gemini_BTCUSD_1h_01_07_22_to_16_06_23.csv,BTC_USD,WEEK,477.38,0.006,31/03/2023 00:00:00,07/04/2023 00:00:00,03/03/2023 00:00:00,TAKE_PROFIT_HIT,SHORT,23948.0,22334.58,22334.58,25561.42,0.301,7.22,6.31,9.57,2,1.0,9.57,0.075,0.107766,TAKER
27/01/2023 00:00:00,17/06/2023 18:06:50,Upscale-Upscale-DUMMY_Gemini_BTCUSD_1h_01_07_22_to_16_06_23.csv,BTC_USD,WEEK,486.95,0.001,24/03/2023 00:00:00,17/03/2023 00:00:00,17/03/2023 00:00:00,EXPIRED,LONG,23487.0,28351.0,34225.92,12748.09,0.048,31.38,84.24,10.72,2,1.0,4.85,0.075,0.01761525,TAKER
24/03/2023 00:00:00,17/06/2023 18:06:50,Upscale-Upscale-DUMMY_Gemini_BTCUSD_1h_01_07_22_to_16_06_23.csv,BTC_USD,WEEK,491.8,0.001,19/05/2023 00:00:00,12/05/2023 00:00:00,12/05/2023 00:00:00,EXPIRED,LONG,27941.0,26831.0,39981.24,15900.77,0.057,30.11,75.72,12.02,2,1.0,-1.13,0.075,0.02095575,TAKER
24/03/2023 00:00:00,17/06/2023 18:06:50,Upscale-Upscale-DUMMY_Gemini_BTCUSD_1h_01_07_22_to_16_06_23.csv,BTC_USD,WEEK,490.67,0.001,19/05/2023 00:00:00,12/05/2023 00:00:00,12/05/2023 00:00:00,EXPIRED,LONG,27941.0,26831.0,39981.24,15900.77,0.057,30.11,75.72,12.02,2,1.0,-1.13,0.075,0.02095575,TAKER
17/02/2023 00:00:00,17/06/2023 18:06:50,Upscale-Upscale-DUMMY_Gemini_BTCUSD_1h_01_07_22_to_16_06_23.csv,BTC_USD,WEEK,489.54,0.006,31/03/2023 00:00:00,07/04/2023 00:00:00,03/03/2023 00:00:00,TAKE_PROFIT_HIT,SHORT,23948.0,22334.58,22334.58,25561.42,0.294,7.22,6.31,9.57,2,1.0,9.57,0.075,0.107766,TAKER
24/03/2023 00:00:00,17/06/2023 18:06:50,Upscale-Upscale-DUMMY_Gemini_BTCUSD_1h_01_07_22_to_16_06_23.csv,BTC_USD,WEEK,499.11,0.001,19/05/2023 00:00:00,12/05/2023 00:00:00,12/05/2023 00:00:00,EXPIRED,LONG,27941.0,26831.0,39981.24,15900.77,0.056,30.11,75.72,12.02,2,1.0,-1.13,0.075,0.02095575,TAKER
03/03/2023 00:00:00,17/06/2023 18:06:50,Upscale-Upscale-DUMMY_Gemini_BTCUSD_1h_01_07_22_to_16_06_23.csv,BTC_USD,WEEK,497.98,0.006,21/04/2023 00:00:00,21/04/2023 00:00:00,10/03/2023 00:00:00,STOP_LOSS_HIT,SHORT,20290.0,21899.78,18680.22,21899.78,0.244,8.62,7.35,9.57,2,1.0,-9.75,0.075,0.091305,TAKER
24/03/2023 00:00:00,17/06/2023 18:06:50,Upscale-Upscale-DUMMY_Gemini_BTCUSD_1h_01_07_22_to_16_06_23.csv,BTC_USD,WEEK,488.23,0.001,19/05/2023 00:00:00,12/05/2023 00:00:00,12/05/2023 00:00:00,EXPIRED,LONG,27941.0,26831.0,39981.24,15900.77,0.057,30.11,75.72,12.02,2,1.0,-1.13,0.075,0.02095575,TAKER
20/01/2023 00:00:00,17/06/2023 18:06:50,Upscale-Upscale-DUMMY_Gemini_BTCUSD_1h_01_07_22_to_16_06_23.csv,BTC_USD,WEEK,487.1,0.002,17/03/2023 00:00:00,10/03/2023 00:00:00,10/03/2023 00:00:00,EXPIRED,LONG,23013.0,25052.0,27602.55,18423.45,0.094,16.63,24.91,9.14,2,1.0,4.04,0.075,0.0345195,TAKER
20/01/2023 00:00:00,17/06/2023 18:06:50,Upscale-Upscale-DUMMY_Gemini_BTCUSD_1h_01_07_22_to_16_06_23.csv,BTC_USD,WEEK,491.14,0.002,17/03/2023 00:00:00,10/03/2023 00:00:00,10/03/2023 00:00:00,EXPIRED,LONG,23013.0,25052.0,27602.55,18423.45,0.094,16.63,24.91,9.14,2,1.0,4.04,0.075,0.0345195,TAKER
03/03/2023 00:00:00,17/06/2023 18:06:50,Upscale-Upscale-DUMMY_Gemini_BTCUSD_1h_01_07_22_to_16_06_23.csv,BTC_USD,WEEK,495.18,0.006,21/04/2023 00:00:00,21/04/2023 00:00:00,10/03/2023 00:00:00,STOP_LOSS_HIT,SHORT,20290.0,21899.78,18680.22,21899.78,0.246,8.62,7.35,9.57,2,1.0,-9.75,0.075,0.091305,TAKER
24/02/2023 00:00:00,17/06/2023 18:06:50,Upscale-Upscale-DUMMY_Gemini_BTCUSD_1h_01_07_22_to_16_06_23.csv,BTC_USD,WEEK,485.43,0.004,21/04/2023 00:00:00,14/04/2023 00:00:00,03/03/2023 00:00:00,TAKE_PROFIT_HIT,SHORT,23468.0,20996.18,20996.18,25939.82,0.193,11.77,9.53,9.82,2,1.0,9.82,0.075,0.070404,TAKER
17/02/2023 00:00:00,17/06/2023 18:06:50,Upscale-Upscale-DUMMY_Gemini_BTCUSD_1h_01_07_22_to_16_06_23.csv,BTC_USD,WEEK,495.25,0.006,31/03/2023 00:00:00,07/04/2023 00:00:00,03/03/2023 00:00:00,TAKE_PROFIT_HIT,SHORT,23948.0,22334.58,22334.58,25561.42,0.29,7.22,6.31,9.57,2,1.0,9.57,0.075,0.107766,TAKER
20/01/2023 00:00:00,17/06/2023 18:06:50,Upscale-Upscale-DUMMY_Gemini_BTCUSD_1h_01_07_22_to_16_06_23.csv,BTC_USD,WEEK,504.82,0.002,17/03/2023 00:00:00,10/03/2023 00:00:00,10/03/2023 00:00:00,EXPIRED,LONG,23013.0,25052.0,27602.55,18423.45,0.091,16.63,24.91,9.14,2,1.0,4.04,0.075,0.0345195,TAKER
24/03/2023 00:00:00,17/06/2023 18:06:50,Upscale-Upscale-DUMMY_Gemini_BTCUSD_1h_01_07_22_to_16_06_23.csv,BTC_USD,WEEK,508.86,0.001,19/05/2023 00:00:00,12/05/2023 00:00:00,12/05/2023 00:00:00,EXPIRED,LONG,27941.0,26831.0,39981.24,15900.77,0.055,30.11,75.72,12.02,2,1.0,-1.13,0.075,0.02095575,TAKER
24/03/2023 00:00:00,17/06/2023 18:06:50,Upscale-Upscale-DUMMY_Gemini_BTCUSD_1h_01_07_22_to_16_06_23.csv,BTC_USD,WEEK,507.73,0.001,19/05/2023 00:00:00,12/05/2023 00:00:00,12/05/2023 00:00:00,EXPIRED,LONG,27941.0,26831.0,39981.24,15900.77,0.055,30.11,75.72,12.02,2,1.0,-1.13,0.075,0.02095575,TAKER
27/01/2023 00:00:00,17/06/2023 18:06:50,Upscale-Upscale-DUMMY_Gemini_BTCUSD_1h_01_07_22_to_16_06_23.csv,BTC_USD,WEEK,506.6,0.001,24/03/2023 00:00:00,17/03/2023 00:00:00,17/03/2023 00:00:00,EXPIRED,LONG,23487.0,28351.0,34225.92,12748.09,0.046,31.38,84.24,10.72,2,1.0,4.85,0.075,0.01761525,TAKER
24/03/2023 00:00:00,17/06/2023 18:06:50,Upscale-Upscale-DUMMY_Gemini_BTCUSD_1h_01_07_22_to_16_06_23.csv,BTC_USD,WEEK,511.45,0.001,19/05/2023 00:00:00,12/05/2023 00:00:00,12/05/2023 00:00:00,EXPIRED,LONG,27941.0,26831.0,39981.24,15900.77,0.055,30.11,75.72,12.02,2,1.0,-1.13,0.075,0.02095575,TAKER
24/03/2023 00:00:00,17/06/2023 18:06:50,Upscale-Upscale-DUMMY_Gemini_BTCUSD_1h_01_07_22_to_16_06_23.csv,BTC_USD,WEEK,510.32,0.001,19/05/2023 00:00:00,12/05/2023 00:00:00,12/05/2023 00:00:00,EXPIRED,LONG,27941.0,26831.0,39981.24,15900.77,0.055,30.11,75.72,12.02,2,1.0,-1.13,0.075,0.02095575,TAKER
20/01/2023 00:00:00,17/06/2023 18:06:50,Upscale-Upscale-DUMMY_Gemini_BTCUSD_1h_01_07_22_to_16_06_23.csv,BTC_USD,WEEK,509.19,0.002,17/03/2023 00:00:00,10/03/2023 00:00:00,10/03/2023 00:00:00,EXPIRED,LONG,23013.0,25052.0,27602.55,18423.45,0.09,16.63,24.91,9.14,2,1.0,4.04,0.075,0.0345195,TAKER
24/02/2023 00:00:00,17/06/2023 18:06:50,Upscale-Upscale-DUMMY_Gemini_BTCUSD_1h_01_07_22_to_16_06_23.csv,BTC_USD,WEEK,513.23,0.004,21/04/2023 00:00:00,14/04/2023 00:00:00,03/03/2023 00:00:00,TAKE_PROFIT_HIT,SHORT,23468.0,20996.18,20996.18,25939.82,0.183,11.77,9.53,9.82,2,1.0,9.82,0.075,0.070404,TAKER
24/02/2023 00:00:00,17/06/2023 18:06:50,Upscale-Upscale-DUMMY_Gemini_BTCUSD_1h_01_07_22_to_16_06_23.csv,BTC_USD,WEEK,523.05,0.004,21/04/2023 00:00:00,14/04/2023 00:00:00,03/03/2023 00:00:00,TAKE_PROFIT_HIT,SHORT,23468.0,20996.18,20996.18,25939.82,0.179,11.77,9.53,9.82,2,1.0,9.82,0.075,0.070404,TAKER
17/02/2023 00:00:00,17/06/2023 18:06:50,Upscale-Upscale-DUMMY_Gemini_BTCUSD_1h_01_07_22_to_16_06_23.csv,BTC_USD,WEEK,532.87,0.007,31/03/2023 00:00:00,07/04/2023 00:00:00,03/03/2023 00:00:00,TAKE_PROFIT_HIT,SHORT,23948.0,22334.58,22334.58,25561.42,0.315,7.22,6.31,11.17,2,1.0,11.17,0.075,0.125727,TAKER
03/03/2023 00:00:00,17/06/2023 18:06:50,Upscale-Upscale-DUMMY_Gemini_BTCUSD_1h_01_07_22_to_16_06_23.csv,BTC_USD,WEEK,544.04,0.007,21/04/2023 00:00:00,21/04/2023 00:00:00,10/03/2023 00:00:00,STOP_LOSS_HIT,SHORT,20290.0,21899.78,18680.22,21899.78,0.261,8.62,7.35,11.16,2,1.0,-11.37,0.075,0.1065225,TAKER
27/01/2023 00:00:00,17/06/2023 18:06:50,Upscale-Upscale-DUMMY_Gemini_BTCUSD_1h_01_07_22_to_16_06_23.csv,BTC_USD,WEEK,532.67,0.001,24/03/2023 00:00:00,17/03/2023 00:00:00,17/03/2023 00:00:00,EXPIRED,LONG,23487.0,28351.0,34225.92,12748.09,0.044,31.38,84.24,10.72,2,1.0,4.85,0.075,0.01761525,TAKER
24/02/2023 00:00:00,17/06/2023 18:06:50,Upscale-Upscale-DUMMY_Gemini_BTCUSD_1h_01_07_22_to_16_06_23.csv,BTC_USD,WEEK,537.52,0.004,21/04/2023 00:00:00,14/04/2023 00:00:00,03/03/2023 00:00:00,TAKE_PROFIT_HIT,SHORT,23468.0,20996.18,20996.18,25939.82,0.175,11.77,9.53,9.82,2,1.0,9.82,0.075,0.070404,TAKER
24/02/2023 00:00:00,17/06/2023 18:06:50,Upscale-Upscale-DUMMY_Gemini_BTCUSD_1h_01_07_22_to_16_06_23.csv,BTC_USD,WEEK,547.34,0.004,21/04/2023 00:00:00,14/04/2023 00:00:00,03/03/2023 00:00:00,TAKE_PROFIT_HIT,SHORT,23468.0,20996.18,20996.18,25939.82,0.172,11.77,9.53,9.82,2,1.0,9.82,0.075,0.070404,TAKER
03/03/2023 00:00:00,17/06/2023 18:06:50,Upscale-Upscale-DUMMY_Gemini_BTCUSD_1h_01_07_22_to_16_06_23.csv,BTC_USD,WEEK,557.16,0.007,21/04/2023 00:00:00,21/04/2023 00:00:00,10/03/2023 00:00:00,STOP_LOSS_HIT,SHORT,20290.0,21899.78,18680.22,21899.78,0.255,8.62,7.35,11.16,2,1.0,-11.37,0.075,0.1065225,TAKER
03/03/2023 00:00:00,17/06/2023 18:06:50,Upscale-Upscale-DUMMY_Gemini_BTCUSD_1h_01_07_22_to_16_06_23.csv,BTC_USD,WEEK,545.79,0.007,21/04/2023 00:00:00,21/04/2023 00:00:00,10/03/2023 00:00:00,STOP_LOSS_HIT,SHORT,20290.0,21899.78,18680.22,21899.78,0.26,8.62,7.35,11.16,2,1.0,-11.37,0.075,0.1065225,TAKER
24/03/2023 00:00:00,17/06/2023 18:06:50,Upscale-Upscale-DUMMY_Gemini_BTCUSD_1h_01_07_22_to_16_06_23.csv,BTC_USD,WEEK,534.42,0.001,19/05/2023 00:00:00,12/05/2023 00:00:00,12/05/2023 00:00:00,EXPIRED,LONG,27941.0,26831.0,39981.24,15900.77,0.052,30.11,75.72,12.02,2,1.0,-1.13,0.075,0.02095575,TAKER
17/02/2023 00:00:00,17/06/2023 18:06:50,Upscale-Upscale-DUMMY_Gemini_BTCUSD_1h_01_07_22_to_16_06_23.csv,BTC_USD,WEEK,533.29,0.007,31/03/2023 00:00:00,07/04/2023 00:00:00,03/03/2023 00:00:00,TAKE_PROFIT_HIT,SHORT,23948.0,22334.58,22334.58,25561.42,0.314,7.22,6.31,11.17,2,1.0,11.17,0.075,0.125727,TAKER
20/01/2023 00:00:00,17/06/2023 18:06:50,Upscale-Upscale-DUMMY_Gemini_BTCUSD_1h_01_07_22_to_16_06_23.csv,BTC_USD,WEEK,544.46,0.002,17/03/2023 00:00:00,10/03/2023 00:00:00,10/03/2023 00:00:00,EXPIRED,LONG,23013.0,25052.0,27602.55,18423.45,0.085,16.63,24.91,9.14,2,1.0,4.04,0.075,0.0345195,TAKER
03/03/2023 00:00:00,17/06/2023 18:06:50,Upscale-Upscale-DUMMY_Gemini_BTCUSD_1h_01_07_22_to_16_06_23.csv,BTC_USD,WEEK,548.5,0.007,21/04/2023 00:00:00,21/04/2023 00:00:00,10/03/2023 00:00:00,STOP_LOSS_HIT,SHORT,20290.0,21899.78,18680.22,21899.78,0.259,8.62,7.35,11.16,2,1.0,-11.37,0.075,0.1065225,TAKER
24/03/2023 00:00:00,17/06/2023 18:06:50,Upscale-Upscale-DUMMY_Gemini_BTCUSD_1h_01_07_22_to_16_06_23.csv,BTC_USD,WEEK,537.13,0.001,19/05/2023 00:00:00,12/05/2023 00:00:00,12/05/2023 00:00:00,EXPIRED,LONG,27941.0,26831.0,39981.24,15900.77,0.052,30.11,75.72,12.02,2,1.0,-1.13,0.075,0.02095575,TAKER
24/03/2023 00:00:00,17/06/2023 18:06:50,Upscale-Upscale-DUMMY_Gemini_BTCUSD_1h_01_07_22_to_16_06_23.csv,BTC_USD,WEEK,536.0,0.001,19/05/2023 00:00:00,12/05/2023 00:00:00,12/05/2023 00:00:00,EXPIRED,LONG,27941.0,26831.0,39981.24,15900.77,0.052,30.11,75.72,12.02,2,1.0,-1.13,0.075,0.02095575,TAKER
24/02/2023 00:00:00,17/06/2023 18:06:50,Upscale-Upscale-DUMMY_Gemini_BTCUSD_1h_01_07_22_to_16_06_23.csv,BTC_USD,WEEK,534.87,0.004,21/04/2023 00:00:00,14/04/2023 00:00:00,03/03/2023 00:00:00,TAKE_PROFIT_HIT,SHORT,23468.0,20996.18,20996.18,25939.82,0.176,11.77,9.53,9.82,2,1.0,9.82,0.075,0.070404,TAKER
17/02/2023 00:00:00,17/06/2023 18:06:50,Upscale-Upscale-DUMMY_Gemini_BTCUSD_1h_01_07_22_to_16_06_23.csv,BTC_USD,WEEK,544.69,0.007,31/03/2023 00:00:00,07/04/2023 00:00:00,03/03/2023 00:00:00,TAKE_PROFIT_HIT,SHORT,23948.0,22334.58,22334.58,25561.42,0.308,7.22,6.31,11.17,2,1.0,11.17,0.075,0.125727,TAKER
27/01/2023 00:00:00,17/06/2023 18:06:50,Upscale-Upscale-DUMMY_Gemini_BTCUSD_1h_01_07_22_to_16_06_23.csv,BTC_USD,WEEK,555.86,0.001,24/03/2023 00:00:00,17/03/2023 00:00:00,17/03/2023 00:00:00,EXPIRED,LONG,23487.0,28351.0,34225.92,12748.09,0.042,31.38,84.24,10.72,2,1.0,4.85,0.075,0.01761525,TAKER
24/03/2023 00:00:00,17/06/2023 18:06:50,Upscale-Upscale-DUMMY_Gemini_BTCUSD_1h_01_07_22_to_16_06_23.csv,BTC_USD,WEEK,560.71,0.001,19/05/2023 00:00:00,12/05/2023 00:00:00,12/05/2023 00:00:00,EXPIRED,LONG,27941.0,26831.0,39981.24,15900.77,0.05,30.11,75.72,12.02,2,1.0,-1.13,0.075,0.02095575,TAKER
17/02/2023 00:00:00,17/06/2023 18:06:50,Upscale-Upscale-DUMMY_Gemini_BTCUSD_1h_01_07_22_to_16_06_23.csv,BTC_USD,WEEK,559.58,0.007,31/03/2023 00:00:00,07/04/2023 00:00:00,03/03/2023 00:00:00,TAKE_PROFIT_HIT,SHORT,23948.0,22334.58,22334.58,25561.42,0.3,7.22,6.31,11.17,2,1.0,11.17,0.075,0.125727,TAKER
17/02/2023 00:00:00,17/06/2023 18:06:50,Upscale-Upscale-DUMMY_Gemini_BTCUSD_1h_01_07_22_to_16_06_23.csv,BTC_USD,WEEK,570.75,0.007,31/03/2023 00:00:00,07/04/2023 00:00:00,03/03/2023 00:00:00,TAKE_PROFIT_HIT,SHORT,23948.0,22334.58,22334.58,25561.42,0.294,7.22,6.31,11.17,2,1.0,11.17,0.075,0.125727,TAKER
27/01/2023 00:00:00,17/06/2023 18:06:50,Upscale-Upscale-DUMMY_Gemini_BTCUSD_1h_01_07_22_to_16_06_23.csv,BTC_USD,WEEK,581.92,0.001,24/03/2023 00:00:00,17/03/2023 00:00:00,17/03/2023 00:00:00,EXPIRED,LONG,23487.0,28351.0,34225.92,12748.09,0.04,31.38,84.24,10.72,2,1.0,4.85,0.075,0.01761525,TAKER
24/02/2023 00:00:00,17/06/2023 18:06:50,Upscale-Upscale-DUMMY_Gemini_BTCUSD_1h_01_07_22_to_16_06_23.csv,BTC_USD,WEEK,586.77,0.005,21/04/2023 00:00:00,14/04/2023 00:00:00,03/03/2023 00:00:00,TAKE_PROFIT_HIT,SHORT,23468.0,20996.18,20996.18,25939.82,0.2,11.77,9.53,12.27,2,1.0,12.27,0.075,0.088005,TAKER
20/01/2023 00:00:00,17/06/2023 18:06:50,Upscale-Upscale-DUMMY_Gemini_BTCUSD_1h_01_07_22_to_16_06_23.csv,BTC_USD,WEEK,599.04,0.003,17/03/2023 00:00:00,10/03/2023 00:00:00,10/03/2023 00:00:00,EXPIRED,LONG,23013.0,25052.0,27602.55,18423.45,0.115,16.63,24.91,13.72,2,1.0,6.07,0.075,0.05177925,TAKER
