Open,Last update,Platform,Symbol,Timeframe,Account balance at open,Size,Expected close,Expiry,Close,Status,Side,Opening price,Closing price,Take profit,Stop loss,Leverage,TP price %,SL price %,Expected profit,Risk %,R/R ratio,PnL,Fee %,Fee Amount,Order Type
20/01/2023 00:00:00,17/06/2023 17:17:15,Upscale-Upscale-DUMMY_Gemini_BTCUSD_1h_01_07_22_to_16_06_23.csv,BTC_USD,WEEK,200.0,0.001,17/03/2023 00:00:00,10/03/2023 00:00:00,10/03/2023 00:00:00,EXPIRED,LONG,23013.0,25052.0,27602.55,18423.45,0.115,16.63,24.91,4.57,2,1.0,2.02,0.075,0.01725975,TAKER
20/01/2023 00:00:00,17/06/2023 17:17:15,Upscale-Upscale-DUMMY_Gemini_BTCUSD_1h_01_07_22_to_16_06_23.csv,BTC_USD,WEEK,202.02,0.001,17/03/2023 00:00:00,10/03/2023 00:00:00,10/03/2023 00:00:00,EXPIRED,LONG,23013.0,25052.0,27602.55,18423.45,0.114,16.63,24.91,4.57,2,1.0,2.02,0.075,0.01725975,TAKER
27/01/2023 00:00:00,17/06/2023 17:17:15,Upscale-Upscale-DUMMY_Gemini_BTCUSD_1h_01_07_22_to_16_06_23.csv,BTC_USD,WEEK,204.04,0.0,24/03/2023 00:00:00,17/03/2023 00:00:00,17/03/2023 00:00:00,EXPIRED,LONG,23487.0,28351.0,34225.92,12748.09,0.0,31.38,84.24,0.0,0,0.0,0.0,0.075,0.0,TAKER
24/02/2023 00:00:00,17/06/2023 17:17:15,Upscale-Upscale-DUMMY_Gemini_BTCUSD_1h_01_07_22_to_16_06_23.csv,BTC_USD,WEEK,204.04,0.002,21/04/2023 00:00:00,14/04/2023 00:00:00,03/03/2023 00:00:00,TAKE_PROFIT_HIT,SHORT,23468.0,20996.18,20996.18,25939.82,0.23,11.77,9.53,4.91,2,1.0,4.91,0.075,0.035202,TAKER
03/03/2023 00:00:00,17/06/2023 17:17:15,Upscale-Upscale-DUMMY_Gemini_BTCUSD_1h_01_07_22_to_16_06_23.csv,BTC_USD,WEEK,208.95,0.003,21/04/2023 00:00:00,21/04/2023 00:00:00,10/03/2023 00:00:00,STOP_LOSS_HIT,SHORT,20290.0,21899.78,18680.22,21899.78,0.291,8.62,7.35,4.78,2,1.0,-4.87,0.075,0.0456525,TAKER
20/01/2023 00:00:00,17/06/2023 17:17:15,Upscale-Upscale-DUMMY_Gemini_BTCUSD_1h_01_07_22_to_16_06_23.csv,BTC_USD,WEEK,204.08,0.001,17/03/2023 00:00:00,10/03/2023 00:00:00,10/03/2023 00:00:00,EXPIRED,LONG,23013.0,25052.0,27602.55,18423.45,0.113,16.63,24.91,4.57,2,1.0,2.02,0.075,0.01725975,TAKER
20/01/2023 00:00:00,17/06/2023 17:17:15,Upscale-Upscale-DUMMY_Gemini_BTCUSD_1h_01_07_22_to_16_06_23.csv,BTC_USD,WEEK,206.1,0.001,17/03/2023 00:00:00,10/03/2023 00:00:00,10/03/2023 00:00:00,EXPIRED,LONG,23013.0,25052.0,27602.55,18423.45,0.112,16.63,24.91,4.57,2,1.0,2.02,0.075,0.01725975,TAKER
20/01/2023 00:00:00,17/06/2023 17:17:15,Upscale-Upscale-DUMMY_Gemini_BTCUSD_1h_01_07_22_to_16_06_23.csv,BTC_USD,WEEK,208.12,0.001,17/03/2023 00:00:00,10/03/2023 00:00:00,10/03/2023 00:00:00,EXPIRED,LONG,23013.0,25052.0,27602.55,18423.45,0.111,16.63,24.91,4.57,2,1.0,2.02,0.075,0.01725975,TAKER
27/01/2023 00:00:00,17/06/2023 17:17:15,Upscale-Upscale-DUMMY_Gemini_BTCUSD_1h_01_07_22_to_16_06_23.csv,BTC_USD,WEEK,210.14,0.0,24/03/2023 00:00:00,17/03/2023 00:00:00,17/03/2023 00:00:00,EXPIRED,LONG,23487.0,28351.0,34225.92,12748.09,0.0,31.38,84.24,0.0,0,0.0,0.0,0.075,0.0,TAKER
20/01/2023 00:00:00,17/06/2023 17:17:15,Upscale-Upscale-DUMMY_Gemini_BTCUSD_1h_01_07_22_to_16_06_23.csv,BTC_USD,WEEK,210.14,0.001,17/03/2023 00:00:00,10/03/2023 00:00:00,10/03/2023 00:00:00,EXPIRED,LONG,23013.0,25052.0,27602.55,18423.45,0.11,16.63,24.91,4.57,2,1.0,2.02,0.075,0.01725975,TAKER
03/03/2023 00:00:00,17/06/2023 17:17:15,Upscale-Upscale-DUMMY_Gemini_BTCUSD_1h_01_07_22_to_16_06_23.csv,BTC_USD,WEEK,212.16,0.003,21/04/2023 00:00:00,21/04/2023 00:00:00,10/03/2023 00:00:00,STOP_LOSS_HIT,SHORT,20290.0,21899.78,18680.22,21899.78,0.287,8.62,7.35,4.78,2,1.0,-4.87,0.075,0.0456525,TAKER
24/02/2023 00:00:00,17/06/2023 17:17:15,Upscale-Upscale-DUMMY_Gemini_BTCUSD_1h_01_07_22_to_16_06_23.csv,BTC_USD,WEEK,207.29,0.002,21/04/2023 00:00:00,14/04/2023 00:00:00,03/03/2023 00:00:00,TAKE_PROFIT_HIT,SHORT,23468.0,20996.18,20996.18,25939.82,0.226,11.77,9.53,4.91,2,1.0,4.91,0.075,0.035202,TAKER
03/03/2023 00:00:00,17/06/2023 17:17:15,Upscale-Upscale-DUMMY_Gemini_BTCUSD_1h_01_07_22_to_16_06_23.csv,BTC_USD,WEEK,212.2,0.003,21/04/2023 00:00:00,21/04/2023 00:00:00,10/03/2023 00:00:00,STOP_LOSS_HIT,SHORT,20290.0,21899.78,18680.22,21899.78,0.287,8.62,7.35,4.78,2,1.0,-4.87,0.075,0.0456525,TAKER
27/01/2023 00:00:00,17/06/2023 17:17:15,Upscale-Upscale-DUMMY_Gemini_BTCUSD_1h_01_07_22_to_16_06_23.csv,BTC_USD,WEEK,207.33,0.0,24/03/2023 00:00:00,17/03/2023 00:00:00,17/03/2023 00:00:00,EXPIRED,LONG,23487.0,28351.0,34225.92,12748.09,0.0,31.38,84.24,0.0,0,0.0,0.0,0.075,0.0,TAKER
17/02/2023 00:00:00,17/06/2023 17:17:15,Upscale-Upscale-DUMMY_Gemini_BTCUSD_1h_01_07_22_to_16_06_23.csv,BTC_USD,WEEK,207.33,0.003,31/03/2023 00:00:00,07/04/2023 00:00:00,03/03/2023 00:00:00,TAKE_PROFIT_HIT,SHORT,23948.0,22334.58,22334.58,25561.42,0.347,7.22,6.31,4.79,2,1.0,4.79,0.075,0.053883,TAKER
20/01/2023 00:00:00,17/06/2023 17:17:15,Upscale-Upscale-DUMMY_Gemini_BTCUSD_1h_01_07_22_to_16_06_23.csv,BTC_USD,WEEK,212.12,0.001,17/03/2023 00:00:00,10/03/2023 00:00:00,10/03/2023 00:00:00,EXPIRED,LONG,23013.0,25052.0,27602.55,18423.45,0.108,16.63,24.91,4.57,2,1.0,2.02,0.075,0.01725975,TAKER
24/02/2023 00:00:00,17/06/2023 17:17:15,Upscale-Upscale-DUMMY_Gemini_BTCUSD_1h_01_07_22_to_16_06_23.csv,BTC_USD,WEEK,214.14,0.002,21/04/2023 00:00:00,14/04/2023 00:00:00,03/03/2023 00:00:00,TAKE_PROFIT_HIT,SHORT,23468.0,20996.18,20996.18,25939.82,0.219,11.77,9.53,4.91,2,1.0,4.91,0.075,0.035202,TAKER
20/01/2023 00:00:00,17/06/2023 17:17:15,Upscale-Upscale-DUMMY_Gemini_BTCUSD_1h_01_07_22_to_16_06_23.csv,BTC_USD,WEEK,219.05,0.001,17/03/2023 00:00:00,10/03/2023 00:00:00,10/03/2023 00:00:00,EXPIRED,LONG,23013.0,25052.0,27602.55,18423.45,0.105,16.63,24.91,4.57,2,1.0,2.02,0.075,0.01725975,TAKER
17/02/2023 00:00:00,17/06/2023 17:17:15,Upscale-Upscale-DUMMY_Gemini_BTCUSD_1h_01_07_22_to_16_06_23.csv,BTC_USD,WEEK,221.07,0.003,31/03/2023 00:00:00,07/04/2023 00:00:00,03/03/2023 00:00:00,TAKE_PROFIT_HIT,SHORT,23948.0,22334.58,22334.58,25561.42,0.325,7.22,6.31,4.79,2,1.0,4.79,0.075,0.053883,TAKER
24/02/2023 00:00:00,17/06/2023 17:17:15,Upscale-Upscale-DUMMY_Gemini_BTCUSD_1h_01_07_22_to_16_06_23.csv,BTC_USD,WEEK,225.86,0.002,21/04/2023 00:00:00,14/04/2023 00:00:00,03/03/2023 00:00:00,TAKE_PROFIT_HIT,SHORT,23468.0,20996.18,20996.18,25939.82,0.208,11.77,9.53,4.91,2,1.0,4.91,0.075,0.035202,TAKER
17/02/2023 00:00:00,17/06/2023 17:17:15,Upscale-Upscale-DUMMY_Gemini_BTCUSD_1h_01_07_22_to_16_06_23.csv,BTC_USD,WEEK,230.77,0.003,31/03/2023 00:00:00,07/04/2023 00:00:00,03/03/2023 00:00:00,TAKE_PROFIT_HIT,SHORT,23948.0,22334.58,22334.58,25561.42,0.311,7.22,6.31,4.79,2,1.0,4.79,0.075,0.053883,TAKER
24/03/2023 00:00:00,17/06/2023 17:17:15,Upscale-Upscale-DUMMY_Gemini_BTCUSD_1h_01_07_22_to_16_06_23.csv,BTC_USD,WEEK,235.56,0.0,19/05/2023 00:00:00,12/05/2023 00:00:00,12/05/2023 00:00:00,EXPIRED,LONG,27941.0,26831.0,39981.24,15900.77,0.0,30.11,75.72,0.0,0,0.0,0.0,0.075,0.0,TAKER
20/01/2023 00:00:00,17/06/2023 17:17:15,Upscale-Upscale-DUMMY_Gemini_BTCUSD_1h_01_07_22_to_16_06_23.csv,BTC_USD,WEEK,235.56,0.001,17/03/2023 00:00:00,10/03/2023 00:00:00,10/03/2023 00:00:00,EXPIRED,LONG,23013.0,25052.0,27602.55,18423.45,0.098,16.63,24.91,4.57,2,1.0,2.02,0.075,0.01725975,TAKER
24/03/2023 00:00:00,17/06/2023 17:17:15,Upscale-Upscale-DUMMY_Gemini_BTCUSD_1h_01_07_22_to_16_06_23.csv,BTC_USD,WEEK,237.58,0.0,19/05/2023 00:00:00,12/05/2023 00:00:00,12/05/2023 00:00:00,EXPIRED,LONG,27941.0,26831.0,39981.24,15900.77,0.0,30.11,75.72,0.0,0,0.0,0.0,0.075,0.0,TAKER
17/02/2023 00:00:00,17/06/2023 17:17:15,Upscale-Upscale-DUMMY_Gemini_BTCUSD_1h_01_07_22_to_16_06_23.csv,BTC_USD,WEEK,237.58,0.003,31/03/2023 00:00:00,07/04/2023 00:00:00,03/03/2023 00:00:00,TAKE_PROFIT_HIT,SHORT,23948.0,22334.58,22334.58,25561.42,0.302,7.22,6.31,4.79,2,1.0,4.79,0.075,0.053883,TAKER
27/01/2023 00:00:00,17/06/2023 17:17:15,Upscale-Upscale-DUMMY_Gemini_BTCUSD_1h_01_07_22_to_16_06_23.csv,BTC_USD,WEEK,242.37,0.0,24/03/2023 00:00:00,17/03/2023 00:00:00,17/03/2023 00:00:00,EXPIRED,LONG,23487.0,28351.0,34225.92,12748.09,0.0,31.38,84.24,0.0,0,0.0,0.0,0.075,0.0,TAKER
24/02/2023 00:00:00,17/06/2023 17:17:15,Upscale-Upscale-DUMMY_Gemini_BTCUSD_1h_01_07_22_to_16_06_23.csv,BTC_USD,WEEK,242.37,0.002,21/04/2023 00:00:00,14/04/2023 00:00:00,03/03/2023 00:00:00,TAKE_PROFIT_HIT,SHORT,23468.0,20996.18,20996.18,25939.82,0.194,11.77,9.53,4.91,2,1.0,4.91,0.075,0.035202,TAKER
24/02/2023 00:00:00,17/06/2023 17:17:15,Upscale-Upscale-DUMMY_Gemini_BTCUSD_1h_01_07_22_to_16_06_23.csv,BTC_USD,WEEK,247.28,0.002,21/04/2023 00:00:00,14/04/2023 00:00:00,03/03/2023 00:00:00,TAKE_PROFIT_HIT,SHORT,23468.0,20996.18,20996.18,25939.82,0.19,11.77,9.53,4.91,2,1.0,4.91,0.075,0.035202,TAKER
20/01/2023 00:00:00,17/06/2023 17:17:15,Upscale-Upscale-DUMMY_Gemini_BTCUSD_1h_01_07_22_to_16_06_23.csv,BTC_USD,WEEK,252.19,0.001,17/03/2023 00:00:00,10/03/2023 00:00:00,10/03/2023 00:00:00,EXPIRED,LONG,23013.0,25052.0,27602.55,18423.45,0.091,16.63,24.91,4.57,2,1.0,2.02,0.075,0.01725975,TAKER
20/01/2023 00:00:00,17/06/2023 17:17:15,Upscale-Upscale-DUMMY_Gemini_BTCUSD_1h_01_07_22_to_16_06_23.csv,BTC_USD,WEEK,254.21,0.001,17/03/2023 00:00:00,10/03/2023 00:00:00,10/03/2023 00:00:00,EXPIRED,LONG,23013.0,25052.0,27602.55,18423.45,0.091,16.63,24.91,4.57,2,1.0,2.02,0.075,0.01725975,TAKER
24/02/2023 00:00:00,17/06/2023 17:17:15,Upscale-Upscale-DUMMY_Gemini_BTCUSD_1h_01_07_22_to_16_06_23.csv,BTC_USD,WEEK,256.23,0.002,21/04/2023 00:00:00,14/04/2023 00:00:00,03/03/2023 00:00:00,TAKE_PROFIT_HIT,SHORT,23468.0,20996.18,20996.18,25939.82,0.183,11.77,9.53,4.91,2,1.0,4.91,0.075,0.035202,TAKER
24/03/2023 00:00:00,17/06/2023 17:17:15,Upscale-Upscale-DUMMY_Gemini_BTCUSD_1h_01_07_22_to_16_06_23.csv,BTC_USD,WEEK,261.14,0.0,19/05/2023 00:00:00,12/05/2023 00:00:00,12/05/2023 00:00:00,EXPIRED,LONG,27941.0,26831.0,39981.24,15900.77,0.0,30.11,75.72,0.0,0,0.0,0.0,0.075,0.0,TAKER
17/02/2023 00:00:00,17/06/2023 17:17:15,Upscale-Upscale-DUMMY_Gemini_BTCUSD_1h_01_07_22_to_16_06_23.csv,BTC_USD,WEEK,261.14,0.003,31/03/2023 00:00:00,07/04/2023 00:00:00,03/03/2023 00:00:00,TAKE_PROFIT_HIT,SHORT,23948.0,22334.58,22334.58,25561.42,0.275,7.22,6.31,4.79,2,1.0,4.79,0.075,0.053883,TAKER
20/01/2023 00:00:00,17/06/2023 17:17:15,Upscale-Upscale-DUMMY_Gemini_BTCUSD_1h_01_07_22_to_16_06_23.csv,BTC_USD,WEEK,265.93,0.001,17/03/2023 00:00:00,10/03/2023 00:00:00,10/03/2023 00:00:00,EXPIRED,LONG,23013.0,25052.0,27602.55,18423.45,0.087,16.63,24.91,4.57,2,1.0,2.02,0.075,0.01725975,TAKER
27/01/2023 00:00:00,17/06/2023 17:17:15,Upscale-Upscale-DUMMY_Gemini_BTCUSD_1h_01_07_22_to_16_06_23.csv,BTC_USD,WEEK,267.95,0.0,24/03/2023 00:00:00,17/03/2023 00:00:00,17/03/2023 00:00:00,EXPIRED,LONG,23487.0,28351.0,34225.92,12748.09,0.0,31.38,84.24,0.0,0,0.0,0.0,0.075,0.0,TAKER
03/03/2023 00:00:00,17/06/2023 17:17:15,Upscale-Upscale-DUMMY_Gemini_BTCUSD_1h_01_07_22_to_16_06_23.csv,BTC_USD,WEEK,267.95,0.003,21/04/2023 00:00:00,21/04/2023 00:00:00,10/03/2023 00:00:00,STOP_LOSS_HIT,SHORT,20290.0,21899.78,18680.22,21899.78,0.227,8.62,7.35,4.78,2,1.0,-4.87,0.075,0.0456525,TAKER
03/03/2023 00:00:00,17/06/2023 17:17:15,Upscale-Upscale-DUMMY_Gemini_BTCUSD_1h_01_07_22_to_16_06_23.csv,BTC_USD,WEEK,263.08,0.003,21/04/2023 00:00:00,21/04/2023 00:00:00,10/03/2023 00:00:00,STOP_LOSS_HIT,SHORT,20290.0,21899.78,18680.22,21899.78,0.231,8.62,7.35,4.78,2,1.0,-4.87,0.075,0.0456525,TAKER
24/03/2023 00:00:00,17/06/2023 17:17:15,Upscale-Upscale-DUMMY_Gemini_BTCUSD_1h_01_07_22_to_16_06_23.csv,BTC_USD,WEEK,258.21,0.0,19/05/2023 00:00:00,12/05/2023 00:00:00,12/05/2023 00:00:00,EXPIRED,LONG,27941.0,26831.0,39981.24,15900.77,0.0,30.11,75.72,0.0,0,0.0,0.0,0.075,0.0,TAKER
03/03/2023 00:00:00,17/06/2023 17:17:15,Upscale-Upscale-DUMMY_Gemini_BTCUSD_1h_01_07_22_to_16_06_23.csv,BTC_USD,WEEK,258.21,0.003,21/04/2023 00:00:00,21/04/2023 00:00:00,10/03/2023 00:00:00,STOP_LOSS_HIT,SHORT,20290.0,21899.78,18680.22,21899.78,0.236,8.62,7.35,4.78,2,1.0,-4.87,0.075,0.0456525,TAKER
17/02/2023 00:00:00,17/06/2023 17:17:15,Upscale-Upscale-DUMMY_Gemini_BTCUSD_1h_01_07_22_to_16_06_23.csv,BTC_USD,WEEK,253.34,0.003,31/03/2023 00:00:00,07/04/2023 00:00:00,03/03/2023 00:00:00,TAKE_PROFIT_HIT,SHORT,23948.0,22334.58,22334.58,25561.42,0.284,7.22,6.31,4.79,2,1.0,4.79,0.075,0.053883,TAKER
17/02/2023 00:00:00,17/06/2023 17:17:15,Upscale-Upscale-DUMMY_Gemini_BTCUSD_1h_01_07_22_to_16_06_23.csv,BTC_USD,WEEK,258.13,0.003,31/03/2023 00:00:00,07/04/2023 00:00:00,03/03/2023 00:00:00,TAKE_PROFIT_HIT,SHORT,23948.0,22334.58,22334.58,25561.42,0.278,7.22,6.31,4.79,2,1.0,4.79,0.075,0.053883,TAKER
24/02/2023 00:00:00,17/06/2023 17:17:15,Upscale-Upscale-DUMMY_Gemini_BTCUSD_1h_01_07_22_to_16_06_23.csv,BTC_USD,WEEK,262.92,0.002,21/04/2023 00:00:00,14/04/2023 00:00:00,03/03/2023 00:00:00,TAKE_PROFIT_HIT,SHORT,23468.0,20996.18,20996.18,25939.82,0.179,11.77,9.53,4.91,2,1.0,4.91,0.075,0.035202,TAKER
24/03/2023 00:00:00,17/06/2023 17:17:15,Upscale-Upscale-DUMMY_Gemini_BTCUSD_1h_01_07_22_to_16_06_23.csv,BTC_USD,WEEK,267.83,0.0,19/05/2023 00:00:00,12/05/2023 00:00:00,12/05/2023 00:00:00,EXPIRED,LONG,27941.0,26831.0,39981.24,15900.77,0.0,30.11,75.72,0.0,0,0.0,0.0,0.075,0.0,TAKER
24/02/2023 00:00:00,17/06/2023 17:17:15,Upscale-Upscale-DUMMY_Gemini_BTCUSD_1h_01_07_22_to_16_06_23.csv,BTC_USD,WEEK,267.83,0.002,21/04/2023 00:00:00,14/04/2023 00:00:00,03/03/2023 00:00:00,TAKE_PROFIT_HIT,SHORT,23468.0,20996.18,20996.18,25939.82,0.175,11.77,9.53,4.91,2,1.0,4.91,0.075,0.035202,TAKER
24/02/2023 00:00:00,17/06/2023 17:17:15,Upscale-Upscale-DUMMY_Gemini_BTCUSD_1h_01_07_22_to_16_06_23.csv,BTC_USD,WEEK,272.74,0.002,21/04/2023 00:00:00,14/04/2023 00:00:00,03/03/2023 00:00:00,TAKE_PROFIT_HIT,SHORT,23468.0,20996.18,20996.18,25939.82,0.172,11.77,9.53,4.91,2,1.0,4.91,0.075,0.035202,TAKER
03/03/2023 00:00:00,17/06/2023 17:17:15,Upscale-Upscale-DUMMY_Gemini_BTCUSD_1h_01_07_22_to_16_06_23.csv,BTC_USD,WEEK,277.65,0.003,21/04/2023 00:00:00,21/04/2023 00:00:00,10/03/2023 00:00:00,STOP_LOSS_HIT,SHORT,20290.0,21899.78,18680.22,21899.78,0.219,8.62,7.35,4.78,2,1.0,-4.87,0.075,0.0456525,TAKER
17/02/2023 00:00:00,17/06/2023 17:17:15,Upscale-Upscale-DUMMY_Gemini_BTCUSD_1h_01_07_22_to_16_06_23.csv,BTC_USD,WEEK,272.78,0.003,31/03/2023 00:00:00,07/04/2023 00:00:00,03/03/2023 00:00:00,TAKE_PROFIT_HIT,SHORT,23948.0,22334.58,22334.58,25561.42,0.263,7.22,6.31,4.79,2,1.0,4.79,0.075,0.053883,TAKER
17/02/2023 00:00:00,17/06/2023 17:17:15,Upscale-Upscale-DUMMY_Gemini_BTCUSD_1h_01_07_22_to_16_06_23.csv,BTC_USD,WEEK,277.57,0.003,31/03/2023 00:00:00,07/04/2023 00:00:00,03/03/2023 00:00:00,TAKE_PROFIT_HIT,SHORT,23948.0,22334.58,22334.58,25561.42,0.259,7.22,6.31,4.79,2,1.0,4.79,0.075,0.053883,TAKER
03/03/2023 00:00:00,17/06/2023 17:17:15,Upscale-Upscale-DUMMY_Gemini_BTCUSD_1h_01_07_22_to_16_06_23.csv,BTC_USD,WEEK,282.36,0.004,21/04/2023 00:00:00,21/04/2023 00:00:00,10/03/2023 00:00:00,STOP_LOSS_HIT,SHORT,20290.0,21899.78,18680.22,21899.78,0.287,8.62,7.35,6.38,2,1.0,-6.5,0.075,0.06087,TAKER
17/02/2023 00:00:00,17/06/2023 17:17:15,Upscale-Upscale-DUMMY_Gemini_BTCUSD_1h_01_07_22_to_16_06_23.csv,BTC_USD,WEEK,275.86,0.003,31/03/2023 00:00:00,07/04/2023 00:00:00,03/03/2023 00:00:00,TAKE_PROFIT_HIT,SHORT,23948.0,22334.58,22334.58,25561.42,0.26,7.22,6.31,4.79,2,1.0,4.79,0.075,0.053883,TAKER
24/03/2023 00:00:00,17/06/2023 17:17:15,Upscale-Upscale-DUMMY_Gemini_BTCUSD_1h_01_07_22_to_16_06_23.csv,BTC_USD,WEEK,280.65,0.0,19/05/2023 00:00:00,12/05/2023 00:00:00,12/05/2023 00:00:00,EXPIRED,LONG,27941.0,26831.0,39981.24,15900.77,0.0,30.11,75.72,0.0,0,0.0,0.0,0.075,0.0,TAKER
27/01/2023 00:00:00,17/06/2023 17:17:15,Upscale-Upscale-DUMMY_Gemini_BTCUSD_1h_01_07_22_to_16_06_23.csv,BTC_USD,WEEK,280.65,0.001,24/03/2023 00:00:00,17/03/2023 00:00:00,17/03/2023 00:00:00,EXPIRED,LONG,23487.0,28351.0,34225.92,12748.09,0.084,31.38,84.24,10.72,4,1.0,4.85,0.075,0.01761525,TAKER
24/02/2023 00:00:00,17/06/2023 17:17:15,Upscale-Upscale-DUMMY_Gemini_BTCUSD_1h_01_07_22_to_16_06_23.csv,BTC_USD,WEEK,285.5,0.002,21/04/2023 00:00:00,14/04/2023 00:00:00,03/03/2023 00:00:00,TAKE_PROFIT_HIT,SHORT,23468.0,20996.18,20996.18,25939.82,0.164,11.77,9.53,4.91,2,1.0,4.91,0.075,0.035202,TAKER
17/02/2023 00:00:00,17/06/2023 17:17:15,Upscale-Upscale-DUMMY_Gemini_BTCUSD_1h_01_07_22_to_16_06_23.csv,BTC_USD,WEEK,290.41,0.004,31/03/2023 00:00:00,07/04/2023 00:00:00,03/03/2023 00:00:00,TAKE_PROFIT_HIT,SHORT,23948.0,22334.58,22334.58,25561.42,0.33,7.22,6.31,6.38,2,1.0,6.38,0.075,0.071844,TAKER
24/03/2023 00:00:00,17/06/2023 17:17:15,Upscale-Upscale-DUMMY_Gemini_BTCUSD_1h_01_07_22_to_16_06_23.csv,BTC_USD,WEEK,296.79,0.0,19/05/2023 00:00:00,12/05/2023 00:00:00,12/05/2023 00:00:00,EXPIRED,LONG,27941.0,26831.0,39981.24,15900.77,0.0,30.11,75.72,0.0,0,0.0,0.0,0.075,0.0,TAKER
20/01/2023 00:00:00,17/06/2023 17:17:15,Upscale-Upscale-DUMMY_Gemini_BTCUSD_1h_01_07_22_to_16_06_23.csv,BTC_USD,WEEK,296.79,0.001,17/03/2023 00:00:00,10/03/2023 00:00:00,10/03/2023 00:00:00,EXPIRED,LONG,23013.0,25052.0,27602.55,18423.45,0.078,16.63,24.91,4.57,2,1.0,2.02,0.075,0.01725975,TAKER
24/03/2023 00:00:00,17/06/2023 17:17:15,Upscale-Upscale-DUMMY_Gemini_BTCUSD_1h_01_07_22_to_16_06_23.csv,BTC_USD,WEEK,298.81,0.0,19/05/2023 00:00:00,12/05/2023 00:00:00,12/05/2023 00:00:00,EXPIRED,LONG,27941.0,26831.0,39981.24,15900.77,0.0,30.11,75.72,0.0,0,0.0,0.0,0.075,0.0,TAKER
24/03/2023 00:00:00,17/06/2023 17:17:15,Upscale-Upscale-DUMMY_Gemini_BTCUSD_1h_01_07_22_to_16_06_23.csv,BTC_USD,WEEK,298.81,0.0,19/05/2023 00:00:00,12/05/2023 00:00:00,12/05/2023 00:00:00,EXPIRED,LONG,27941.0,26831.0,39981.24,15900.77,0.0,30.11,75.72,0.0,0,0.0,0.0,0.075,0.0,TAKER
20/01/2023 00:00:00,17/06/2023 17:17:15,Upscale-Upscale-DUMMY_Gemini_BTCUSD_1h_01_07_22_to_16_06_23.csv,BTC_USD,WEEK,298.81,0.001,17/03/2023 00:00:00,10/03/2023 00:00:00,10/03/2023 00:00:00,EXPIRED,LONG,23013.0,25052.0,27602.55,18423.45,0.077,16.63,24.91,4.57,2,1.0,2.02,0.075,0.01725975,TAKER
24/03/2023 00:00:00,17/06/2023 17:17:15,Upscale-Upscale-DUMMY_Gemini_BTCUSD_1h_01_07_22_to_16_06_23.csv,BTC_USD,WEEK,300.83,0.0,19/05/2023 00:00:00,12/05/2023 00:00:00,12/05/2023 00:00:00,EXPIRED,LONG,27941.0,26831.0,39981.24,15900.77,0.0,30.11,75.72,0.0,0,0.0,0.0,0.075,0.0,TAKER
20/01/2023 00:00:00,17/06/2023 17:17:15,Upscale-Upscale-DUMMY_Gemini_BTCUSD_1h_01_07_22_to_16_06_23.csv,BTC_USD,WEEK,300.83,0.001,17/03/2023 00:00:00,10/03/2023 00:00:00,10/03/2023 00:00:00,EXPIRED,LONG,23013.0,25052.0,27602.55,18423.45,0.076,16.63,24.91,4.57,2,1.0,2.02,0.075,0.01725975,TAKER
24/02/2023 00:00:00,17/06/2023 17:17:16,Upscale-Upscale-DUMMY_Gemini_BTCUSD_1h_01_07_22_to_16_06_23.csv,BTC_USD,WEEK,302.85,0.002,21/04/2023 00:00:00,14/04/2023 00:00:00,03/03/2023 00:00:00,TAKE_PROFIT_HIT,SHORT,23468.0,20996.18,20996.18,25939.82,0.155,11.77,9.53,4.91,2,1.0,4.91,0.075,0.035202,TAKER
27/01/2023 00:00:00,17/06/2023 17:17:16,Upscale-Upscale-DUMMY_Gemini_BTCUSD_1h_01_07_22_to_16_06_23.csv,BTC_USD,WEEK,307.76,0.001,24/03/2023 00:00:00,17/03/2023 00:00:00,17/03/2023 00:00:00,EXPIRED,LONG,23487.0,28351.0,34225.92,12748.09,0.076,31.38,84.24,10.72,3,1.0,4.85,0.075,0.01761525,TAKER
17/02/2023 00:00:00,17/06/2023 17:17:16,Upscale-Upscale-DUMMY_Gemini_BTCUSD_1h_01_07_22_to_16_06_23.csv,BTC_USD,WEEK,312.61,0.004,31/03/2023 00:00:00,07/04/2023 00:00:00,03/03/2023 00:00:00,TAKE_PROFIT_HIT,SHORT,23948.0,22334.58,22334.58,25561.42,0.306,7.22,6.31,6.38,2,1.0,6.38,0.075,0.071844,TAKER
03/03/2023 00:00:00,17/06/2023 17:17:16,Upscale-Upscale-DUMMY_Gemini_BTCUSD_1h_01_07_22_to_16_06_23.csv,BTC_USD,WEEK,318.99,0.004,21/04/2023 00:00:00,21/04/2023 00:00:00,10/03/2023 00:00:00,STOP_LOSS_HIT,SHORT,20290.0,21899.78,18680.22,21899.78,0.254,8.62,7.35,6.38,2,1.0,-6.5,0.075,0.06087,TAKER
03/03/2023 00:00:00,17/06/2023 17:17:16,Upscale-Upscale-DUMMY_Gemini_BTCUSD_1h_01_07_22_to_16_06_23.csv,BTC_USD,WEEK,312.49,0.004,21/04/2023 00:00:00,21/04/2023 00:00:00,10/03/2023 00:00:00,STOP_LOSS_HIT,SHORT,20290.0,21899.78,18680.22,21899.78,0.26,8.62,7.35,6.38,2,1.0,-6.5,0.075,0.06087,TAKER
24/02/2023 00:00:00,17/06/2023 17:17:16,Upscale-Upscale-DUMMY_Gemini_BTCUSD_1h_01_07_22_to_16_06_23.csv,BTC_USD,WEEK,305.99,0.002,21/04/2023 00:00:00,14/04/2023 00:00:00,03/03/2023 00:00:00,TAKE_PROFIT_HIT,SHORT,23468.0,20996.18,20996.18,25939.82,0.153,11.77,9.53,4.91,2,1.0,4.91,0.075,0.035202,TAKER
17/02/2023 00:00:00,17/06/2023 17:17:16,Upscale-Upscale-DUMMY_Gemini_BTCUSD_1h_01_07_22_to_16_06_23.csv,BTC_USD,WEEK,310.9,0.004,31/03/2023 00:00:00,07/04/2023 00:00:00,03/03/2023 00:00:00,TAKE_PROFIT_HIT,SHORT,23948.0,22334.58,22334.58,25561.42,0.308,7.22,6.31,6.38,2,1.0,6.38,0.075,0.071844,TAKER
24/02/2023 00:00:00,17/06/2023 17:17:16,Upscale-Upscale-DUMMY_Gemini_BTCUSD_1h_01_07_22_to_16_06_23.csv,BTC_USD,WEEK,317.28,0.003,21/04/2023 00:00:00,14/04/2023 00:00:00,03/03/2023 00:00:00,TAKE_PROFIT_HIT,SHORT,23468.0,20996.18,20996.18,25939.82,0.222,11.77,9.53,7.36,2,1.0,7.36,0.075,0.052802999999999996,TAKER
03/03/2023 00:00:00,17/06/2023 17:17:16,Upscale-Upscale-DUMMY_Gemini_BTCUSD_1h_01_07_22_to_16_06_23.csv,BTC_USD,WEEK,324.64,0.004,21/04/2023 00:00:00,21/04/2023 00:00:00,10/03/2023 00:00:00,STOP_LOSS_HIT,SHORT,20290.0,21899.78,18680.22,21899.78,0.25,8.62,7.35,6.38,2,1.0,-6.5,0.075,0.06087,TAKER
03/03/2023 00:00:00,17/06/2023 17:17:16,Upscale-Upscale-DUMMY_Gemini_BTCUSD_1h_01_07_22_to_16_06_23.csv,BTC_USD,WEEK,318.14,0.004,21/04/2023 00:00:00,21/04/2023 00:00:00,10/03/2023 00:00:00,STOP_LOSS_HIT,SHORT,20290.0,21899.78,18680.22,21899.78,0.255,8.62,7.35,6.38,2,1.0,-6.5,0.075,0.06087,TAKER
03/03/2023 00:00:00,17/06/2023 17:17:16,Upscale-Upscale-DUMMY_Gemini_BTCUSD_1h_01_07_22_to_16_06_23.csv,BTC_USD,WEEK,311.64,0.004,21/04/2023 00:00:00,21/04/2023 00:00:00,10/03/2023 00:00:00,STOP_LOSS_HIT,SHORT,20290.0,21899.78,18680.22,21899.78,0.26,8.62,7.35,6.38,2,1.0,-6.5,0.075,0.06087,TAKER
03/03/2023 00:00:00,17/06/2023 17:17:16,Upscale-Upscale-DUMMY_Gemini_BTCUSD_1h_01_07_22_to_16_06_23.csv,BTC_USD,WEEK,305.14,0.004,21/04/2023 00:00:00,21/04/2023 00:00:00,10/03/2023 00:00:00,STOP_LOSS_HIT,SHORT,20290.0,21899.78,18680.22,21899.78,0.266,8.62,7.35,6.38,2,1.0,-6.5,0.075,0.06087,TAKER
17/02/2023 00:00:00,17/06/2023 17:17:16,Upscale-Upscale-DUMMY_Gemini_BTCUSD_1h_01_07_22_to_16_06_23.csv,BTC_USD,WEEK,298.64,0.004,31/03/2023 00:00:00,07/04/2023 00:00:00,03/03/2023 00:00:00,TAKE_PROFIT_HIT,SHORT,23948.0,22334.58,22334.58,25561.42,0.321,7.22,6.31,6.38,2,1.0,6.38,0.075,0.071844,TAKER
24/03/2023 00:00:00,17/06/2023 17:17:16,Upscale-Upscale-DUMMY_Gemini_BTCUSD_1h_01_07_22_to_16_06_23.csv,BTC_USD,WEEK,305.02,0.001,19/05/2023 00:00:00,12/05/2023 00:00:00,12/05/2023 00:00:00,EXPIRED,LONG,27941.0,26831.0,39981.24,15900.77,0.092,30.11,75.72,12.02,4,1.0,-1.13,0.075,0.02095575,TAKER
03/03/2023 00:00:00,17/06/2023 17:17:16,Upscale-Upscale-DUMMY_Gemini_BTCUSD_1h_01_07_22_to_16_06_23.csv,BTC_USD,WEEK,303.89,0.004,21/04/2023 00:00:00,21/04/2023 00:00:00,10/03/2023 00:00:00,STOP_LOSS_HIT,SHORT,20290.0,21899.78,18680.22,21899.78,0.267,8.62,7.35,6.38,2,1.0,-6.5,0.075,0.06087,TAKER
03/03/2023 00:00:00,17/06/2023 17:17:16,Upscale-Upscale-DUMMY_Gemini_BTCUSD_1h_01_07_22_to_16_06_23.csv,BTC_USD,WEEK,297.39,0.004,21/04/2023 00:00:00,21/04/2023 00:00:00,10/03/2023 00:00:00,STOP_LOSS_HIT,SHORT,20290.0,21899.78,18680.22,21899.78,0.273,8.62,7.35,6.38,2,1.0,-6.5,0.075,0.06087,TAKER
24/02/2023 00:00:00,17/06/2023 17:17:16,Upscale-Upscale-DUMMY_Gemini_BTCUSD_1h_01_07_22_to_16_06_23.csv,BTC_USD,WEEK,290.89,0.002,21/04/2023 00:00:00,14/04/2023 00:00:00,03/03/2023 00:00:00,TAKE_PROFIT_HIT,SHORT,23468.0,20996.18,20996.18,25939.82,0.161,11.77,9.53,4.91,2,1.0,4.91,0.075,0.035202,TAKER
24/02/2023 00:00:00,17/06/2023 17:17:16,Upscale-Upscale-DUMMY_Gemini_BTCUSD_1h_01_07_22_to_16_06_23.csv,BTC_USD,WEEK,295.8,0.002,21/04/2023 00:00:00,14/04/2023 00:00:00,03/03/2023 00:00:00,TAKE_PROFIT_HIT,SHORT,23468.0,20996.18,20996.18,25939.82,0.159,11.77,9.53,4.91,2,1.0,4.91,0.075,0.035202,TAKER
24/02/2023 00:00:00,17/06/2023 17:17:16,Upscale-Upscale-DUMMY_Gemini_BTCUSD_1h_01_07_22_to_16_06_23.csv,BTC_USD,WEEK,300.71,0.002,21/04/2023 00:00:00,14/04/2023 00:00:00,03/03/2023 00:00:00,TAKE_PROFIT_HIT,SHORT,23468.0,20996.18,20996.18,25939.82,0.156,11.77,9.53,4.91,2,1.0,4.91,0.075,0.035202,TAKER
03/03/2023 00:00:00,17/06/2023 17:17:16,Upscale-Upscale-DUMMY_Gemini_BTCUSD_1h_01_07_22_to_16_06_23.csv,BTC_USD,WEEK,305.62,0.004,21/04/2023 00:00:00,21/04/2023 00:00:00,10/03/2023 00:00:00,STOP_LOSS_HIT,SHORT,20290.0,21899.78,18680.22,21899.78,0.266,8.62,7.35,6.38,2,1.0,-6.5,0.075,0.06087,TAKER
17/02/2023 00:00:00,17/06/2023 17:17:16,Upscale-Upscale-DUMMY_Gemini_BTCUSD_1h_01_07_22_to_16_06_23.csv,BTC_USD,WEEK,299.12,0.004,31/03/2023 00:00:00,07/04/2023 00:00:00,03/03/2023 00:00:00,TAKE_PROFIT_HIT,SHORT,23948.0,22334.58,22334.58,25561.42,0.32,7.22,6.31,6.38,2,1.0,6.38,0.075,0.071844,TAKER
27/01/2023 00:00:00,17/06/2023 17:17:16,Upscale-Upscale-DUMMY_Gemini_BTCUSD_1h_01_07_22_to_16_06_23.csv,BTC_USD,WEEK,305.5,0.001,24/03/2023 00:00:00,17/03/2023 00:00:00,17/03/2023 00:00:00,EXPIRED,LONG,23487.0,28351.0,34225.92,12748.09,0.077,31.38,84.24,10.72,4,1.0,4.85,0.075,0.01761525,TAKER
03/03/2023 00:00:00,17/06/2023 17:17:16,Upscale-Upscale-DUMMY_Gemini_BTCUSD_1h_01_07_22_to_16_06_23.csv,BTC_USD,WEEK,310.35,0.004,21/04/2023 00:00:00,21/04/2023 00:00:00,10/03/2023 00:00:00,STOP_LOSS_HIT,SHORT,20290.0,21899.78,18680.22,21899.78,0.262,8.62,7.35,6.38,2,1.0,-6.5,0.075,0.06087,TAKER
24/03/2023 00:00:00,17/06/2023 17:17:16,Upscale-Upscale-DUMMY_Gemini_BTCUSD_1h_01_07_22_to_16_06_23.csv,BTC_USD,WEEK,303.85,0.001,19/05/2023 00:00:00,12/05/2023 00:00:00,12/05/2023 00:00:00,EXPIRED,LONG,27941.0,26831.0,39981.24,15900.77,0.092,30.11,75.72,12.02,4,1.0,-1.13,0.075,0.02095575,TAKER
20/01/2023 00:00:00,17/06/2023 17:17:16,Upscale-Upscale-DUMMY_Gemini_BTCUSD_1h_01_07_22_to_16_06_23.csv,BTC_USD,WEEK,302.72,0.001,17/03/2023 00:00:00,10/03/2023 00:00:00,10/03/2023 00:00:00,EXPIRED,LONG,23013.0,25052.0,27602.55,18423.45,0.076,16.63,24.91,4.57,2,1.0,2.02,0.075,0.01725975,TAKER
03/03/2023 00:00:00,17/06/2023 17:17:16,Upscale-Upscale-DUMMY_Gemini_BTCUSD_1h_01_07_22_to_16_06_23.csv,BTC_USD,WEEK,304.74,0.004,21/04/2023 00:00:00,21/04/2023 00:00:00,10/03/2023 00:00:00,STOP_LOSS_HIT,SHORT,20290.0,21899.78,18680.22,21899.78,0.266,8.62,7.35,6.38,2,1.0,-6.5,0.075,0.06087,TAKER
20/01/2023 00:00:00,17/06/2023 17:17:16,Upscale-Upscale-DUMMY_Gemini_BTCUSD_1h_01_07_22_to_16_06_23.csv,BTC_USD,WEEK,298.24,0.001,17/03/2023 00:00:00,10/03/2023 00:00:00,10/03/2023 00:00:00,EXPIRED,LONG,23013.0,25052.0,27602.55,18423.45,0.077,16.63,24.91,4.57,2,1.0,2.02,0.075,0.01725975,TAKER
24/02/2023 00:00:00,17/06/2023 17:17:16,Upscale-Upscale-DUMMY_Gemini_BTCUSD_1h_01_07_22_to_16_06_23.csv,BTC_USD,WEEK,300.26,0.002,21/04/2023 00:00:00,14/04/2023 00:00:00,03/03/2023 00:00:00,TAKE_PROFIT_HIT,SHORT,23468.0,20996.18,20996.18,25939.82,0.156,11.77,9.53,4.91,2,1.0,4.91,0.075,0.035202,TAKER
24/02/2023 00:00:00,17/06/2023 17:17:16,Upscale-Upscale-DUMMY_Gemini_BTCUSD_1h_01_07_22_to_16_06_23.csv,BTC_USD,WEEK,305.17,0.002,21/04/2023 00:00:00,14/04/2023 00:00:00,03/03/2023 00:00:00,TAKE_PROFIT_HIT,SHORT,23468.0,20996.18,20996.18,25939.82,0.154,11.77,9.53,4.91,2,1.0,4.91,0.075,0.035202,TAKER
03/03/2023 00:00:00,17/06/2023 17:17:16,Upscale-Upscale-DUMMY_Gemini_BTCUSD_1h_01_07_22_to_16_06_23.csv,BTC_USD,WEEK,310.08,0.004,21/04/2023 00:00:00,21/04/2023 00:00:00,10/03/2023 00:00:00,STOP_LOSS_HIT,SHORT,20290.0,21899.78,18680.22,21899.78,0.262,8.62,7.35,6.38,2,1.0,-6.5,0.075,0.06087,TAKER
17/02/2023 00:00:00,17/06/2023 17:17:16,Upscale-Upscale-DUMMY_Gemini_BTCUSD_1h_01_07_22_to_16_06_23.csv,BTC_USD,WEEK,303.58,0.004,31/03/2023 00:00:00,07/04/2023 00:00:00,03/03/2023 00:00:00,TAKE_PROFIT_HIT,SHORT,23948.0,22334.58,22334.58,25561.42,0.316,7.22,6.31,6.38,2,1.0,6.38,0.075,0.071844,TAKER
24/03/2023 00:00:00,17/06/2023 17:17:16,Upscale-Upscale-DUMMY_Gemini_BTCUSD_1h_01_07_22_to_16_06_23.csv,BTC_USD,WEEK,309.96,0.001,19/05/2023 00:00:00,12/05/2023 00:00:00,12/05/2023 00:00:00,EXPIRED,LONG,27941.0,26831.0,39981.24,15900.77,0.09,30.11,75.72,12.02,4,1.0,-1.13,0.075,0.02095575,TAKER
27/01/2023 00:00:00,17/06/2023 17:17:16,Upscale-Upscale-DUMMY_Gemini_BTCUSD_1h_01_07_22_to_16_06_23.csv,BTC_USD,WEEK,308.83,0.001,24/03/2023 00:00:00,17/03/2023 00:00:00,17/03/2023 00:00:00,EXPIRED,LONG,23487.0,28351.0,34225.92,12748.09,0.076,31.38,84.24,10.72,3,1.0,4.85,0.075,0.01761525,TAKER
20/01/2023 00:00:00,17/06/2023 17:17:16,Upscale-Upscale-DUMMY_Gemini_BTCUSD_1h_01_07_22_to_16_06_23.csv,BTC_USD,WEEK,313.68,0.001,17/03/2023 00:00:00,10/03/2023 00:00:00,10/03/2023 00:00:00,EXPIRED,LONG,23013.0,25052.0,27602.55,18423.45,0.073,16.63,24.91,4.57,1,1.0,2.02,0.075,0.01725975,TAKER
17/02/2023 00:00:00,17/06/2023 17:17:16,Upscale-Upscale-DUMMY_Gemini_BTCUSD_1h_01_07_22_to_16_06_23.csv,BTC_USD,WEEK,315.7,0.004,31/03/2023 00:00:00,07/04/2023 00:00:00,03/03/2023 00:00:00,TAKE_PROFIT_HIT,SHORT,23948.0,22334.58,22334.58,25561.42,0.303,7.22,6.31,6.38,2,1.0,6.38,0.075,0.071844,TAKER
27/01/2023 00:00:00,17/06/2023 17:17:16,Upscale-Upscale-DUMMY_Gemini_BTCUSD_1h_01_07_22_to_16_06_23.csv,BTC_USD,WEEK,322.08,0.001,24/03/2023 00:00:00,17/03/2023 00:00:00,17/03/2023 00:00:00,EXPIRED,LONG,23487.0,28351.0,34225.92,12748.09,0.073,31.38,84.24,10.72,3,1.0,4.85,0.075,0.01761525,TAKER
24/03/2023 00:00:00,17/06/2023 17:17:16,Upscale-Upscale-DUMMY_Gemini_BTCUSD_1h_01_07_22_to_16_06_23.csv,BTC_USD,WEEK,326.93,0.001,19/05/2023 00:00:00,12/05/2023 00:00:00,12/05/2023 00:00:00,EXPIRED,LONG,27941.0,26831.0,39981.24,15900.77,0.085,30.11,75.72,12.02,4,1.0,-1.13,0.075,0.02095575,TAKER
20/01/2023 00:00:00,17/06/2023 17:17:16,Upscale-Upscale-DUMMY_Gemini_BTCUSD_1h_01_07_22_to_16_06_23.csv,BTC_USD,WEEK,325.8,0.001,17/03/2023 00:00:00,10/03/2023 00:00:00,10/03/2023 00:00:00,EXPIRED,LONG,23013.0,25052.0,27602.55,18423.45,0.071,16.63,24.91,4.57,1,1.0,2.02,0.075,0.01725975,TAKER
03/03/2023 00:00:00,17/06/2023 17:17:16,Upscale-Upscale-DUMMY_Gemini_BTCUSD_1h_01_07_22_to_16_06_23.csv,BTC_USD,WEEK,327.82,0.004,21/04/2023 00:00:00,21/04/2023 00:00:00,10/03/2023 00:00:00,STOP_LOSS_HIT,SHORT,20290.0,21899.78,18680.22,21899.78,0.248,8.62,7.35,6.38,2,1.0,-6.5,0.075,0.06087,TAKER
24/03/2023 00:00:00,17/06/2023 17:17:16,Upscale-Upscale-DUMMY_Gemini_BTCUSD_1h_01_07_22_to_16_06_23.csv,BTC_USD,WEEK,321.32,0.001,19/05/2023 00:00:00,12/05/2023 00:00:00,12/05/2023 00:00:00,EXPIRED,LONG,27941.0,26831.0,39981.24,15900.77,0.087,30.11,75.72,12.02,4,1.0,-1.13,0.075,0.02095575,TAKER
03/03/2023 00:00:00,17/06/2023 17:17:16,Upscale-Upscale-DUMMY_Gemini_BTCUSD_1h_01_07_22_to_16_06_23.csv,BTC_USD,WEEK,320.19,0.004,21/04/2023 00:00:00,21/04/2023 00:00:00,10/03/2023 00:00:00,STOP_LOSS_HIT,SHORT,20290.0,21899.78,18680.22,21899.78,0.253,8.62,7.35,6.38,2,1.0,-6.5,0.075,0.06087,TAKER
17/02/2023 00:00:00,17/06/2023 17:17:16,Upscale-Upscale-DUMMY_Gemini_BTCUSD_1h_01_07_22_to_16_06_23.csv,BTC_USD,WEEK,313.69,0.004,31/03/2023 00:00:00,07/04/2023 00:00:00,03/03/2023 00:00:00,TAKE_PROFIT_HIT,SHORT,23948.0,22334.58,22334.58,25561.42,0.305,7.22,6.31,6.38,2,1.0,6.38,0.075,0.071844,TAKER
17/02/2023 00:00:00,17/06/2023 17:17:16,Upscale-Upscale-DUMMY_Gemini_BTCUSD_1h_01_07_22_to_16_06_23.csv,BTC_USD,WEEK,320.07,0.004,31/03/2023 00:00:00,07/04/2023 00:00:00,03/03/2023 00:00:00,TAKE_PROFIT_HIT,SHORT,23948.0,22334.58,22334.58,25561.42,0.299,7.22,6.31,6.38,2,1.0,6.38,0.075,0.071844,TAKER
20/01/2023 00:00:00,17/06/2023 17:17:16,Upscale-Upscale-DUMMY_Gemini_BTCUSD_1h_01_07_22_to_16_06_23.csv,BTC_USD,WEEK,326.45,0.001,17/03/2023 00:00:00,10/03/2023 00:00:00,10/03/2023 00:00:00,EXPIRED,LONG,23013.0,25052.0,27602.55,18423.45,0.07,16.63,24.91,4.57,1,1.0,2.02,0.075,0.01725975,TAKER
03/03/2023 00:00:00,17/06/2023 17:17:16,Upscale-Upscale-DUMMY_Gemini_BTCUSD_1h_01_07_22_to_16_06_23.csv,BTC_USD,WEEK,328.47,0.004,21/04/2023 00:00:00,21/04/2023 00:00:00,10/03/2023 00:00:00,STOP_LOSS_HIT,SHORT,20290.0,21899.78,18680.22,21899.78,0.247,8.62,7.35,6.38,2,1.0,-6.5,0.075,0.06087,TAKER
24/03/2023 00:00:00,17/06/2023 17:17:16,Upscale-Upscale-DUMMY_Gemini_BTCUSD_1h_01_07_22_to_16_06_23.csv,BTC_USD,WEEK,321.97,0.001,19/05/2023 00:00:00,12/05/2023 00:00:00,12/05/2023 00:00:00,EXPIRED,LONG,27941.0,26831.0,39981.24,15900.77,0.087,30.11,75.72,12.02,4,1.0,-1.13,0.075,0.02095575,TAKER
20/01/2023 00:00:00,17/06/2023 17:17:16,Upscale-Upscale-DUMMY_Gemini_BTCUSD_1h_01_07_22_to_16_06_23.csv,BTC_USD,WEEK,320.84,0.001,17/03/2023 00:00:00,10/03/2023 00:00:00,10/03/2023 00:00:00,EXPIRED,LONG,23013.0,25052.0,27602.55,18423.45,0.072,16.63,24.91,4.57,1,1.0,2.02,0.075,0.01725975,TAKER
20/01/2023 00:00:00,17/06/2023 17:17:16,Upscale-Upscale-DUMMY_Gemini_BTCUSD_1h_01_07_22_to_16_06_23.csv,BTC_USD,WEEK,322.86,0.001,17/03/2023 00:00:00,10/03/2023 00:00:00,10/03/2023 00:00:00,EXPIRED,LONG,23013.0,25052.0,27602.55,18423.45,0.071,16.63,24.91,4.57,1,1.0,2.02,0.075,0.01725975,TAKER
24/02/2023 00:00:00,17/06/2023 17:17:16,Upscale-Upscale-DUMMY_Gemini_BTCUSD_1h_01_07_22_to_16_06_23.csv,BTC_USD,WEEK,324.88,0.003,21/04/2023 00:00:00,14/04/2023 00:00:00,03/03/2023 00:00:00,TAKE_PROFIT_HIT,SHORT,23468.0,20996.18,20996.18,25939.82,0.217,11.77,9.53,7.36,2,1.0,7.36,0.075,0.052802999999999996,TAKER
03/03/2023 00:00:00,17/06/2023 17:17:16,Upscale-Upscale-DUMMY_Gemini_BTCUSD_1h_01_07_22_to_16_06_23.csv,BTC_USD,WEEK,332.24,0.004,21/04/2023 00:00:00,21/04/2023 00:00:00,10/03/2023 00:00:00,STOP_LOSS_HIT,SHORT,20290.0,21899.78,18680.22,21899.78,0.244,8.62,7.35,6.38,2,1.0,-6.5,0.075,0.06087,TAKER
20/01/2023 00:00:00,17/06/2023 17:17:16,Upscale-Upscale-DUMMY_Gemini_BTCUSD_1h_01_07_22_to_16_06_23.csv,BTC_USD,WEEK,325.74,0.001,17/03/2023 00:00:00,10/03/2023 00:00:00,10/03/2023 00:00:00,EXPIRED,LONG,23013.0,25052.0,27602.55,18423.45,0.071,16.63,24.91,4.57,1,1.0,2.02,0.075,0.01725975,TAKER
17/02/2023 00:00:00,17/06/2023 17:17:16,Upscale-Upscale-DUMMY_Gemini_BTCUSD_1h_01_07_22_to_16_06_23.csv,BTC_USD,WEEK,327.76,0.004,31/03/2023 00:00:00,07/04/2023 00:00:00,03/03/2023 00:00:00,TAKE_PROFIT_HIT,SHORT,23948.0,22334.58,22334.58,25561.42,0.292,7.22,6.31,6.38,2,1.0,6.38,0.075,0.071844,TAKER
03/03/2023 00:00:00,17/06/2023 17:17:16,Upscale-Upscale-DUMMY_Gemini_BTCUSD_1h_01_07_22_to_16_06_23.csv,BTC_USD,WEEK,334.14,0.004,21/04/2023 00:00:00,21/04/2023 00:00:00,10/03/2023 00:00:00,STOP_LOSS_HIT,SHORT,20290.0,21899.78,18680.22,21899.78,0.243,8.62,7.35,6.38,2,1.0,-6.5,0.075,0.06087,TAKER
03/03/2023 00:00:00,17/06/2023 17:17:16,Upscale-Upscale-DUMMY_Gemini_BTCUSD_1h_01_07_22_to_16_06_23.csv,BTC_USD,WEEK,327.64,0.004,21/04/2023 00:00:00,21/04/2023 00:00:00,10/03/2023 00:00:00,STOP_LOSS_HIT,SHORT,20290.0,21899.78,18680.22,21899.78,0.248,8.62,7.35,6.38,2,1.0,-6.5,0.075,0.06087,TAKER
03/03/2023 00:00:00,17/06/2023 17:17:16,Upscale-Upscale-DUMMY_Gemini_BTCUSD_1h_01_07_22_to_16_06_23.csv,BTC_USD,WEEK,321.14,0.004,21/04/2023 00:00:00,21/04/2023 00:00:00,10/03/2023 00:00:00,STOP_LOSS_HIT,SHORT,20290.0,21899.78,18680.22,21899.78,0.253,8.62,7.35,6.38,2,1.0,-6.5,0.075,0.06087,TAKER
17/02/2023 00:00:00,17/06/2023 17:17:16,Upscale-Upscale-DUMMY_Gemini_BTCUSD_1h_01_07_22_to_16_06_23.csv,BTC_USD,WEEK,314.64,0.004,31/03/2023 00:00:00,07/04/2023 00:00:00,03/03/2023 00:00:00,TAKE_PROFIT_HIT,SHORT,23948.0,22334.58,22334.58,25561.42,0.304,7.22,6.31,6.38,2,1.0,6.38,0.075,0.071844,TAKER
24/03/2023 00:00:00,17/06/2023 17:17:16,Upscale-Upscale-DUMMY_Gemini_BTCUSD_1h_01_07_22_to_16_06_23.csv,BTC_USD,WEEK,321.02,0.001,19/05/2023 00:00:00,12/05/2023 00:00:00,12/05/2023 00:00:00,EXPIRED,LONG,27941.0,26831.0,39981.24,15900.77,0.087,30.11,75.72,12.02,4,1.0,-1.13,0.075,0.02095575,TAKER
24/02/2023 00:00:00,17/06/2023 17:17:16,Upscale-Upscale-DUMMY_Gemini_BTCUSD_1h_01_07_22_to_16_06_23.csv,BTC_USD,WEEK,319.89,0.003,21/04/2023 00:00:00,14/04/2023 00:00:00,03/03/2023 00:00:00,TAKE_PROFIT_HIT,SHORT,23468.0,20996.18,20996.18,25939.82,0.22,11.77,9.53,7.36,2,1.0,7.36,0.075,0.052802999999999996,TAKER
24/02/2023 00:00:00,17/06/2023 17:17:16,Upscale-Upscale-DUMMY_Gemini_BTCUSD_1h_01_07_22_to_16_06_23.csv,BTC_USD,WEEK,327.25,0.003,21/04/2023 00:00:00,14/04/2023 00:00:00,03/03/2023 00:00:00,TAKE_PROFIT_HIT,SHORT,23468.0,20996.18,20996.18,25939.82,0.215,11.77,9.53,7.36,2,1.0,7.36,0.075,0.052802999999999996,TAKER
17/02/2023 00:00:00,17/06/2023 17:17:16,Upscale-Upscale-DUMMY_Gemini_BTCUSD_1h_01_07_22_to_16_06_23.csv,BTC_USD,WEEK,334.61,0.004,31/03/2023 00:00:00,07/04/2023 00:00:00,03/03/2023 00:00:00,TAKE_PROFIT_HIT,SHORT,23948.0,22334.58,22334.58,25561.42,0.286,7.22,6.31,6.38,2,1.0,6.38,0.075,0.071844,TAKER
03/03/2023 00:00:00,17/06/2023 17:17:16,Upscale-Upscale-DUMMY_Gemini_BTCUSD_1h_01_07_22_to_16_06_23.csv,BTC_USD,WEEK,340.99,0.004,21/04/2023 00:00:00,21/04/2023 00:00:00,10/03/2023 00:00:00,STOP_LOSS_HIT,SHORT,20290.0,21899.78,18680.22,21899.78,0.238,8.62,7.35,6.38,2,1.0,-6.5,0.075,0.06087,TAKER
24/02/2023 00:00:00,17/06/2023 17:17:16,Upscale-Upscale-DUMMY_Gemini_BTCUSD_1h_01_07_22_to_16_06_23.csv,BTC_USD,WEEK,334.49,0.003,21/04/2023 00:00:00,14/04/2023 00:00:00,03/03/2023 00:00:00,TAKE_PROFIT_HIT,SHORT,23468.0,20996.18,20996.18,25939.82,0.21,11.77,9.53,7.36,2,1.0,7.36,0.075,0.052802999999999996,TAKER
17/02/2023 00:00:00,17/06/2023 17:17:16,Upscale-Upscale-DUMMY_Gemini_BTCUSD_1h_01_07_22_to_16_06_23.csv,BTC_USD,WEEK,341.85,0.004,31/03/2023 00:00:00,07/04/2023 00:00:00,03/03/2023 00:00:00,TAKE_PROFIT_HIT,SHORT,23948.0,22334.58,22334.58,25561.42,0.28,7.22,6.31,6.38,2,1.0,6.38,0.075,0.071844,TAKER
24/02/2023 00:00:00,17/06/2023 17:17:16,Upscale-Upscale-DUMMY_Gemini_BTCUSD_1h_01_07_22_to_16_06_23.csv,BTC_USD,WEEK,348.23,0.003,21/04/2023 00:00:00,14/04/2023 00:00:00,03/03/2023 00:00:00,TAKE_PROFIT_HIT,SHORT,23468.0,20996.18,20996.18,25939.82,0.202,11.77,9.53,7.36,2,1.0,7.36,0.075,0.052802999999999996,TAKER
03/03/2023 00:00:00,17/06/2023 17:17:16,Upscale-Upscale-DUMMY_Gemini_BTCUSD_1h_01_07_22_to_16_06_23.csv,BTC_USD,WEEK,355.59,0.004,21/04/2023 00:00:00,21/04/2023 00:00:00,10/03/2023 00:00:00,STOP_LOSS_HIT,SHORT,20290.0,21899.78,18680.22,21899.78,0.228,8.62,7.35,6.38,2,1.0,-6.5,0.075,0.06087,TAKER
24/02/2023 00:00:00,17/06/2023 17:17:16,Upscale-Upscale-DUMMY_Gemini_BTCUSD_1h_01_07_22_to_16_06_23.csv,BTC_USD,WEEK,349.09,0.003,21/04/2023 00:00:00,14/04/2023 00:00:00,03/03/2023 00:00:00,TAKE_PROFIT_HIT,SHORT,23468.0,20996.18,20996.18,25939.82,0.202,11.77,9.53,7.36,2,1.0,7.36,0.075,0.052802999999999996,TAKER
24/03/2023 00:00:00,17/06/2023 17:17:16,Upscale-Upscale-DUMMY_Gemini_BTCUSD_1h_01_07_22_to_16_06_23.csv,BTC_USD,WEEK,356.45,0.001,19/05/2023 00:00:00,12/05/2023 00:00:00,12/05/2023 00:00:00,EXPIRED,LONG,27941.0,26831.0,39981.24,15900.77,0.078,30.11,75.72,12.02,3,1.0,-1.13,0.075,0.02095575,TAKER
24/03/2023 00:00:00,17/06/2023 17:17:16,Upscale-Upscale-DUMMY_Gemini_BTCUSD_1h_01_07_22_to_16_06_23.csv,BTC_USD,WEEK,355.32,0.001,19/05/2023 00:00:00,12/05/2023 00:00:00,12/05/2023 00:00:00,EXPIRED,LONG,27941.0,26831.0,39981.24,15900.77,0.079,30.11,75.72,12.02,3,1.0,-1.13,0.075,0.02095575,TAKER
24/02/2023 00:00:00,17/06/2023 17:17:16,Upscale-Upscale-DUMMY_Gemini_BTCUSD_1h_01_07_22_to_16_06_23.csv,BTC_USD,WEEK,354.19,0.003,21/04/2023 00:00:00,14/04/2023 00:00:00,03/03/2023 00:00:00,TAKE_PROFIT_HIT,SHORT,23468.0,20996.18,20996.18,25939.82,0.199,11.77,9.53,7.36,2,1.0,7.36,0.075,0.052802999999999996,TAKER
20/01/2023 00:00:00,17/06/2023 17:17:16,Upscale-Upscale-DUMMY_Gemini_BTCUSD_1h_01_07_22_to_16_06_23.csv,BTC_USD,WEEK,361.55,0.002,17/03/2023 00:00:00,10/03/2023 00:00:00,10/03/2023 00:00:00,EXPIRED,LONG,23013.0,25052.0,27602.55,18423.45,0.127,16.63,24.91,9.14,3,1.0,4.04,0.075,0.0345195,TAKER
17/02/2023 00:00:00,17/06/2023 17:17:16,Upscale-Upscale-DUMMY_Gemini_BTCUSD_1h_01_07_22_to_16_06_23.csv,BTC_USD,WEEK,365.59,0.005,31/03/2023 00:00:00,07/04/2023 00:00:00,03/03/2023 00:00:00,TAKE_PROFIT_HIT,SHORT,23948.0,22334.58,22334.58,25561.42,0.328,7.22,6.31,7.98,2,1.0,7.98,0.075,0.08980500000000001,TAKER
24/03/2023 00:00:00,17/06/2023 17:17:16,Upscale-Upscale-DUMMY_Gemini_BTCUSD_1h_01_07_22_to_16_06_23.csv,BTC_USD,WEEK,373.57,0.001,19/05/2023 00:00:00,12/05/2023 00:00:00,12/05/2023 00:00:00,EXPIRED,LONG,27941.0,26831.0,39981.24,15900.77,0.075,30.11,75.72,12.02,3,1.0,-1.13,0.075,0.02095575,TAKER
03/03/2023 00:00:00,17/06/2023 17:17:16,Upscale-Upscale-DUMMY_Gemini_BTCUSD_1h_01_07_22_to_16_06_23.csv,BTC_USD,WEEK,372.44,0.005,21/04/2023 00:00:00,21/04/2023 00:00:00,10/03/2023 00:00:00,STOP_LOSS_HIT,SHORT,20290.0,21899.78,18680.22,21899.78,0.272,8.62,7.35,7.97,2,1.0,-8.12,0.075,0.0760875,TAKER
17/02/2023 00:00:00,17/06/2023 17:17:16,Upscale-Upscale-DUMMY_Gemini_BTCUSD_1h_01_07_22_to_16_06_23.csv,BTC_USD,WEEK,364.32,0.005,31/03/2023 00:00:00,07/04/2023 00:00:00,03/03/2023 00:00:00,TAKE_PROFIT_HIT,SHORT,23948.0,22334.58,22334.58,25561.42,0.329,7.22,6.31,7.98,2,1.0,7.98,0.075,0.08980500000000001,TAKER
03/03/2023 00:00:00,17/06/2023 17:17:16,Upscale-Upscale-DUMMY_Gemini_BTCUSD_1h_01_07_22_to_16_06_23.csv,BTC_USD,WEEK,372.3,0.005,21/04/2023 00:00:00,21/04/2023 00:00:00,10/03/2023 00:00:00,STOP_LOSS_HIT,SHORT,20290.0,21899.78,18680.22,21899.78,0.272,8.62,7.35,7.97,2,1.0,-8.12,0.075,0.0760875,TAKER
24/02/2023 00:00:00,17/06/2023 17:17:16,Upscale-Upscale-DUMMY_Gemini_BTCUSD_1h_01_07_22_to_16_06_23.csv,BTC_USD,WEEK,364.18,0.003,21/04/2023 00:00:00,14/04/2023 00:00:00,03/03/2023 00:00:00,TAKE_PROFIT_HIT,SHORT,23468.0,20996.18,20996.18,25939.82,0.193,11.77,9.53,7.36,2,1.0,7.36,0.075,0.052802999999999996,TAKER
24/02/2023 00:00:00,17/06/2023 17:17:16,Upscale-Upscale-DUMMY_Gemini_BTCUSD_1h_01_07_22_to_16_06_23.csv,BTC_USD,WEEK,371.54,0.003,21/04/2023 00:00:00,14/04/2023 00:00:00,03/03/2023 00:00:00,TAKE_PROFIT_HIT,SHORT,23468.0,20996.18,20996.18,25939.82,0.189,11.77,9.53,7.36,2,1.0,7.36,0.075,0.052802999999999996,TAKER
24/02/2023 00:00:00,17/06/2023 17:17:16,Upscale-Upscale-DUMMY_Gemini_BTCUSD_1h_01_07_22_to_16_06_23.csv,BTC_USD,WEEK,378.9,0.003,21/04/2023 00:00:00,14/04/2023 00:00:00,03/03/2023 00:00:00,TAKE_PROFIT_HIT,SHORT,23468.0,20996.18,20996.18,25939.82,0.186,11.77,9.53,7.36,2,1.0,7.36,0.075,0.052802999999999996,TAKER
03/03/2023 00:00:00,17/06/2023 17:17:16,Upscale-Upscale-DUMMY_Gemini_BTCUSD_1h_01_07_22_to_16_06_23.csv,BTC_USD,WEEK,386.26,0.005,21/04/2023 00:00:00,21/04/2023 00:00:00,10/03/2023 00:00:00,STOP_LOSS_HIT,SHORT,20290.0,21899.78,18680.22,21899.78,0.263,8.62,7.35,7.97,2,1.0,-8.12,0.075,0.0760875,TAKER
24/03/2023 00:00:00,17/06/2023 17:17:16,Upscale-Upscale-DUMMY_Gemini_BTCUSD_1h_01_07_22_to_16_06_23.csv,BTC_USD,WEEK,378.14,0.001,19/05/2023 00:00:00,12/05/2023 00:00:00,12/05/2023 00:00:00,EXPIRED,LONG,27941.0,26831.0,39981.24,15900.77,0.074,30.11,75.72,12.02,3,1.0,-1.13,0.075,0.02095575,TAKER
24/02/2023 00:00:00,17/06/2023 17:17:16,Upscale-Upscale-DUMMY_Gemini_BTCUSD_1h_01_07_22_to_16_06_23.csv,BTC_USD,WEEK,377.01,0.003,21/04/2023 00:00:00,14/04/2023 00:00:00,03/03/2023 00:00:00,TAKE_PROFIT_HIT,SHORT,23468.0,20996.18,20996.18,25939.82,0.187,11.77,9.53,7.36,2,1.0,7.36,0.075,0.052802999999999996,TAKER
27/01/2023 00:00:00,17/06/2023 17:17:16,Upscale-Upscale-DUMMY_Gemini_BTCUSD_1h_01_07_22_to_16_06_23.csv,BTC_USD,WEEK,384.37,0.001,24/03/2023 00:00:00,17/03/2023 00:00:00,17/03/2023 00:00:00,EXPIRED,LONG,23487.0,28351.0,34225.92,12748.09,0.061,31.38,84.24,10.72,3,1.0,4.85,0.075,0.01761525,TAKER
27/01/2023 00:00:00,17/06/2023 17:17:16,Upscale-Upscale-DUMMY_Gemini_BTCUSD_1h_01_07_22_to_16_06_23.csv,BTC_USD,WEEK,389.22,0.001,24/03/2023 00:00:00,17/03/2023 00:00:00,17/03/2023 00:00:00,EXPIRED,LONG,23487.0,28351.0,34225.92,12748.09,0.06,31.38,84.24,10.72,3,1.0,4.85,0.075,0.01761525,TAKER
20/01/2023 00:00:00,17/06/2023 17:17:16,Upscale-Upscale-DUMMY_Gemini_BTCUSD_1h_01_07_22_to_16_06_23.csv,BTC_USD,WEEK,394.07,0.002,17/03/2023 00:00:00,10/03/2023 00:00:00,10/03/2023 00:00:00,EXPIRED,LONG,23013.0,25052.0,27602.55,18423.45,0.117,16.63,24.91,9.14,2,1.0,4.04,0.075,0.0345195,TAKER
03/03/2023 00:00:00,17/06/2023 17:17:16,Upscale-Upscale-DUMMY_Gemini_BTCUSD_1h_01_07_22_to_16_06_23.csv,BTC_USD,WEEK,398.11,0.005,21/04/2023 00:00:00,21/04/2023 00:00:00,10/03/2023 00:00:00,STOP_LOSS_HIT,SHORT,20290.0,21899.78,18680.22,21899.78,0.255,8.62,7.35,7.97,2,1.0,-8.12,0.075,0.0760875,TAKER
17/02/2023 00:00:00,17/06/2023 17:17:16,Upscale-Upscale-DUMMY_Gemini_BTCUSD_1h_01_07_22_to_16_06_23.csv,BTC_USD,WEEK,389.99,0.005,31/03/2023 00:00:00,07/04/2023 00:00:00,03/03/2023 00:00:00,TAKE_PROFIT_HIT,SHORT,23948.0,22334.58,22334.58,25561.42,0.307,7.22,6.31,7.98,2,1.0,7.98,0.075,0.08980500000000001,TAKER
03/03/2023 00:00:00,17/06/2023 17:17:16,Upscale-Upscale-DUMMY_Gemini_BTCUSD_1h_01_07_22_to_16_06_23.csv,BTC_USD,WEEK,397.97,0.005,21/04/2023 00:00:00,21/04/2023 00:00:00,10/03/2023 00:00:00,STOP_LOSS_HIT,SHORT,20290.0,21899.78,18680.22,21899.78,0.255,8.62,7.35,7.97,2,1.0,-8.12,0.075,0.0760875,TAKER
17/02/2023 00:00:00,17/06/2023 17:17:16,Upscale-Upscale-DUMMY_Gemini_BTCUSD_1h_01_07_22_to_16_06_23.csv,BTC_USD,WEEK,389.85,0.005,31/03/2023 00:00:00,07/04/2023 00:00:00,03/03/2023 00:00:00,TAKE_PROFIT_HIT,SHORT,23948.0,22334.58,22334.58,25561.42,0.307,7.22,6.31,7.98,2,1.0,7.98,0.075,0.08980500000000001,TAKER
20/01/2023 00:00:00,17/06/2023 17:17:16,Upscale-Upscale-DUMMY_Gemini_BTCUSD_1h_01_07_22_to_16_06_23.csv,BTC_USD,WEEK,397.83,0.002,17/03/2023 00:00:00,10/03/2023 00:00:00,10/03/2023 00:00:00,EXPIRED,LONG,23013.0,25052.0,27602.55,18423.45,0.116,16.63,24.91,9.14,2,1.0,4.04,0.075,0.0345195,TAKER
24/02/2023 00:00:00,17/06/2023 17:17:16,Upscale-Upscale-DUMMY_Gemini_BTCUSD_1h_01_07_22_to_16_06_23.csv,BTC_USD,WEEK,401.87,0.003,21/04/2023 00:00:00,14/04/2023 00:00:00,03/03/2023 00:00:00,TAKE_PROFIT_HIT,SHORT,23468.0,20996.18,20996.18,25939.82,0.175,11.77,9.53,7.36,2,1.0,7.36,0.075,0.052802999999999996,TAKER
03/03/2023 00:00:00,17/06/2023 17:17:16,Upscale-Upscale-DUMMY_Gemini_BTCUSD_1h_01_07_22_to_16_06_23.csv,BTC_USD,WEEK,409.23,0.005,21/04/2023 00:00:00,21/04/2023 00:00:00,10/03/2023 00:00:00,STOP_LOSS_HIT,SHORT,20290.0,21899.78,18680.22,21899.78,0.248,8.62,7.35,7.97,2,1.0,-8.12,0.075,0.0760875,TAKER
20/01/2023 00:00:00,17/06/2023 17:17:16,Upscale-Upscale-DUMMY_Gemini_BTCUSD_1h_01_07_22_to_16_06_23.csv,BTC_USD,WEEK,401.11,0.002,17/03/2023 00:00:00,10/03/2023 00:00:00,10/03/2023 00:00:00,EXPIRED,LONG,23013.0,25052.0,27602.55,18423.45,0.115,16.63,24.91,9.14,2,1.0,4.04,0.075,0.0345195,TAKER
17/02/2023 00:00:00,17/06/2023 17:17:16,Upscale-Upscale-DUMMY_Gemini_BTCUSD_1h_01_07_22_to_16_06_23.csv,BTC_USD,WEEK,405.15,0.005,31/03/2023 00:00:00,07/04/2023 00:00:00,03/03/2023 00:00:00,TAKE_PROFIT_HIT,SHORT,23948.0,22334.58,22334.58,25561.42,0.296,7.22,6.31,7.98,2,1.0,7.98,0.075,0.08980500000000001,TAKER
03/03/2023 00:00:00,17/06/2023 17:17:16,Upscale-Upscale-DUMMY_Gemini_BTCUSD_1h_01_07_22_to_16_06_23.csv,BTC_USD,WEEK,413.13,0.005,21/04/2023 00:00:00,21/04/2023 00:00:00,10/03/2023 00:00:00,STOP_LOSS_HIT,SHORT,20290.0,21899.78,18680.22,21899.78,0.246,8.62,7.35,7.97,2,1.0,-8.12,0.075,0.0760875,TAKER
24/02/2023 00:00:00,17/06/2023 17:17:16,Upscale-Upscale-DUMMY_Gemini_BTCUSD_1h_01_07_22_to_16_06_23.csv,BTC_USD,WEEK,405.01,0.003,21/04/2023 00:00:00,14/04/2023 00:00:00,03/03/2023 00:00:00,TAKE_PROFIT_HIT,SHORT,23468.0,20996.18,20996.18,25939.82,0.174,11.77,9.53,7.36,2,1.0,7.36,0.075,0.052802999999999996,TAKER
24/02/2023 00:00:00,17/06/2023 17:17:16,Upscale-Upscale-DUMMY_Gemini_BTCUSD_1h_01_07_22_to_16_06_23.csv,BTC_USD,WEEK,412.37,0.003,21/04/2023 00:00:00,14/04/2023 00:00:00,03/03/2023 00:00:00,TAKE_PROFIT_HIT,SHORT,23468.0,20996.18,20996.18,25939.82,0.171,11.77,9.53,7.36,2,1.0,7.36,0.075,0.052802999999999996,TAKER
03/03/2023 00:00:00,17/06/2023 17:17:16,Upscale-Upscale-DUMMY_Gemini_BTCUSD_1h_01_07_22_to_16_06_23.csv,BTC_USD,WEEK,419.73,0.005,21/04/2023 00:00:00,21/04/2023 00:00:00,10/03/2023 00:00:00,STOP_LOSS_HIT,SHORT,20290.0,21899.78,18680.22,21899.78,0.242,8.62,7.35,7.97,2,1.0,-8.12,0.075,0.0760875,TAKER
24/03/2023 00:00:00,17/06/2023 17:17:16,Upscale-Upscale-DUMMY_Gemini_BTCUSD_1h_01_07_22_to_16_06_23.csv,BTC_USD,WEEK,411.61,0.001,19/05/2023 00:00:00,12/05/2023 00:00:00,12/05/2023 00:00:00,EXPIRED,LONG,27941.0,26831.0,39981.24,15900.77,0.068,30.11,75.72,12.02,3,1.0,-1.13,0.075,0.02095575,TAKER
27/01/2023 00:00:00,17/06/2023 17:17:16,Upscale-Upscale-DUMMY_Gemini_BTCUSD_1h_01_07_22_to_16_06_23.csv,BTC_USD,WEEK,410.48,0.001,24/03/2023 00:00:00,17/03/2023 00:00:00,17/03/2023 00:00:00,EXPIRED,LONG,23487.0,28351.0,34225.92,12748.09,0.057,31.38,84.24,10.72,3,1.0,4.85,0.075,0.01761525,TAKER
24/03/2023 00:00:00,17/06/2023 17:17:16,Upscale-Upscale-DUMMY_Gemini_BTCUSD_1h_01_07_22_to_16_06_23.csv,BTC_USD,WEEK,415.33,0.001,19/05/2023 00:00:00,12/05/2023 00:00:00,12/05/2023 00:00:00,EXPIRED,LONG,27941.0,26831.0,39981.24,15900.77,0.067,30.11,75.72,12.02,3,1.0,-1.13,0.075,0.02095575,TAKER
20/01/2023 00:00:00,17/06/2023 17:17:16,Upscale-Upscale-DUMMY_Gemini_BTCUSD_1h_01_07_22_to_16_06_23.csv,BTC_USD,WEEK,414.2,0.002,17/03/2023 00:00:00,10/03/2023 00:00:00,10/03/2023 00:00:00,EXPIRED,LONG,23013.0,25052.0,27602.55,18423.45,0.111,16.63,24.91,9.14,2,1.0,4.04,0.075,0.0345195,TAKER
24/03/2023 00:00:00,17/06/2023 17:17:16,Upscale-Upscale-DUMMY_Gemini_BTCUSD_1h_01_07_22_to_16_06_23.csv,BTC_USD,WEEK,418.24,0.001,19/05/2023 00:00:00,12/05/2023 00:00:00,12/05/2023 00:00:00,EXPIRED,LONG,27941.0,26831.0,39981.24,15900.77,0.067,30.11,75.72,12.02,3,1.0,-1.13,0.075,0.02095575,TAKER
24/02/2023 00:00:00,17/06/2023 17:17:16,Upscale-Upscale-DUMMY_Gemini_BTCUSD_1h_01_07_22_to_16_06_23.csv,BTC_USD,WEEK,417.11,0.003,21/04/2023 00:00:00,14/04/2023 00:00:00,03/03/2023 00:00:00,TAKE_PROFIT_HIT,SHORT,23468.0,20996.18,20996.18,25939.82,0.169,11.77,9.53,7.36,2,1.0,7.36,0.075,0.052802999999999996,TAKER
27/01/2023 00:00:00,17/06/2023 17:17:16,Upscale-Upscale-DUMMY_Gemini_BTCUSD_1h_01_07_22_to_16_06_23.csv,BTC_USD,WEEK,424.47,0.001,24/03/2023 00:00:00,17/03/2023 00:00:00,17/03/2023 00:00:00,EXPIRED,LONG,23487.0,28351.0,34225.92,12748.09,0.055,31.38,84.24,10.72,3,1.0,4.85,0.075,0.01761525,TAKER
17/02/2023 00:00:00,17/06/2023 17:17:16,Upscale-Upscale-DUMMY_Gemini_BTCUSD_1h_01_07_22_to_16_06_23.csv,BTC_USD,WEEK,429.32,0.005,31/03/2023 00:00:00,07/04/2023 00:00:00,03/03/2023 00:00:00,TAKE_PROFIT_HIT,SHORT,23948.0,22334.58,22334.58,25561.42,0.279,7.22,6.31,7.98,2,1.0,7.98,0.075,0.08980500000000001,TAKER
24/02/2023 00:00:00,17/06/2023 17:17:16,Upscale-Upscale-DUMMY_Gemini_BTCUSD_1h_01_07_22_to_16_06_23.csv,BTC_USD,WEEK,437.3,0.004,21/04/2023 00:00:00,14/04/2023 00:00:00,03/03/2023 00:00:00,TAKE_PROFIT_HIT,SHORT,23468.0,20996.18,20996.18,25939.82,0.215,11.77,9.53,9.82,2,1.0,9.82,0.075,0.070404,TAKER
24/02/2023 00:00:00,17/06/2023 17:17:16,Upscale-Upscale-DUMMY_Gemini_BTCUSD_1h_01_07_22_to_16_06_23.csv,BTC_USD,WEEK,447.12,0.004,21/04/2023 00:00:00,14/04/2023 00:00:00,03/03/2023 00:00:00,TAKE_PROFIT_HIT,SHORT,23468.0,20996.18,20996.18,25939.82,0.21,11.77,9.53,9.82,2,1.0,9.82,0.075,0.070404,TAKER
24/02/2023 00:00:00,17/06/2023 17:17:16,Upscale-Upscale-DUMMY_Gemini_BTCUSD_1h_01_07_22_to_16_06_23.csv,BTC_USD,WEEK,456.94,0.004,21/04/2023 00:00:00,14/04/2023 00:00:00,03/03/2023 00:00:00,TAKE_PROFIT_HIT,SHORT,23468.0,20996.18,20996.18,25939.82,0.205,11.77,9.53,9.82,2,1.0,9.82,0.075,0.070404,TAKER
24/02/2023 00:00:00,17/06/2023 17:17:16,Upscale-Upscale-DUMMY_Gemini_BTCUSD_1h_01_07_22_to_16_06_23.csv,BTC_USD,WEEK,466.76,0.004,21/04/2023 00:00:00,14/04/2023 00:00:00,03/03/2023 00:00:00,TAKE_PROFIT_HIT,SHORT,23468.0,20996.18,20996.18,25939.82,0.201,11.77,9.53,9.82,2,1.0,9.82,0.075,0.070404,TAKER
24/02/2023 00:00:00,17/06/2023 17:17:16,Upscale-Upscale-DUMMY_Gemini_BTCUSD_1h_01_07_22_to_16_06_23.csv,BTC_USD,WEEK,476.58,0.004,21/04/2023 00:00:00,14/04/2023 00:00:00,03/03/2023 00:00:00,TAKE_PROFIT_HIT,SHORT,23468.0,20996.18,20996.18,25939.82,0.197,11.77,9.53,9.82,2,1.0,9.82,0.075,0.070404,TAKER
24/02/2023 00:00:00,17/06/2023 17:17:16,Upscale-Upscale-DUMMY_Gemini_BTCUSD_1h_01_07_22_to_16_06_23.csv,BTC_USD,WEEK,486.4,0.004,21/04/2023 00:00:00,14/04/2023 00:00:00,03/03/2023 00:00:00,TAKE_PROFIT_HIT,SHORT,23468.0,20996.18,20996.18,25939.82,0.193,11.77,9.53,9.82,2,1.0,9.82,0.075,0.070404,TAKER
27/01/2023 00:00:00,17/06/2023 17:17:16,Upscale-Upscale-DUMMY_Gemini_BTCUSD_1h_01_07_22_to_16_06_23.csv,BTC_USD,WEEK,496.22,0.001,24/03/2023 00:00:00,17/03/2023 00:00:00,17/03/2023 00:00:00,EXPIRED,LONG,23487.0,28351.0,34225.92,12748.09,0.047,31.38,84.24,10.72,2,1.0,4.85,0.075,0.01761525,TAKER
24/03/2023 00:00:00,17/06/2023 17:17:16,Upscale-Upscale-DUMMY_Gemini_BTCUSD_1h_01_07_22_to_16_06_23.csv,BTC_USD,WEEK,501.07,0.001,19/05/2023 00:00:00,12/05/2023 00:00:00,12/05/2023 00:00:00,EXPIRED,LONG,27941.0,26831.0,39981.24,15900.77,0.056,30.11,75.72,12.02,2,1.0,-1.13,0.075,0.02095575,TAKER
17/02/2023 00:00:00,17/06/2023 17:17:16,Upscale-Upscale-DUMMY_Gemini_BTCUSD_1h_01_07_22_to_16_06_23.csv,BTC_USD,WEEK,499.94,0.006,31/03/2023 00:00:00,07/04/2023 00:00:00,03/03/2023 00:00:00,TAKE_PROFIT_HIT,SHORT,23948.0,22334.58,22334.58,25561.42,0.287,7.22,6.31,9.57,2,1.0,9.57,0.075,0.107766,TAKER
20/01/2023 00:00:00,17/06/2023 17:17:16,Upscale-Upscale-DUMMY_Gemini_BTCUSD_1h_01_07_22_to_16_06_23.csv,BTC_USD,WEEK,509.51,0.002,17/03/2023 00:00:00,10/03/2023 00:00:00,10/03/2023 00:00:00,EXPIRED,LONG,23013.0,25052.0,27602.55,18423.45,0.09,16.63,24.91,9.14,2,1.0,4.04,0.075,0.0345195,TAKER
20/01/2023 00:00:00,17/06/2023 17:17:16,Upscale-Upscale-DUMMY_Gemini_BTCUSD_1h_01_07_22_to_16_06_23.csv,BTC_USD,WEEK,513.55,0.002,17/03/2023 00:00:00,10/03/2023 00:00:00,10/03/2023 00:00:00,EXPIRED,LONG,23013.0,25052.0,27602.55,18423.45,0.09,16.63,24.91,9.14,2,1.0,4.04,0.075,0.0345195,TAKER
03/03/2023 00:00:00,17/06/2023 17:17:16,Upscale-Upscale-DUMMY_Gemini_BTCUSD_1h_01_07_22_to_16_06_23.csv,BTC_USD,WEEK,517.59,0.006,21/04/2023 00:00:00,21/04/2023 00:00:00,10/03/2023 00:00:00,STOP_LOSS_HIT,SHORT,20290.0,21899.78,18680.22,21899.78,0.235,8.62,7.35,9.57,2,1.0,-9.75,0.075,0.091305,TAKER
17/02/2023 00:00:00,17/06/2023 17:17:16,Upscale-Upscale-DUMMY_Gemini_BTCUSD_1h_01_07_22_to_16_06_23.csv,BTC_USD,WEEK,507.84,0.006,31/03/2023 00:00:00,07/04/2023 00:00:00,03/03/2023 00:00:00,TAKE_PROFIT_HIT,SHORT,23948.0,22334.58,22334.58,25561.42,0.283,7.22,6.31,9.57,2,1.0,9.57,0.075,0.107766,TAKER
27/01/2023 00:00:00,17/06/2023 17:17:16,Upscale-Upscale-DUMMY_Gemini_BTCUSD_1h_01_07_22_to_16_06_23.csv,BTC_USD,WEEK,517.41,0.001,24/03/2023 00:00:00,17/03/2023 00:00:00,17/03/2023 00:00:00,EXPIRED,LONG,23487.0,28351.0,34225.92,12748.09,0.045,31.38,84.24,10.72,2,1.0,4.85,0.075,0.01761525,TAKER
27/01/2023 00:00:00,17/06/2023 17:17:16,Upscale-Upscale-DUMMY_Gemini_BTCUSD_1h_01_07_22_to_16_06_23.csv,BTC_USD,WEEK,522.26,0.001,24/03/2023 00:00:00,17/03/2023 00:00:00,17/03/2023 00:00:00,EXPIRED,LONG,23487.0,28351.0,34225.92,12748.09,0.045,31.38,84.24,10.72,2,1.0,4.85,0.075,0.01761525,TAKER
24/02/2023 00:00:00,17/06/2023 17:17:16,Upscale-Upscale-DUMMY_Gemini_BTCUSD_1h_01_07_22_to_16_06_23.csv,BTC_USD,WEEK,527.11,0.004,21/04/2023 00:00:00,14/04/2023 00:00:00,03/03/2023 00:00:00,TAKE_PROFIT_HIT,SHORT,23468.0,20996.18,20996.18,25939.82,0.178,11.77,9.53,9.82,2,1.0,9.82,0.075,0.070404,TAKER
20/01/2023 00:00:00,17/06/2023 17:17:16,Upscale-Upscale-DUMMY_Gemini_BTCUSD_1h_01_07_22_to_16_06_23.csv,BTC_USD,WEEK,536.93,0.002,17/03/2023 00:00:00,10/03/2023 00:00:00,10/03/2023 00:00:00,EXPIRED,LONG,23013.0,25052.0,27602.55,18423.45,0.086,16.63,24.91,9.14,2,1.0,4.04,0.075,0.0345195,TAKER
27/01/2023 00:00:00,17/06/2023 17:17:16,Upscale-Upscale-DUMMY_Gemini_BTCUSD_1h_01_07_22_to_16_06_23.csv,BTC_USD,WEEK,540.97,0.001,24/03/2023 00:00:00,17/03/2023 00:00:00,17/03/2023 00:00:00,EXPIRED,LONG,23487.0,28351.0,34225.92,12748.09,0.043,31.38,84.24,10.72,2,1.0,4.85,0.075,0.01761525,TAKER
20/01/2023 00:00:00,17/06/2023 17:17:16,Upscale-Upscale-DUMMY_Gemini_BTCUSD_1h_01_07_22_to_16_06_23.csv,BTC_USD,WEEK,545.82,0.002,17/03/2023 00:00:00,10/03/2023 00:00:00,10/03/2023 00:00:00,EXPIRED,LONG,23013.0,25052.0,27602.55,18423.45,0.084,16.63,24.91,9.14,2,1.0,4.04,0.075,0.0345195,TAKER
27/01/2023 00:00:00,17/06/2023 17:17:16,Upscale-Upscale-DUMMY_Gemini_BTCUSD_1h_01_07_22_to_16_06_23.csv,BTC_USD,WEEK,549.86,0.001,24/03/2023 00:00:00,17/03/2023 00:00:00,17/03/2023 00:00:00,EXPIRED,LONG,23487.0,28351.0,34225.92,12748.09,0.043,31.38,84.24,10.72,2,1.0,4.85,0.075,0.01761525,TAKER
17/02/2023 00:00:00,17/06/2023 17:17:16,Upscale-Upscale-DUMMY_Gemini_BTCUSD_1h_01_07_22_to_16_06_23.csv,BTC_USD,WEEK,554.71,0.007,31/03/2023 00:00:00,07/04/2023 00:00:00,03/03/2023 00:00:00,TAKE_PROFIT_HIT,SHORT,23948.0,22334.58,22334.58,25561.42,0.302,7.22,6.31,11.17,2,1.0,11.17,0.075,0.125727,TAKER
24/03/2023 00:00:00,17/06/2023 17:17:16,Upscale-Upscale-DUMMY_Gemini_BTCUSD_1h_01_07_22_to_16_06_23.csv,BTC_USD,WEEK,565.88,0.001,19/05/2023 00:00:00,12/05/2023 00:00:00,12/05/2023 00:00:00,EXPIRED,LONG,27941.0,26831.0,39981.24,15900.77,0.049,30.11,75.72,12.02,2,1.0,-1.13,0.075,0.02095575,TAKER
24/03/2023 00:00:00,17/06/2023 17:17:16,Upscale-Upscale-DUMMY_Gemini_BTCUSD_1h_01_07_22_to_16_06_23.csv,BTC_USD,WEEK,564.75,0.001,19/05/2023 00:00:00,12/05/2023 00:00:00,12/05/2023 00:00:00,EXPIRED,LONG,27941.0,26831.0,39981.24,15900.77,0.049,30.11,75.72,12.02,2,1.0,-1.13,0.075,0.02095575,TAKER
24/02/2023 00:00:00,17/06/2023 17:17:16,Upscale-Upscale-DUMMY_Gemini_BTCUSD_1h_01_07_22_to_16_06_23.csv,BTC_USD,WEEK,563.62,0.005,21/04/2023 00:00:00,14/04/2023 00:00:00,03/03/2023 00:00:00,TAKE_PROFIT_HIT,SHORT,23468.0,20996.18,20996.18,25939.82,0.208,11.77,9.53,12.27,2,1.0,12.27,0.075,0.088005,TAKER
24/02/2023 00:00:00,17/06/2023 17:17:16,Upscale-Upscale-DUMMY_Gemini_BTCUSD_1h_01_07_22_to_16_06_23.csv,BTC_USD,WEEK,575.89,0.005,21/04/2023 00:00:00,14/04/2023 00:00:00,03/03/2023 00:00:00,TAKE_PROFIT_HIT,SHORT,23468.0,20996.18,20996.18,25939.82,0.204,11.77,9.53,12.27,2,1.0,12.27,0.075,0.088005,TAKER
24/03/2023 00:00:00,17/06/2023 17:17:16,Upscale-Upscale-DUMMY_Gemini_BTCUSD_1h_01_07_22_to_16_06_23.csv,BTC_USD,WEEK,588.16,0.001,19/05/2023 00:00:00,12/05/2023 00:00:00,12/05/2023 00:00:00,EXPIRED,LONG,27941.0,26831.0,39981.24,15900.77,0.048,30.11,75.72,12.02,2,1.0,-1.13,0.075,0.02095575,TAKER
20/01/2023 00:00:00,17/06/2023 17:17:16,Upscale-Upscale-DUMMY_Gemini_BTCUSD_1h_01_07_22_to_16_06_23.csv,BTC_USD,WEEK,587.03,0.003,17/03/2023 00:00:00,10/03/2023 00:00:00,10/03/2023 00:00:00,EXPIRED,LONG,23013.0,25052.0,27602.55,18423.45,0.118,16.63,24.91,13.72,2,1.0,6.07,0.075,0.05177925,TAKER
24/02/2023 00:00:00,17/06/2023 17:17:16,Upscale-Upscale-DUMMY_Gemini_BTCUSD_1h_01_07_22_to_16_06_23.csv,BTC_USD,WEEK,593.1,0.005,21/04/2023 00:00:00,14/04/2023 00:00:00,03/03/2023 00:00:00,TAKE_PROFIT_HIT,SHORT,23468.0,20996.18,20996.18,25939.82,0.198,11.77,9.53,12.27,2,1.0,12.27,0.075,0.088005,TAKER
