Open,Last update,Platform,Symbol,Timeframe,Account balance at open,Size,Expected close,Expiry,Close,Status,Side,Opening price,Closing price,Take profit,Stop loss,Leverage,TP price %,SL price %,Expected profit,Risk %,R/R ratio,PnL
28/06/2019 18:00:00,15/06/2023 18:58:11,Gemini_BTCUSD_1h_17_12_17_to_10_03_23.csv,BTC_USD,HOUR,100000.0,34.489,28/06/2019 20:00:00,28/06/2019 21:00:00,28/06/2019 19:00:00,TAKE_PROFIT_HIT,LONG,11920.0,12093.96,12093.96,11862.01,4.111,1.44,0.49,5999.71,2,3.0,5999.71
25/07/2021 08:00:00,15/06/2023 18:58:11,Gemini_BTCUSD_1h_17_12_17_to_10_03_23.csv,BTC_USD,HOUR,105999.71,4.218,25/07/2021 09:00:00,25/07/2021 11:00:00,25/07/2021 11:00:00,EXPIRED,LONG,34601.0,34419.0,36108.98,34098.34,1.377,4.18,1.47,6360.66,2,3.0,-767.68
06/04/2018 02:00:00,15/06/2023 18:58:11,Gemini_BTCUSD_1h_17_12_17_to_10_03_23.csv,BTC_USD,HOUR,105232.03,36.685,06/04/2018 05:00:00,06/04/2018 05:00:00,06/04/2018 05:00:00,STOP_LOSS_HIT,SHORT,6779.0,6836.37,6606.9,6836.37,2.363,2.6,0.84,6313.49,2,3.0,-2104.62
08/04/2021 20:00:00,15/06/2023 18:58:11,Gemini_BTCUSD_1h_17_12_17_to_10_03_23.csv,BTC_USD,HOUR,103127.41,5.432,08/04/2021 23:00:00,08/04/2021 23:00:00,08/04/2021 23:00:00,EXPIRED,LONG,57674.0,58086.0,58813.08,57294.31,3.038,1.94,0.66,6187.48,2,3.0,2237.98
27/06/2018 12:00:00,15/06/2023 18:58:11,Gemini_BTCUSD_1h_17_12_17_to_10_03_23.csv,BTC_USD,HOUR,105365.39,17.682,27/06/2018 13:00:00,27/06/2018 15:00:00,27/06/2018 15:00:00,EXPIRED,LONG,6088.0,6102.0,6445.54,5968.82,1.022,5.55,2.0,6322.02,2,3.0,247.55
20/05/2018 01:00:00,15/06/2023 18:58:11,Gemini_BTCUSD_1h_17_12_17_to_10_03_23.csv,BTC_USD,HOUR,105612.94,35.578,20/05/2018 05:00:00,20/05/2018 04:00:00,20/05/2018 04:00:00,EXPIRED,LONG,8220.0,8250.0,8398.12,8160.63,2.769,2.12,0.73,6337.15,2,3.0,1067.34
20/08/2021 04:00:00,15/06/2023 18:58:11,Gemini_BTCUSD_1h_17_12_17_to_10_03_23.csv,BTC_USD,HOUR,106680.28,8.101,20/08/2021 05:00:00,20/08/2021 07:00:00,20/08/2021 07:00:00,STOP_LOSS_HIT,LONG,47108.0,46844.62,47898.14,46844.62,3.577,1.65,0.56,6400.92,2,3.0,-2133.64
12/11/2022 03:00:00,15/06/2023 18:58:11,Gemini_BTCUSD_1h_17_12_17_to_10_03_23.csv,BTC_USD,HOUR,104546.64,13.251,12/11/2022 05:00:00,12/11/2022 06:00:00,12/11/2022 04:00:00,STOP_LOSS_HIT,LONG,16841.0,16683.21,17314.37,16683.21,2.135,2.73,0.95,6272.63,2,3.0,-2090.88
07/12/2021 17:00:00,15/06/2023 18:58:11,Gemini_BTCUSD_1h_17_12_17_to_10_03_23.csv,BTC_USD,HOUR,102455.76,2.726,07/12/2021 19:00:00,07/12/2021 20:00:00,07/12/2021 20:00:00,STOP_LOSS_HIT,LONG,51075.0,50323.17,53330.51,50323.17,1.359,4.23,1.49,6148.52,2,3.0,-2049.49
02/10/2022 04:00:00,15/06/2023 18:58:11,Gemini_BTCUSD_1h_17_12_17_to_10_03_23.csv,BTC_USD,HOUR,100406.27,19.624,02/10/2022 05:00:00,02/10/2022 07:00:00,02/10/2022 07:00:00,EXPIRED,LONG,19332.0,19288.0,19638.99,19229.67,3.778,1.56,0.53,6024.37,2,3.0,-863.46
17/01/2021 19:00:00,15/06/2023 18:58:11,Gemini_BTCUSD_1h_17_12_17_to_10_03_23.csv,BTC_USD,HOUR,99542.81,10.429,17/01/2021 20:00:00,17/01/2021 22:00:00,17/01/2021 21:00:00,TAKE_PROFIT_HIT,LONG,35629.0,36201.7,36201.7,35438.1,3.733,1.58,0.54,5972.69,2,3.0,5972.69
15/06/2019 05:00:00,15/06/2023 18:58:11,Gemini_BTCUSD_1h_17_12_17_to_10_03_23.csv,BTC_USD,HOUR,105515.5,28.661,15/06/2019 09:00:00,15/06/2019 08:00:00,15/06/2019 08:00:00,EXPIRED,SHORT,8712.0,8697.0,8491.11,8785.63,2.366,2.6,0.84,6330.93,2,3.0,429.92
18/07/2019 08:00:00,15/06/2023 18:58:11,Gemini_BTCUSD_1h_17_12_17_to_10_03_23.csv,BTC_USD,HOUR,105945.42,33.517,18/07/2019 10:00:00,18/07/2019 11:00:00,18/07/2019 11:00:00,EXPIRED,LONG,9715.0,9773.0,9904.67,9651.78,3.073,1.91,0.66,6357.17,2,3.0,1943.99
21/05/2018 23:00:00,15/06/2023 18:58:11,Gemini_BTCUSD_1h_17_12_17_to_10_03_23.csv,BTC_USD,HOUR,107889.41,29.038,22/05/2018 01:00:00,22/05/2018 02:00:00,22/05/2018 01:00:00,STOP_LOSS_HIT,LONG,8396.0,8321.69,8618.94,8321.69,2.26,2.59,0.89,6473.73,2,3.0,-2157.81
04/10/2020 14:00:00,15/06/2023 18:58:11,Gemini_BTCUSD_1h_17_12_17_to_10_03_23.csv,BTC_USD,HOUR,105731.6,18.805,04/10/2020 15:00:00,04/10/2020 17:00:00,04/10/2020 17:00:00,EXPIRED,LONG,10612.0,10610.0,10949.36,10499.55,1.887,3.08,1.07,6344.05,2,3.0,-37.61
03/12/2019 03:00:00,15/06/2023 18:58:11,Gemini_BTCUSD_1h_17_12_17_to_10_03_23.csv,BTC_USD,HOUR,105693.99,19.649,03/12/2019 04:00:00,03/12/2019 06:00:00,03/12/2019 06:00:00,EXPIRED,LONG,7360.0,7314.0,7682.75,7252.42,1.368,4.2,1.48,6341.71,2,3.0,-903.85
13/03/2019 00:00:00,15/06/2023 18:58:11,Gemini_BTCUSD_1h_17_12_17_to_10_03_23.csv,BTC_USD,HOUR,104790.14,62.246,13/03/2019 04:00:00,13/03/2019 03:00:00,13/03/2019 03:00:00,EXPIRED,LONG,3862.0,3869.0,3963.02,3828.33,2.294,2.55,0.88,6288.09,2,3.0,435.72
11/12/2021 13:00:00,15/06/2023 18:58:11,Gemini_BTCUSD_1h_17_12_17_to_10_03_23.csv,BTC_USD,HOUR,105225.86,3.488,11/12/2021 17:00:00,11/12/2021 16:00:00,11/12/2021 16:00:00,STOP_LOSS_HIT,SHORT,48362.0,48965.42,46551.74,48965.42,1.603,3.89,1.23,6314.19,2,3.0,-2104.73
20/05/2022 06:00:00,15/06/2023 18:58:11,Gemini_BTCUSD_1h_17_12_17_to_10_03_23.csv,BTC_USD,HOUR,103121.13,12.179,20/05/2022 10:00:00,20/05/2022 09:00:00,20/05/2022 07:00:00,STOP_LOSS_HIT,SHORT,29972.0,30141.34,29464.0,30141.34,3.54,1.72,0.56,6186.93,2,3.0,-2062.39
24/11/2020 02:00:00,15/06/2023 18:58:11,Gemini_BTCUSD_1h_17_12_17_to_10_03_23.csv,BTC_USD,HOUR,101058.74,23.073,24/11/2020 06:00:00,24/11/2020 05:00:00,24/11/2020 04:00:00,STOP_LOSS_HIT,SHORT,18368.0,18455.6,18105.2,18455.6,4.194,1.45,0.47,6063.58,2,3.0,-2021.19
06/07/2022 01:00:00,15/06/2023 18:58:11,Gemini_BTCUSD_1h_17_12_17_to_10_03_23.csv,BTC_USD,HOUR,99037.55,18.832,06/07/2022 02:00:00,06/07/2022 04:00:00,06/07/2022 03:00:00,STOP_LOSS_HIT,LONG,19866.0,19760.82,20181.54,19760.82,3.778,1.56,0.53,5942.25,2,3.0,-1980.75
18/02/2021 03:00:00,15/06/2023 18:58:11,Gemini_BTCUSD_1h_17_12_17_to_10_03_23.csv,BTC_USD,HOUR,97056.8,5.493,18/02/2021 07:00:00,18/02/2021 06:00:00,18/02/2021 06:00:00,EXPIRED,SHORT,52068.0,51960.0,51007.97,52421.35,2.947,2.08,0.67,5822.74,2,3.0,593.24
02/04/2020 16:00:00,15/06/2023 18:58:11,Gemini_BTCUSD_1h_17_12_17_to_10_03_23.csv,BTC_USD,HOUR,97650.04,21.611,02/04/2020 17:00:00,02/04/2020 19:00:00,02/04/2020 17:00:00,TAKE_PROFIT_HIT,LONG,6923.0,7194.1,7194.1,6832.63,1.532,3.77,1.32,5858.74,2,3.0,5858.74
24/08/2018 08:00:00,15/06/2023 18:58:11,Gemini_BTCUSD_1h_17_12_17_to_10_03_23.csv,BTC_USD,HOUR,103508.78,22.014,24/08/2018 11:00:00,24/08/2018 11:00:00,24/08/2018 11:00:00,EXPIRED,LONG,6515.0,6526.0,6797.12,6420.96,1.386,4.15,1.46,6210.59,2,3.0,242.15
18/11/2019 11:00:00,15/06/2023 18:58:11,Gemini_BTCUSD_1h_17_12_17_to_10_03_23.csv,BTC_USD,HOUR,103750.93,12.121,18/11/2019 13:00:00,18/11/2019 14:00:00,18/11/2019 14:00:00,EXPIRED,LONG,8425.0,8427.0,8938.56,8253.81,0.984,5.75,2.07,6224.86,2,3.0,24.24
24/09/2020 08:00:00,15/06/2023 18:58:11,Gemini_BTCUSD_1h_17_12_17_to_10_03_23.csv,BTC_USD,HOUR,103775.17,41.074,24/09/2020 09:00:00,24/09/2020 11:00:00,24/09/2020 11:00:00,EXPIRED,LONG,10319.0,10412.0,10470.6,10268.47,4.084,1.45,0.49,6226.82,2,3.0,3819.88
06/09/2019 14:00:00,15/06/2023 18:58:11,Gemini_BTCUSD_1h_17_12_17_to_10_03_23.csv,BTC_USD,HOUR,107595.05,13.699,06/09/2019 15:00:00,06/09/2019 17:00:00,06/09/2019 17:00:00,STOP_LOSS_HIT,LONG,10867.0,10709.91,11338.28,10709.91,1.384,4.16,1.47,6456.06,2,3.0,-2151.98
05/06/2022 21:00:00,15/06/2023 18:58:11,Gemini_BTCUSD_1h_17_12_17_to_10_03_23.csv,BTC_USD,HOUR,105443.07,13.625,06/06/2022 01:00:00,06/06/2022 00:00:00,06/06/2022 00:00:00,STOP_LOSS_HIT,SHORT,29942.0,30096.78,29477.67,30096.78,3.869,1.58,0.51,6326.5,2,3.0,-2108.88
20/03/2019 16:00:00,15/06/2023 18:58:11,Gemini_BTCUSD_1h_17_12_17_to_10_03_23.csv,BTC_USD,HOUR,103334.19,69.422,20/03/2019 19:00:00,20/03/2019 19:00:00,20/03/2019 19:00:00,EXPIRED,LONG,4005.0,4014.0,4094.3,3975.23,2.691,2.18,0.75,6199.38,2,3.0,624.8
17/04/2019 22:00:00,15/06/2023 18:58:11,Gemini_BTCUSD_1h_17_12_17_to_10_03_23.csv,BTC_USD,HOUR,103958.99,38.461,18/04/2019 02:00:00,18/04/2019 01:00:00,18/04/2019 01:00:00,STOP_LOSS_HIT,SHORT,5223.0,5277.06,5060.81,5277.06,1.932,3.2,1.02,6237.99,2,3.0,-2079.2
27/08/2021 17:00:00,15/06/2023 18:58:11,Gemini_BTCUSD_1h_17_12_17_to_10_03_23.csv,BTC_USD,HOUR,101879.79,3.432,27/08/2021 18:00:00,27/08/2021 20:00:00,27/08/2021 20:00:00,EXPIRED,LONG,48200.0,48944.0,49981.2,47606.27,1.624,3.56,1.25,6113.08,2,3.0,2553.41
26/12/2018 19:00:00,15/06/2023 18:58:11,Gemini_BTCUSD_1h_17_12_17_to_10_03_23.csv,BTC_USD,HOUR,104433.2,28.149,26/12/2018 20:00:00,26/12/2018 22:00:00,26/12/2018 22:00:00,EXPIRED,LONG,3799.0,3810.0,4021.59,3724.8,1.024,5.53,1.99,6265.69,2,3.0,309.64
13/07/2019 00:00:00,15/06/2023 18:58:11,Gemini_BTCUSD_1h_17_12_17_to_10_03_23.csv,BTC_USD,HOUR,104742.84,26.83,13/07/2019 03:00:00,13/07/2019 03:00:00,13/07/2019 03:00:00,EXPIRED,SHORT,11768.0,11631.0,11533.75,11846.08,3.014,2.03,0.66,6284.93,2,3.0,3675.71
26/03/2020 14:00:00,15/06/2023 18:58:11,Gemini_BTCUSD_1h_17_12_17_to_10_03_23.csv,BTC_USD,HOUR,108418.55,25.811,26/03/2020 17:00:00,26/03/2020 17:00:00,26/03/2020 17:00:00,EXPIRED,LONG,6612.0,6655.0,6864.04,6527.99,1.574,3.67,1.29,6505.4,2,3.0,1109.87
31/07/2019 15:00:00,15/06/2023 18:58:11,Gemini_BTCUSD_1h_17_12_17_to_10_03_23.csv,BTC_USD,HOUR,109528.42,25.101,31/07/2019 19:00:00,31/07/2019 18:00:00,31/07/2019 16:00:00,STOP_LOSS_HIT,LONG,10058.0,9970.73,10319.82,9970.73,2.305,2.54,0.88,6571.94,2,3.0,-2190.56
27/10/2020 22:00:00,15/06/2023 18:58:11,Gemini_BTCUSD_1h_17_12_17_to_10_03_23.csv,BTC_USD,HOUR,107337.86,28.066,27/10/2020 23:00:00,28/10/2020 01:00:00,27/10/2020 23:00:00,STOP_LOSS_HIT,LONG,13752.0,13675.51,13981.48,13675.51,3.596,1.64,0.56,6440.59,2,3.0,-2146.77
06/06/2018 22:00:00,15/06/2023 18:58:11,Gemini_BTCUSD_1h_17_12_17_to_10_03_23.csv,BTC_USD,HOUR,105191.09,19.195,06/06/2018 23:00:00,07/06/2018 01:00:00,07/06/2018 01:00:00,EXPIRED,LONG,7660.0,7720.0,7988.8,7550.4,1.398,4.12,1.45,6311.32,2,3.0,1151.7
25/02/2018 02:00:00,15/06/2023 18:58:11,Gemini_BTCUSD_1h_17_12_17_to_10_03_23.csv,BTC_USD,HOUR,106342.79,16.44,25/02/2018 03:00:00,25/02/2018 05:00:00,25/02/2018 05:00:00,EXPIRED,LONG,9612.0,9735.0,10000.11,9482.63,1.486,3.88,1.36,6380.53,2,3.0,2022.12
13/05/2018 02:00:00,15/06/2023 18:58:11,Gemini_BTCUSD_1h_17_12_17_to_10_03_23.csv,BTC_USD,HOUR,108364.91,19.647,13/05/2018 03:00:00,13/05/2018 05:00:00,13/05/2018 05:00:00,EXPIRED,LONG,8422.0,8390.0,8752.93,8311.69,1.527,3.78,1.33,6501.78,2,3.0,-628.7
21/06/2018 23:00:00,15/06/2023 18:58:11,Gemini_BTCUSD_1h_17_12_17_to_10_03_23.csv,BTC_USD,HOUR,107736.21,45.22,22/06/2018 01:00:00,22/06/2018 02:00:00,22/06/2018 02:00:00,EXPIRED,SHORT,6718.0,6664.0,6575.05,6765.65,2.82,2.17,0.7,6464.2,2,3.0,2441.88
20/04/2018 14:00:00,15/06/2023 18:58:11,Gemini_BTCUSD_1h_17_12_17_to_10_03_23.csv,BTC_USD,HOUR,110178.09,51.739,20/04/2018 15:00:00,20/04/2018 17:00:00,20/04/2018 15:00:00,STOP_LOSS_HIT,LONG,8501.0,8458.41,8628.77,8458.41,3.992,1.48,0.5,6610.69,2,3.0,-2203.56
07/07/2020 18:00:00,15/06/2023 18:58:11,Gemini_BTCUSD_1h_17_12_17_to_10_03_23.csv,BTC_USD,HOUR,107974.53,33.111,07/07/2020 22:00:00,07/07/2020 21:00:00,07/07/2020 21:00:00,EXPIRED,SHORT,9270.0,9248.0,9074.33,9335.22,2.843,2.16,0.7,6478.83,2,3.0,728.44
26/08/2021 16:00:00,15/06/2023 18:58:11,Gemini_BTCUSD_1h_17_12_17_to_10_03_23.csv,BTC_USD,HOUR,108702.97,4.501,26/08/2021 17:00:00,26/08/2021 19:00:00,26/08/2021 19:00:00,EXPIRED,LONG,46921.0,46928.0,48370.22,46437.93,1.943,3.0,1.04,6522.94,2,3.0,31.51
21/01/2023 00:00:00,15/06/2023 18:58:11,Gemini_BTCUSD_1h_17_12_17_to_10_03_23.csv,BTC_USD,HOUR,108734.48,16.168,21/01/2023 02:00:00,21/01/2023 03:00:00,21/01/2023 03:00:00,EXPIRED,SHORT,22591.0,22555.0,22187.49,22725.51,3.359,1.82,0.59,6523.95,2,3.0,582.05
24/05/2018 06:00:00,15/06/2023 18:58:11,Gemini_BTCUSD_1h_17_12_17_to_10_03_23.csv,BTC_USD,HOUR,109316.53,26.588,24/05/2018 08:00:00,24/05/2018 09:00:00,24/05/2018 07:00:00,STOP_LOSS_HIT,LONG,7654.0,7571.77,7900.68,7571.77,1.862,3.12,1.09,6558.73,2,3.0,-2186.33
17/05/2018 16:00:00,15/06/2023 18:58:11,Gemini_BTCUSD_1h_17_12_17_to_10_03_23.csv,BTC_USD,HOUR,107130.2,18.001,17/05/2018 17:00:00,17/05/2018 19:00:00,17/05/2018 18:00:00,STOP_LOSS_HIT,LONG,8287.0,8167.97,8644.08,8167.97,1.392,4.13,1.46,6427.8,2,3.0,-2142.66
12/12/2021 14:00:00,15/06/2023 18:58:11,Gemini_BTCUSD_1h_17_12_17_to_10_03_23.csv,BTC_USD,HOUR,104987.54,2.258,12/12/2021 15:00:00,12/12/2021 17:00:00,12/12/2021 17:00:00,EXPIRED,LONG,49905.0,50305.0,52694.96,48975.01,1.073,5.29,1.9,6299.73,2,3.0,903.2
27/11/2018 22:00:00,15/06/2023 18:58:11,Gemini_BTCUSD_1h_17_12_17_to_10_03_23.csv,BTC_USD,HOUR,105890.74,29.665,27/11/2018 23:00:00,28/11/2018 01:00:00,28/11/2018 01:00:00,EXPIRED,LONG,3799.0,3799.0,4013.16,3727.61,1.064,5.34,1.92,6353.06,2,3.0,0.0
23/01/2023 00:00:00,15/06/2023 18:58:11,Gemini_BTCUSD_1h_17_12_17_to_10_03_23.csv,BTC_USD,HOUR,105890.74,18.055,23/01/2023 03:00:00,23/01/2023 03:00:00,23/01/2023 03:00:00,EXPIRED,LONG,22752.0,22674.0,23103.9,22634.7,3.879,1.52,0.52,6353.55,2,3.0,-1408.29
07/08/2019 13:00:00,15/06/2023 18:58:11,Gemini_BTCUSD_1h_17_12_17_to_10_03_23.csv,BTC_USD,HOUR,104482.45,8.929,07/08/2019 14:00:00,07/08/2019 16:00:00,07/08/2019 15:00:00,STOP_LOSS_HIT,LONG,12030.0,11795.98,12732.05,11795.98,1.028,5.51,1.98,6268.6,2,3.0,-2089.56
20/11/2020 18:00:00,15/06/2023 18:58:11,Gemini_BTCUSD_1h_17_12_17_to_10_03_23.csv,BTC_USD,HOUR,102392.89,13.403,20/11/2020 19:00:00,20/11/2020 21:00:00,20/11/2020 21:00:00,EXPIRED,LONG,18602.0,18597.0,19060.37,18449.21,2.435,2.4,0.83,6143.53,2,3.0,-67.01
04/05/2021 23:00:00,15/06/2023 18:58:11,Gemini_BTCUSD_1h_17_12_17_to_10_03_23.csv,BTC_USD,HOUR,102325.88,3.305,05/05/2021 03:00:00,05/05/2021 02:00:00,05/05/2021 02:00:00,TAKE_PROFIT_HIT,LONG,53240.0,55097.78,55097.78,52620.74,1.72,3.37,1.18,6139.96,2,3.0,6139.96
22/04/2022 09:00:00,15/06/2023 18:58:11,Gemini_BTCUSD_1h_17_12_17_to_10_03_23.csv,BTC_USD,HOUR,108465.84,6.216,22/04/2022 13:00:00,22/04/2022 12:00:00,22/04/2022 12:00:00,EXPIRED,SHORT,40318.0,40419.0,39270.97,40667.01,2.311,2.67,0.86,6508.34,2,3.0,-627.82
23/11/2018 10:00:00,15/06/2023 18:58:11,Gemini_BTCUSD_1h_17_12_17_to_10_03_23.csv,BTC_USD,HOUR,107838.02,98.124,23/11/2018 11:00:00,23/11/2018 13:00:00,23/11/2018 11:00:00,STOP_LOSS_HIT,LONG,4290.0,4268.02,4355.93,4268.02,3.904,1.51,0.51,6469.32,2,3.0,-2156.77
28/06/2019 00:00:00,15/06/2023 18:58:11,Gemini_BTCUSD_1h_17_12_17_to_10_03_23.csv,BTC_USD,HOUR,105681.25,35.046,28/06/2019 02:00:00,28/06/2019 03:00:00,28/06/2019 01:00:00,STOP_LOSS_HIT,LONG,11463.0,11402.69,11643.94,11402.69,3.801,1.55,0.53,6341.22,2,3.0,-2113.62
09/02/2021 23:00:00,15/06/2023 18:58:11,Gemini_BTCUSD_1h_17_12_17_to_10_03_23.csv,BTC_USD,HOUR,103567.63,3.224,10/02/2021 01:00:00,10/02/2021 02:00:00,10/02/2021 02:00:00,EXPIRED,LONG,46507.0,46378.0,48434.22,45864.6,1.448,3.98,1.4,6213.36,2,3.0,-415.9
30/04/2018 19:00:00,15/06/2023 18:58:11,Gemini_BTCUSD_1h_17_12_17_to_10_03_23.csv,BTC_USD,HOUR,103151.73,13.171,30/04/2018 20:00:00,30/04/2018 22:00:00,30/04/2018 22:00:00,STOP_LOSS_HIT,LONG,9322.0,9165.36,9791.93,9165.36,1.19,4.8,1.71,6189.45,2,3.0,-2063.11
02/04/2022 04:00:00,15/06/2023 18:58:11,Gemini_BTCUSD_1h_17_12_17_to_10_03_23.csv,BTC_USD,HOUR,101088.62,4.819,02/04/2022 05:00:00,02/04/2022 07:00:00,02/04/2022 07:00:00,EXPIRED,LONG,46572.0,46600.0,47830.74,46152.42,2.22,2.63,0.91,6065.87,2,3.0,134.93
22/08/2021 17:00:00,15/06/2023 18:58:11,Gemini_BTCUSD_1h_17_12_17_to_10_03_23.csv,BTC_USD,HOUR,101223.55,8.607,22/08/2021 20:00:00,22/08/2021 20:00:00,22/08/2021 18:00:00,STOP_LOSS_HIT,LONG,48721.0,48485.8,49426.6,48485.8,4.143,1.43,0.49,6073.1,2,3.0,-2024.37
07/02/2022 08:00:00,15/06/2023 18:58:11,Gemini_BTCUSD_1h_17_12_17_to_10_03_23.csv,BTC_USD,HOUR,99199.18,8.698,07/02/2022 10:00:00,07/02/2022 11:00:00,07/02/2022 09:00:00,STOP_LOSS_HIT,LONG,42639.0,42410.9,43323.3,42410.9,3.739,1.58,0.54,5952.04,2,3.0,-1984.01
05/11/2020 04:00:00,15/06/2023 18:58:11,Gemini_BTCUSD_1h_17_12_17_to_10_03_23.csv,BTC_USD,HOUR,97215.17,8.567,05/11/2020 05:00:00,05/11/2020 07:00:00,05/11/2020 07:00:00,EXPIRED,LONG,14306.0,14498.0,14986.84,14079.05,1.261,4.54,1.61,5832.76,2,3.0,1644.86
19/07/2018 12:00:00,15/06/2023 18:58:11,Gemini_BTCUSD_1h_17_12_17_to_10_03_23.csv,BTC_USD,HOUR,98860.03,15.308,19/07/2018 13:00:00,19/07/2018 15:00:00,19/07/2018 15:00:00,EXPIRED,LONG,7418.0,7378.0,7805.49,7288.84,1.149,4.96,1.77,5931.7,2,3.0,-612.32
21/03/2018 14:00:00,15/06/2023 18:58:11,Gemini_BTCUSD_1h_17_12_17_to_10_03_23.csv,BTC_USD,HOUR,98247.71,44.058,21/03/2018 15:00:00,21/03/2018 17:00:00,21/03/2018 16:00:00,STOP_LOSS_HIT,LONG,9060.0,9015.4,9193.81,9015.4,4.063,1.46,0.49,5895.4,2,3.0,-1964.99
27/01/2020 21:00:00,15/06/2023 18:58:11,Gemini_BTCUSD_1h_17_12_17_to_10_03_23.csv,BTC_USD,HOUR,96282.72,14.121,27/01/2020 22:00:00,28/01/2020 00:00:00,28/01/2020 00:00:00,EXPIRED,LONG,8945.0,9053.0,9354.1,8808.63,1.312,4.37,1.55,5776.9,2,3.0,1525.07
16/12/2021 16:00:00,15/06/2023 18:58:11,Gemini_BTCUSD_1h_17_12_17_to_10_03_23.csv,BTC_USD,HOUR,97807.79,2.24,16/12/2021 20:00:00,16/12/2021 19:00:00,16/12/2021 19:00:00,EXPIRED,SHORT,48535.0,47873.0,45915.58,49408.14,1.112,5.7,1.77,5867.5,2,3.0,1482.88
07/04/2022 12:00:00,15/06/2023 18:58:11,Gemini_BTCUSD_1h_17_12_17_to_10_03_23.csv,BTC_USD,HOUR,99290.67,3.824,07/04/2022 13:00:00,07/04/2022 15:00:00,07/04/2022 15:00:00,EXPIRED,SHORT,43547.0,43336.0,41989.03,44066.33,1.677,3.71,1.18,5957.68,2,3.0,806.86
18/06/2020 01:00:00,15/06/2023 18:58:11,Gemini_BTCUSD_1h_17_12_17_to_10_03_23.csv,BTC_USD,HOUR,100097.53,41.218,18/06/2020 05:00:00,18/06/2020 04:00:00,18/06/2020 04:00:00,EXPIRED,LONG,9415.0,9403.0,9560.71,9366.43,3.877,1.52,0.52,6005.87,2,3.0,-494.62
02/01/2018 11:00:00,15/06/2023 18:58:11,Gemini_BTCUSD_1h_17_12_17_to_10_03_23.csv,BTC_USD,HOUR,99602.91,26.858,02/01/2018 12:00:00,02/01/2018 14:00:00,02/01/2018 13:00:00,TAKE_PROFIT_HIT,LONG,13533.0,13755.51,13755.51,13458.83,3.649,1.62,0.55,5976.17,2,3.0,5976.17
07/07/2022 10:00:00,15/06/2023 18:58:11,Gemini_BTCUSD_1h_17_12_17_to_10_03_23.csv,BTC_USD,HOUR,105579.08,6.518,07/07/2022 11:00:00,07/07/2022 13:00:00,07/07/2022 13:00:00,EXPIRED,LONG,20485.0,20528.0,21456.82,20161.06,1.265,4.53,1.61,6334.32,2,3.0,280.27
10/02/2021 12:00:00,15/06/2023 18:58:11,Gemini_BTCUSD_1h_17_12_17_to_10_03_23.csv,BTC_USD,HOUR,105859.35,9.488,10/02/2021 13:00:00,10/02/2021 15:00:00,10/02/2021 13:00:00,STOP_LOSS_HIT,LONG,45873.0,45649.85,46542.47,45649.85,4.112,1.44,0.49,6351.93,2,3.0,-2117.25
11/12/2021 23:00:00,15/06/2023 18:58:11,Gemini_BTCUSD_1h_17_12_17_to_10_03_23.csv,BTC_USD,HOUR,103742.1,2.83,12/12/2021 02:00:00,12/12/2021 02:00:00,12/12/2021 02:00:00,EXPIRED,LONG,49402.0,49073.0,51601.28,48668.91,1.348,4.26,1.51,6223.96,2,3.0,-931.07
14/11/2021 15:00:00,15/06/2023 18:58:11,Gemini_BTCUSD_1h_17_12_17_to_10_03_23.csv,BTC_USD,HOUR,102811.03,6.515,14/11/2021 16:00:00,14/11/2021 18:00:00,14/11/2021 16:00:00,STOP_LOSS_HIT,LONG,64107.0,63791.4,65053.81,63791.4,4.062,1.46,0.49,6168.47,2,3.0,-2056.13
08/02/2020 23:00:00,15/06/2023 18:58:11,Gemini_BTCUSD_1h_17_12_17_to_10_03_23.csv,BTC_USD,HOUR,100754.9,19.041,09/02/2020 00:00:00,09/02/2020 02:00:00,09/02/2020 02:00:00,EXPIRED,LONG,9913.0,9976.0,10230.49,9807.17,1.873,3.1,1.08,6045.33,2,3.0,1199.58
17/03/2019 20:00:00,15/06/2023 18:58:11,Gemini_BTCUSD_1h_17_12_17_to_10_03_23.csv,BTC_USD,HOUR,101954.48,46.47,17/03/2019 21:00:00,17/03/2019 23:00:00,17/03/2019 23:00:00,EXPIRED,LONG,3975.0,3965.0,4106.64,3931.12,1.812,3.21,1.12,6117.31,2,3.0,-464.7
06/04/2022 22:00:00,15/06/2023 18:58:12,Gemini_BTCUSD_1h_17_12_17_to_10_03_23.csv,BTC_USD,HOUR,101489.78,7.554,06/04/2022 23:00:00,07/04/2022 01:00:00,06/04/2022 23:00:00,STOP_LOSS_HIT,LONG,43531.0,43262.3,44337.11,43262.3,3.24,1.82,0.62,6089.35,2,3.0,-2029.76
20/01/2022 04:00:00,15/06/2023 18:58:12,Gemini_BTCUSD_1h_17_12_17_to_10_03_23.csv,BTC_USD,HOUR,99460.02,5.866,20/01/2022 05:00:00,20/01/2022 07:00:00,20/01/2022 07:00:00,EXPIRED,LONG,41916.0,42071.0,42933.39,41576.87,2.472,2.37,0.82,5968.01,2,3.0,909.23
29/05/2020 00:00:00,15/06/2023 18:58:12,Gemini_BTCUSD_1h_17_12_17_to_10_03_23.csv,BTC_USD,HOUR,100369.25,16.496,29/05/2020 02:00:00,29/05/2020 03:00:00,29/05/2020 03:00:00,EXPIRED,LONG,9508.0,9516.0,9873.07,9386.31,1.563,3.7,1.3,6022.19,2,3.0,131.97
05/04/2019 18:00:00,15/06/2023 18:58:12,Gemini_BTCUSD_1h_17_12_17_to_10_03_23.csv,BTC_USD,HOUR,100501.22,21.036,05/04/2019 19:00:00,05/04/2019 21:00:00,05/04/2019 21:00:00,EXPIRED,LONG,5023.0,5010.0,5309.66,4927.45,1.051,5.4,1.94,6030.18,2,3.0,-273.47
27/02/2019 14:00:00,15/06/2023 18:58:12,Gemini_BTCUSD_1h_17_12_17_to_10_03_23.csv,BTC_USD,HOUR,100227.75,51.478,27/02/2019 15:00:00,27/02/2019 17:00:00,27/02/2019 17:00:00,EXPIRED,LONG,3803.0,3805.0,3919.83,3764.06,1.953,2.98,1.03,6014.17,2,3.0,102.96
24/04/2021 20:00:00,15/06/2023 18:58:12,Gemini_BTCUSD_1h_17_12_17_to_10_03_23.csv,BTC_USD,HOUR,100330.71,2.281,24/04/2021 22:00:00,24/04/2021 23:00:00,24/04/2021 23:00:00,STOP_LOSS_HIT,LONG,50995.0,50115.21,53634.39,50115.21,1.159,4.92,1.76,6020.45,2,3.0,-2006.8
08/08/2021 11:00:00,15/06/2023 18:58:12,Gemini_BTCUSD_1h_17_12_17_to_10_03_23.csv,BTC_USD,HOUR,98323.91,8.261,08/08/2021 13:00:00,08/08/2021 14:00:00,08/08/2021 13:00:00,TAKE_PROFIT_HIT,LONG,44500.0,45214.16,45214.16,44261.95,3.739,1.58,0.54,5899.68,2,3.0,5899.68
13/10/2021 00:00:00,15/06/2023 18:58:12,Gemini_BTCUSD_1h_17_12_17_to_10_03_23.csv,BTC_USD,HOUR,104223.59,4.236,13/10/2021 04:00:00,13/10/2021 03:00:00,13/10/2021 03:00:00,EXPIRED,SHORT,56466.0,56289.0,54989.71,56958.1,2.295,2.68,0.86,6253.56,2,3.0,749.77
16/11/2018 00:00:00,15/06/2023 18:58:12,Gemini_BTCUSD_1h_17_12_17_to_10_03_23.csv,BTC_USD,HOUR,104973.36,25.467,16/11/2018 01:00:00,16/11/2018 03:00:00,16/11/2018 03:00:00,EXPIRED,LONG,5548.0,5574.0,5795.32,5465.56,1.346,4.27,1.51,6298.5,2,3.0,662.14
13/04/2022 02:00:00,15/06/2023 18:58:12,Gemini_BTCUSD_1h_17_12_17_to_10_03_23.csv,BTC_USD,HOUR,105635.5,8.88,13/04/2022 05:00:00,13/04/2022 05:00:00,13/04/2022 05:00:00,EXPIRED,SHORT,40063.0,40187.0,39349.26,40300.92,3.368,1.81,0.59,6338.01,2,3.0,-1101.12
07/10/2019 10:00:00,15/06/2023 18:58:12,Gemini_BTCUSD_1h_17_12_17_to_10_03_23.csv,BTC_USD,HOUR,104534.38,14.945,07/10/2019 12:00:00,07/10/2019 13:00:00,07/10/2019 13:00:00,EXPIRED,LONG,8004.0,8164.0,8423.68,7864.11,1.144,4.98,1.78,6272.12,2,3.0,2391.2
28/08/2020 14:00:00,15/06/2023 18:58:12,Gemini_BTCUSD_1h_17_12_17_to_10_03_23.csv,BTC_USD,HOUR,106925.58,17.253,28/08/2020 16:00:00,28/08/2020 17:00:00,28/08/2020 17:00:00,EXPIRED,SHORT,11450.0,11483.0,11078.14,11573.95,1.848,3.36,1.07,6415.7,2,3.0,-569.35
15/09/2022 11:00:00,15/06/2023 18:58:12,Gemini_BTCUSD_1h_17_12_17_to_10_03_23.csv,BTC_USD,HOUR,106356.23,17.013,15/09/2022 12:00:00,15/09/2022 14:00:00,15/09/2022 13:00:00,STOP_LOSS_HIT,LONG,20150.0,20024.97,20525.08,20024.97,3.223,1.83,0.62,6381.24,2,3.0,-2127.14
10/08/2018 15:00:00,15/06/2023 18:58:12,Gemini_BTCUSD_1h_17_12_17_to_10_03_23.csv,BTC_USD,HOUR,104229.09,34.252,10/08/2018 18:00:00,10/08/2018 18:00:00,10/08/2018 18:00:00,EXPIRED,SHORT,6453.0,6405.0,6270.43,6513.86,2.121,2.91,0.93,6253.39,2,3.0,1644.1
24/03/2020 17:00:00,15/06/2023 18:58:12,Gemini_BTCUSD_1h_17_12_17_to_10_03_23.csv,BTC_USD,HOUR,105873.19,63.246,24/03/2020 19:00:00,24/03/2020 20:00:00,24/03/2020 19:00:00,STOP_LOSS_HIT,SHORT,6683.0,6716.48,6582.55,6716.48,3.992,1.53,0.5,6353.06,2,3.0,-2117.48
11/04/2020 07:00:00,15/06/2023 18:58:12,Gemini_BTCUSD_1h_17_12_17_to_10_03_23.csv,BTC_USD,HOUR,103755.71,37.511,11/04/2020 08:00:00,11/04/2020 10:00:00,11/04/2020 10:00:00,EXPIRED,LONG,6892.0,6853.0,7057.97,6836.68,2.492,2.35,0.81,6225.7,2,3.0,-1462.93
25/06/2020 00:00:00,15/06/2023 18:58:12,Gemini_BTCUSD_1h_17_12_17_to_10_03_23.csv,BTC_USD,HOUR,102292.78,42.489,25/06/2020 03:00:00,25/06/2020 03:00:00,25/06/2020 03:00:00,STOP_LOSS_HIT,LONG,9255.0,9206.85,9399.45,9206.85,3.844,1.54,0.52,6137.54,2,3.0,-2045.85
19/02/2021 18:00:00,15/06/2023 18:58:12,Gemini_BTCUSD_1h_17_12_17_to_10_03_23.csv,BTC_USD,HOUR,100246.93,2.189,19/02/2021 19:00:00,19/02/2021 21:00:00,19/02/2021 21:00:00,EXPIRED,LONG,55403.0,55652.0,58151.36,54486.88,1.21,4.73,1.68,6016.16,2,3.0,545.06
05/05/2018 23:00:00,15/06/2023 18:58:12,Gemini_BTCUSD_1h_17_12_17_to_10_03_23.csv,BTC_USD,HOUR,100791.99,37.07,06/05/2018 03:00:00,06/05/2018 02:00:00,06/05/2018 02:00:00,EXPIRED,LONG,9813.0,9820.0,9976.13,9758.62,3.609,1.64,0.56,6047.23,2,3.0,259.49
06/01/2023 17:00:00,15/06/2023 18:58:12,Gemini_BTCUSD_1h_17_12_17_to_10_03_23.csv,BTC_USD,HOUR,101051.48,11.326,06/01/2023 18:00:00,06/01/2023 20:00:00,06/01/2023 20:00:00,EXPIRED,LONG,16810.0,16897.0,17345.35,16631.55,1.884,3.09,1.07,6063.37,2,3.0,985.36
12/05/2022 12:00:00,15/06/2023 18:58:12,Gemini_BTCUSD_1h_17_12_17_to_10_03_23.csv,BTC_USD,HOUR,102036.84,13.053,12/05/2022 16:00:00,12/05/2022 15:00:00,12/05/2022 13:00:00,STOP_LOSS_HIT,SHORT,28297.0,28453.34,27827.99,28453.34,3.62,1.69,0.55,6121.99,2,3.0,-2040.71
22/03/2019 05:00:00,15/06/2023 18:58:12,Gemini_BTCUSD_1h_17_12_17_to_10_03_23.csv,BTC_USD,HOUR,99996.13,61.16,22/03/2019 07:00:00,22/03/2019 08:00:00,22/03/2019 08:00:00,EXPIRED,LONG,3977.0,3978.0,4075.09,3944.3,2.432,2.41,0.83,5999.18,2,3.0,61.16
19/10/2021 21:00:00,15/06/2023 18:58:12,Gemini_BTCUSD_1h_17_12_17_to_10_03_23.csv,BTC_USD,HOUR,100057.29,6.264,19/10/2021 22:00:00,20/10/2021 00:00:00,20/10/2021 00:00:00,EXPIRED,LONG,64096.0,64081.0,65054.48,63776.51,4.013,1.47,0.5,6003.92,2,3.0,-93.96
24/08/2022 15:00:00,15/06/2023 18:58:12,Gemini_BTCUSD_1h_17_12_17_to_10_03_23.csv,BTC_USD,HOUR,99963.33,8.69,24/08/2022 16:00:00,24/08/2022 18:00:00,24/08/2022 18:00:00,EXPIRED,LONG,21616.0,21680.0,22306.22,21385.93,1.879,3.09,1.08,5998.01,2,3.0,556.16
06/05/2020 00:00:00,15/06/2023 18:58:12,Gemini_BTCUSD_1h_17_12_17_to_10_03_23.csv,BTC_USD,HOUR,100519.49,25.574,06/05/2020 01:00:00,06/05/2020 03:00:00,06/05/2020 03:00:00,EXPIRED,LONG,8953.0,8982.0,9188.84,8874.39,2.278,2.57,0.89,6031.37,2,3.0,741.65
07/03/2020 10:00:00,15/06/2023 18:58:12,Gemini_BTCUSD_1h_17_12_17_to_10_03_23.csv,BTC_USD,HOUR,101261.14,11.1,07/03/2020 11:00:00,07/03/2020 13:00:00,07/03/2020 13:00:00,EXPIRED,LONG,9123.0,9105.0,9670.39,8940.54,1.0,5.66,2.04,6076.03,2,3.0,-199.8
08/11/2018 11:00:00,15/06/2023 18:58:12,Gemini_BTCUSD_1h_17_12_17_to_10_03_23.csv,BTC_USD,HOUR,101061.34,15.915,08/11/2018 12:00:00,08/11/2018 14:00:00,08/11/2018 14:00:00,EXPIRED,LONG,6444.0,6480.0,6825.0,6317.0,1.015,5.58,2.01,6063.62,2,3.0,572.94
28/09/2018 18:00:00,15/06/2023 18:58:12,Gemini_BTCUSD_1h_17_12_17_to_10_03_23.csv,BTC_USD,HOUR,101634.28,54.716,28/09/2018 19:00:00,28/09/2018 21:00:00,28/09/2018 19:00:00,STOP_LOSS_HIT,LONG,6644.0,6606.85,6755.44,6606.85,3.577,1.65,0.56,6097.55,2,3.0,-2032.7
08/07/2018 10:00:00,15/06/2023 18:58:12,Gemini_BTCUSD_1h_17_12_17_to_10_03_23.csv,BTC_USD,HOUR,99601.58,29.183,08/07/2018 11:00:00,08/07/2018 13:00:00,08/07/2018 13:00:00,EXPIRED,LONG,6727.0,6734.0,6931.8,6658.74,1.971,2.95,1.03,5976.68,2,3.0,204.28
04/10/2021 22:00:00,15/06/2023 18:58:12,Gemini_BTCUSD_1h_17_12_17_to_10_03_23.csv,BTC_USD,HOUR,99805.86,6.842,05/10/2021 00:00:00,05/10/2021 01:00:00,05/10/2021 01:00:00,EXPIRED,LONG,48957.0,49257.0,49832.3,48665.24,3.356,1.76,0.6,5988.8,2,3.0,2052.6
23/12/2021 15:00:00,15/06/2023 18:58:12,Gemini_BTCUSD_1h_17_12_17_to_10_03_23.csv,BTC_USD,HOUR,101858.46,7.663,23/12/2021 16:00:00,23/12/2021 18:00:00,23/12/2021 17:00:00,TAKE_PROFIT_HIT,LONG,48842.0,49639.51,49639.51,48576.17,3.674,1.61,0.55,6111.32,2,3.0,6111.32
22/05/2022 05:00:00,15/06/2023 18:58:12,Gemini_BTCUSD_1h_17_12_17_to_10_03_23.csv,BTC_USD,HOUR,107969.78,14.217,22/05/2022 06:00:00,22/05/2022 08:00:00,22/05/2022 08:00:00,EXPIRED,LONG,29337.0,29521.0,29792.67,29185.11,3.863,1.53,0.52,6478.26,2,3.0,2615.93
11/09/2022 17:00:00,15/06/2023 18:58:12,Gemini_BTCUSD_1h_17_12_17_to_10_03_23.csv,BTC_USD,HOUR,110585.71,6.129,11/09/2022 18:00:00,11/09/2022 20:00:00,11/09/2022 20:00:00,EXPIRED,LONG,21634.0,21646.0,22716.61,21273.13,1.199,4.77,1.7,6635.32,2,3.0,73.55
14/09/2021 07:00:00,15/06/2023 18:58:12,Gemini_BTCUSD_1h_17_12_17_to_10_03_23.csv,BTC_USD,HOUR,110659.26,3.156,14/09/2021 08:00:00,14/09/2021 10:00:00,14/09/2021 10:00:00,EXPIRED,LONG,45742.0,46033.0,47845.8,45040.74,1.305,4.4,1.56,6639.59,2,3.0,918.4
27/02/2018 14:00:00,15/06/2023 18:58:12,Gemini_BTCUSD_1h_17_12_17_to_10_03_23.csv,BTC_USD,HOUR,111577.66,41.907,27/02/2018 15:00:00,27/02/2018 17:00:00,27/02/2018 15:00:00,STOP_LOSS_HIT,LONG,10681.0,10627.75,10840.74,10627.75,4.012,1.47,0.5,6694.22,2,3.0,-2231.55
11/06/2020 06:00:00,15/06/2023 18:58:12,Gemini_BTCUSD_1h_17_12_17_to_10_03_23.csv,BTC_USD,HOUR,109346.11,24.135,11/06/2020 09:00:00,11/06/2020 09:00:00,11/06/2020 09:00:00,EXPIRED,SHORT,9830.0,9797.0,9558.16,9920.61,2.17,2.84,0.91,6560.86,2,3.0,796.46
02/02/2021 09:00:00,15/06/2023 18:58:12,Gemini_BTCUSD_1h_17_12_17_to_10_03_23.csv,BTC_USD,HOUR,110142.57,3.869,02/02/2021 10:00:00,02/02/2021 12:00:00,02/02/2021 11:00:00,STOP_LOSS_HIT,LONG,35353.0,34783.71,37060.87,34783.71,1.242,4.61,1.64,6607.75,2,3.0,-2202.58
08/05/2020 15:00:00,15/06/2023 18:58:12,Gemini_BTCUSD_1h_17_12_17_to_10_03_23.csv,BTC_USD,HOUR,107939.99,27.292,08/05/2020 16:00:00,08/05/2020 18:00:00,08/05/2020 18:00:00,EXPIRED,LONG,9956.0,9910.0,10193.31,9876.9,2.517,2.33,0.8,6476.66,2,3.0,-1255.43
10/10/2020 13:00:00,15/06/2023 18:58:12,Gemini_BTCUSD_1h_17_12_17_to_10_03_23.csv,BTC_USD,HOUR,106684.56,14.871,10/10/2020 14:00:00,10/10/2020 16:00:00,10/10/2020 16:00:00,EXPIRED,LONG,11358.0,11340.0,11788.45,11214.52,1.583,3.65,1.28,6401.22,2,3.0,-267.68
07/11/2019 16:00:00,15/06/2023 18:58:12,Gemini_BTCUSD_1h_17_12_17_to_10_03_23.csv,BTC_USD,HOUR,106416.88,22.861,07/11/2019 17:00:00,07/11/2019 19:00:00,07/11/2019 19:00:00,EXPIRED,LONG,9199.0,9200.0,9478.29,9105.9,1.976,2.95,1.02,6384.85,2,3.0,22.86
24/05/2020 10:00:00,15/06/2023 18:58:12,Gemini_BTCUSD_1h_17_12_17_to_10_03_23.csv,BTC_USD,HOUR,106439.74,19.503,24/05/2020 14:00:00,24/05/2020 13:00:00,24/05/2020 13:00:00,EXPIRED,SHORT,9271.0,9088.0,8943.54,9380.15,1.699,3.66,1.16,6386.45,2,3.0,3569.05
06/07/2018 20:00:00,15/06/2023 18:58:12,Gemini_BTCUSD_1h_17_12_17_to_10_03_23.csv,BTC_USD,HOUR,110008.79,40.956,06/07/2018 21:00:00,06/07/2018 23:00:00,06/07/2018 23:00:00,EXPIRED,LONG,6573.0,6587.0,6734.16,6519.28,2.447,2.39,0.82,6600.47,2,3.0,573.38
21/10/2021 22:00:00,15/06/2023 18:58:12,Gemini_BTCUSD_1h_17_12_17_to_10_03_23.csv,BTC_USD,HOUR,110582.17,6.165,22/10/2021 00:00:00,22/10/2021 01:00:00,22/10/2021 00:00:00,STOP_LOSS_HIT,SHORT,62459.0,62817.74,61382.79,62817.74,3.482,1.75,0.57,6634.83,2,3.0,-2211.63
03/04/2020 13:00:00,15/06/2023 18:58:12,Gemini_BTCUSD_1h_17_12_17_to_10_03_23.csv,BTC_USD,HOUR,108370.54,21.915,03/04/2020 17:00:00,03/04/2020 16:00:00,03/04/2020 14:00:00,STOP_LOSS_HIT,LONG,6842.0,6743.1,7138.71,6743.1,1.384,4.16,1.47,6502.4,2,3.0,-2167.39
24/01/2019 23:00:00,15/06/2023 18:58:12,Gemini_BTCUSD_1h_17_12_17_to_10_03_23.csv,BTC_USD,HOUR,106203.15,61.71,25/01/2019 00:00:00,25/01/2019 02:00:00,25/01/2019 02:00:00,EXPIRED,LONG,3570.0,3568.0,3673.25,3535.58,2.074,2.81,0.97,6371.56,2,3.0,-123.42
18/08/2018 03:00:00,15/06/2023 18:58:12,Gemini_BTCUSD_1h_17_12_17_to_10_03_23.csv,BTC_USD,HOUR,106079.73,21.647,18/08/2018 07:00:00,18/08/2018 06:00:00,18/08/2018 06:00:00,EXPIRED,LONG,6526.0,6473.0,6820.02,6427.99,1.332,4.31,1.52,6364.65,2,3.0,-1147.29
28/10/2019 23:00:00,15/06/2023 18:58:12,Gemini_BTCUSD_1h_17_12_17_to_10_03_23.csv,BTC_USD,HOUR,104932.44,11.329,29/10/2019 00:00:00,29/10/2019 02:00:00,29/10/2019 02:00:00,EXPIRED,LONG,9220.0,9269.0,9775.73,9034.76,0.995,5.68,2.05,6295.87,2,3.0,555.12
27/10/2022 01:00:00,15/06/2023 18:58:12,Gemini_BTCUSD_1h_17_12_17_to_10_03_23.csv,BTC_USD,HOUR,105487.56,6.623,27/10/2022 02:00:00,27/10/2022 04:00:00,27/10/2022 04:00:00,EXPIRED,LONG,20737.0,20838.0,21692.69,20418.44,1.302,4.41,1.56,6329.53,2,3.0,668.92
12/12/2022 11:00:00,15/06/2023 18:58:12,Gemini_BTCUSD_1h_17_12_17_to_10_03_23.csv,BTC_USD,HOUR,106156.48,9.444,12/12/2022 12:00:00,12/12/2022 14:00:00,12/12/2022 14:00:00,EXPIRED,LONG,16980.0,17021.0,17654.46,16755.18,1.511,3.82,1.34,6369.6,2,3.0,387.2
01/11/2022 05:00:00,15/06/2023 18:58:12,Gemini_BTCUSD_1h_17_12_17_to_10_03_23.csv,BTC_USD,HOUR,106543.68,19.958,01/11/2022 06:00:00,01/11/2022 08:00:00,01/11/2022 08:00:00,EXPIRED,LONG,20533.0,20581.0,20853.32,20426.23,3.846,1.54,0.52,6392.95,2,3.0,957.98
10/09/2020 01:00:00,15/06/2023 18:58:12,Gemini_BTCUSD_1h_17_12_17_to_10_03_23.csv,BTC_USD,HOUR,107501.66,15.028,10/09/2020 05:00:00,10/09/2020 04:00:00,10/09/2020 04:00:00,EXPIRED,LONG,10396.0,10394.0,10825.21,10252.93,1.453,3.96,1.4,6450.17,2,3.0,-30.06
16/05/2022 00:00:00,15/06/2023 18:58:12,Gemini_BTCUSD_1h_17_12_17_to_10_03_23.csv,BTC_USD,HOUR,107471.6,12.367,16/05/2022 02:00:00,16/05/2022 03:00:00,16/05/2022 02:00:00,TAKE_PROFIT_HIT,SHORT,31068.0,30546.61,30546.61,31241.8,3.575,1.71,0.56,6448.03,2,3.0,6448.03
07/12/2018 14:00:00,15/06/2023 18:58:12,Gemini_BTCUSD_1h_17_12_17_to_10_03_23.csv,BTC_USD,HOUR,113919.63,31.746,07/12/2018 15:00:00,07/12/2018 17:00:00,07/12/2018 15:00:00,STOP_LOSS_HIT,LONG,3390.0,3318.23,3605.32,3318.23,0.945,5.97,2.16,6835.55,2,3.0,-2278.41
04/09/2020 09:00:00,15/06/2023 18:58:12,Gemini_BTCUSD_1h_17_12_17_to_10_03_23.csv,BTC_USD,HOUR,111641.22,18.627,04/09/2020 10:00:00,04/09/2020 12:00:00,04/09/2020 11:00:00,STOP_LOSS_HIT,LONG,10561.0,10441.13,10920.62,10441.13,1.762,3.29,1.15,6698.64,2,3.0,-2232.82
23/08/2019 22:00:00,15/06/2023 18:58:12,Gemini_BTCUSD_1h_17_12_17_to_10_03_23.csv,BTC_USD,HOUR,109408.4,35.299,24/08/2019 02:00:00,24/08/2019 01:00:00,24/08/2019 01:00:00,EXPIRED,LONG,10395.0,10394.0,10580.97,10333.01,3.354,1.76,0.6,6564.56,2,3.0,-35.3
26/09/2022 18:00:00,15/06/2023 18:58:12,Gemini_BTCUSD_1h_17_12_17_to_10_03_23.csv,BTC_USD,HOUR,109373.1,21.849,26/09/2022 20:00:00,26/09/2022 21:00:00,26/09/2022 21:00:00,EXPIRED,LONG,19173.0,19089.0,19473.36,19072.88,3.83,1.54,0.52,6562.57,2,3.0,-1835.32
18/01/2020 00:00:00,15/06/2023 18:58:12,Gemini_BTCUSD_1h_17_12_17_to_10_03_23.csv,BTC_USD,HOUR,107537.78,12.783,18/01/2020 01:00:00,18/01/2020 03:00:00,18/01/2020 03:00:00,EXPIRED,LONG,8963.0,8915.0,9467.74,8794.75,1.065,5.33,1.91,6452.09,2,3.0,-613.58
24/02/2023 10:00:00,15/06/2023 18:58:12,Gemini_BTCUSD_1h_17_12_17_to_10_03_23.csv,BTC_USD,HOUR,106924.2,10.561,24/02/2023 13:00:00,24/02/2023 13:00:00,24/02/2023 13:00:00,EXPIRED,LONG,23864.0,23791.0,24471.45,23661.52,2.357,2.48,0.86,6415.28,2,3.0,-770.95
19/02/2019 15:00:00,15/06/2023 18:58:12,Gemini_BTCUSD_1h_17_12_17_to_10_03_23.csv,BTC_USD,HOUR,106153.25,105.625,19/02/2019 18:00:00,19/02/2019 18:00:00,19/02/2019 17:00:00,STOP_LOSS_HIT,LONG,3957.0,3936.9,4017.3,3936.9,3.937,1.5,0.51,6369.19,2,3.0,-2123.06
06/12/2019 15:00:00,15/06/2023 18:58:12,Gemini_BTCUSD_1h_17_12_17_to_10_03_23.csv,BTC_USD,HOUR,104030.19,24.23,06/12/2019 16:00:00,06/12/2019 18:00:00,06/12/2019 18:00:00,EXPIRED,LONG,7375.0,7450.0,7632.61,7289.13,1.718,3.38,1.18,6241.89,2,3.0,1817.25
27/01/2018 00:00:00,15/06/2023 18:58:12,Gemini_BTCUSD_1h_17_12_17_to_10_03_23.csv,BTC_USD,HOUR,105847.44,37.055,27/01/2018 04:00:00,27/01/2018 03:00:00,27/01/2018 01:00:00,STOP_LOSS_HIT,LONG,11118.0,11060.87,11289.39,11060.87,3.892,1.52,0.52,6350.86,2,3.0,-2116.95
28/12/2022 00:00:00,15/06/2023 18:58:12,Gemini_BTCUSD_1h_17_12_17_to_10_03_23.csv,BTC_USD,HOUR,103730.49,24.869,28/12/2022 02:00:00,28/12/2022 03:00:00,28/12/2022 03:00:00,STOP_LOSS_HIT,LONG,16680.0,16596.58,16930.25,16596.58,3.999,1.48,0.5,6223.47,2,3.0,-2074.57
30/11/2020 13:00:00,15/06/2023 18:58:12,Gemini_BTCUSD_1h_17_12_17_to_10_03_23.csv,BTC_USD,HOUR,101655.92,5.988,30/11/2020 14:00:00,30/11/2020 16:00:00,30/11/2020 16:00:00,EXPIRED,LONG,19191.0,19181.0,20209.65,18851.45,1.13,5.04,1.8,6099.68,2,3.0,-59.88
01/05/2020 05:00:00,15/06/2023 18:58:12,Gemini_BTCUSD_1h_17_12_17_to_10_03_23.csv,BTC_USD,HOUR,101596.04,36.87,01/05/2020 06:00:00,01/05/2020 08:00:00,01/05/2020 06:00:00,STOP_LOSS_HIT,LONG,8808.0,8752.89,8973.33,8752.89,3.196,1.84,0.63,6095.72,2,3.0,-2031.91
19/03/2021 05:00:00,15/06/2023 18:58:12,Gemini_BTCUSD_1h_17_12_17_to_10_03_23.csv,BTC_USD,HOUR,99564.13,6.536,19/03/2021 08:00:00,19/03/2021 08:00:00,19/03/2021 06:00:00,STOP_LOSS_HIT,LONG,58370.0,58065.33,59284.03,58065.33,3.832,1.54,0.52,5974.1,2,3.0,-1991.32
21/12/2020 18:00:00,15/06/2023 18:58:12,Gemini_BTCUSD_1h_17_12_17_to_10_03_23.csv,BTC_USD,HOUR,97572.81,15.649,21/12/2020 20:00:00,21/12/2020 21:00:00,21/12/2020 21:00:00,EXPIRED,LONG,22823.0,23154.0,23197.1,22698.3,3.66,1.61,0.55,5854.29,2,3.0,5179.82
08/03/2023 03:00:00,15/06/2023 18:58:12,Gemini_BTCUSD_1h_17_12_17_to_10_03_23.csv,BTC_USD,HOUR,102752.63,11.234,08/03/2023 07:00:00,08/03/2023 06:00:00,08/03/2023 05:00:00,STOP_LOSS_HIT,LONG,22148.0,21965.07,22696.8,21965.07,2.421,2.42,0.83,6165.22,2,3.0,-2055.04
28/08/2021 17:00:00,15/06/2023 18:58:12,Gemini_BTCUSD_1h_17_12_17_to_10_03_23.csv,BTC_USD,HOUR,100697.59,4.847,28/08/2021 20:00:00,28/08/2021 20:00:00,28/08/2021 19:00:00,STOP_LOSS_HIT,LONG,49050.0,48634.51,50296.48,48634.51,2.361,2.48,0.85,6041.69,2,3.0,-2013.88
28/04/2018 08:00:00,15/06/2023 18:58:12,Gemini_BTCUSD_1h_17_12_17_to_10_03_23.csv,BTC_USD,HOUR,98683.71,33.865,28/04/2018 09:00:00,28/04/2018 11:00:00,28/04/2018 09:00:00,STOP_LOSS_HIT,LONG,9236.0,9177.72,9410.83,9177.72,3.169,1.86,0.64,5920.62,2,3.0,-1973.65
13/09/2018 17:00:00,15/06/2023 18:58:12,Gemini_BTCUSD_1h_17_12_17_to_10_03_23.csv,BTC_USD,HOUR,96710.06,27.312,13/09/2018 18:00:00,13/09/2018 20:00:00,13/09/2018 20:00:00,STOP_LOSS_HIT,LONG,6502.0,6431.18,6714.45,6431.18,1.836,3.16,1.1,5802.43,2,3.0,-1934.24
12/05/2019 21:00:00,15/06/2023 18:58:12,Gemini_BTCUSD_1h_17_12_17_to_10_03_23.csv,BTC_USD,HOUR,94775.82,55.636,12/05/2019 22:00:00,13/05/2019 00:00:00,12/05/2019 22:00:00,STOP_LOSS_HIT,LONG,7151.0,7116.93,7253.21,7116.93,4.198,1.41,0.48,5686.56,2,3.0,-1895.52
21/08/2018 20:00:00,15/06/2023 18:58:12,Gemini_BTCUSD_1h_17_12_17_to_10_03_23.csv,BTC_USD,HOUR,92880.3,30.264,21/08/2018 21:00:00,21/08/2018 23:00:00,21/08/2018 23:00:00,EXPIRED,LONG,6446.0,6477.0,6630.14,6384.62,2.1,2.78,0.96,5572.81,2,3.0,938.18
11/09/2022 21:00:00,15/06/2023 18:58:12,Gemini_BTCUSD_1h_17_12_17_to_10_03_23.csv,BTC_USD,HOUR,93818.48,17.875,11/09/2022 23:00:00,12/09/2022 00:00:00,11/09/2022 22:00:00,STOP_LOSS_HIT,SHORT,21507.0,21611.97,21192.09,21611.97,4.098,1.49,0.49,5629.02,2,3.0,-1876.34
04/03/2022 10:00:00,15/06/2023 18:58:12,Gemini_BTCUSD_1h_17_12_17_to_10_03_23.csv,BTC_USD,HOUR,91942.14,3.699,04/03/2022 11:00:00,04/03/2022 13:00:00,04/03/2022 13:00:00,EXPIRED,LONG,41681.0,41297.0,43172.35,41183.88,1.677,3.45,1.21,5516.5,2,3.0,-1420.42
08/11/2021 20:00:00,15/06/2023 18:58:12,Gemini_BTCUSD_1h_17_12_17_to_10_03_23.csv,BTC_USD,HOUR,90521.72,2.353,08/11/2021 22:00:00,08/11/2021 23:00:00,08/11/2021 23:00:00,STOP_LOSS_HIT,SHORT,66062.0,66831.48,63753.58,66831.48,1.717,3.62,1.15,5431.71,2,3.0,-1810.59
08/08/2019 05:00:00,15/06/2023 18:58:12,Gemini_BTCUSD_1h_17_12_17_to_10_03_23.csv,BTC_USD,HOUR,88711.13,9.531,08/08/2019 07:00:00,08/08/2019 08:00:00,08/08/2019 08:00:00,EXPIRED,LONG,11929.0,11897.0,12487.45,11742.85,1.282,4.47,1.59,5322.59,2,3.0,-304.99
11/11/2019 01:00:00,15/06/2023 18:58:12,Gemini_BTCUSD_1h_17_12_17_to_10_03_23.csv,BTC_USD,HOUR,88406.14,11.137,11/11/2019 02:00:00,11/11/2019 04:00:00,11/11/2019 04:00:00,EXPIRED,LONG,9056.0,8937.0,9532.27,8897.24,1.141,5.0,1.78,5304.22,2,3.0,-1325.3
04/02/2020 21:00:00,15/06/2023 18:58:12,Gemini_BTCUSD_1h_17_12_17_to_10_03_23.csv,BTC_USD,HOUR,87080.84,33.538,04/02/2020 22:00:00,05/02/2020 00:00:00,05/02/2020 00:00:00,EXPIRED,LONG,9137.0,9200.0,9292.79,9085.07,3.519,1.68,0.57,5224.89,2,3.0,2112.89
04/11/2019 22:00:00,15/06/2023 18:58:12,Gemini_BTCUSD_1h_17_12_17_to_10_03_23.csv,BTC_USD,HOUR,89193.73,16.968,05/11/2019 00:00:00,05/11/2019 01:00:00,05/11/2019 01:00:00,EXPIRED,LONG,9381.0,9453.0,9696.4,9275.87,1.785,3.25,1.13,5351.71,2,3.0,1221.7
17/02/2018 10:00:00,15/06/2023 18:58:12,Gemini_BTCUSD_1h_17_12_17_to_10_03_23.csv,BTC_USD,HOUR,90415.43,34.216,17/02/2018 11:00:00,17/02/2018 13:00:00,17/02/2018 12:00:00,TAKE_PROFIT_HIT,LONG,10687.0,10845.56,10845.56,10634.15,4.044,1.46,0.5,5425.29,2,3.0,5425.29
10/05/2021 02:00:00,15/06/2023 18:58:12,Gemini_BTCUSD_1h_17_12_17_to_10_03_23.csv,BTC_USD,HOUR,95840.72,2.171,10/05/2021 04:00:00,10/05/2021 05:00:00,10/05/2021 05:00:00,EXPIRED,LONG,59047.0,59132.0,61695.57,58164.15,1.338,4.29,1.52,5750.05,2,3.0,184.54
03/11/2018 21:00:00,15/06/2023 18:58:12,Gemini_BTCUSD_1h_17_12_17_to_10_03_23.csv,BTC_USD,HOUR,96025.26,17.859,03/11/2018 22:00:00,04/11/2018 00:00:00,04/11/2018 00:00:00,EXPIRED,LONG,6333.0,6332.0,6655.61,6225.46,1.178,4.85,1.73,5761.49,2,3.0,-17.86
21/05/2018 10:00:00,15/06/2023 18:58:12,Gemini_BTCUSD_1h_17_12_17_to_10_03_23.csv,BTC_USD,HOUR,96007.4,40.553,21/05/2018 11:00:00,21/05/2018 13:00:00,21/05/2018 13:00:00,EXPIRED,LONG,8469.0,8491.0,8611.05,8421.65,3.577,1.65,0.56,5760.55,2,3.0,892.17
01/09/2021 00:00:00,15/06/2023 18:58:12,Gemini_BTCUSD_1h_17_12_17_to_10_03_23.csv,BTC_USD,HOUR,96899.57,3.713,01/09/2021 02:00:00,01/09/2021 03:00:00,01/09/2021 03:00:00,EXPIRED,SHORT,46778.0,47053.0,45212.01,47300.0,1.792,3.46,1.1,5814.52,2,3.0,-1021.07
06/05/2018 23:00:00,15/06/2023 18:58:12,Gemini_BTCUSD_1h_17_12_17_to_10_03_23.csv,BTC_USD,HOUR,95878.5,19.052,07/05/2018 00:00:00,07/05/2018 02:00:00,07/05/2018 02:00:00,TAKE_PROFIT_HIT,SHORT,9600.0,9298.06,9298.06,9700.65,1.908,3.25,1.04,5752.56,2,3.0,5752.56
06/04/2020 10:00:00,15/06/2023 18:58:12,Gemini_BTCUSD_1h_17_12_17_to_10_03_23.csv,BTC_USD,HOUR,101631.06,47.624,06/04/2020 14:00:00,06/04/2020 13:00:00,06/04/2020 13:00:00,EXPIRED,LONG,7089.0,7109.0,7217.05,7046.32,3.322,1.77,0.61,6098.25,2,3.0,952.48
07/09/2020 18:00:00,15/06/2023 18:58:12,Gemini_BTCUSD_1h_17_12_17_to_10_03_23.csv,BTC_USD,HOUR,102583.54,10.725,07/09/2020 20:00:00,07/09/2020 21:00:00,07/09/2020 21:00:00,EXPIRED,LONG,10168.0,10157.0,10741.91,9976.7,1.063,5.34,1.92,6155.18,2,3.0,-117.97
08/09/2022 14:00:00,15/06/2023 18:58:12,Gemini_BTCUSD_1h_17_12_17_to_10_03_23.csv,BTC_USD,HOUR,102465.57,7.583,08/09/2022 18:00:00,08/09/2022 17:00:00,08/09/2022 17:00:00,EXPIRED,LONG,19318.0,19197.0,20128.78,19047.74,1.43,4.03,1.42,6148.14,2,3.0,-917.54
21/01/2023 10:00:00,15/06/2023 18:58:12,Gemini_BTCUSD_1h_17_12_17_to_10_03_23.csv,BTC_USD,HOUR,101548.03,6152.969,21/01/2023 11:00:00,21/01/2023 13:00:00,21/01/2023 11:00:00,STOP_LOSS_HIT,LONG,22782.0,22781.67,22783.0,22781.67,1380.4,0.0,0.0,6152.97,2,3.0,-2030.48
01/03/2019 09:00:00,15/06/2023 18:58:12,Gemini_BTCUSD_1h_17_12_17_to_10_03_23.csv,BTC_USD,HOUR,99517.55,35.785,01/03/2019 10:00:00,01/03/2019 12:00:00,01/03/2019 12:00:00,EXPIRED,LONG,3813.0,3810.0,3979.87,3757.38,1.371,4.19,1.48,5971.44,2,3.0,-107.35
06/05/2019 15:00:00,15/06/2023 18:58:12,Gemini_BTCUSD_1h_17_12_17_to_10_03_23.csv,BTC_USD,HOUR,99410.2,42.932,06/05/2019 16:00:00,06/05/2019 18:00:00,06/05/2019 18:00:00,EXPIRED,LONG,5656.0,5743.0,5794.93,5609.69,2.443,2.4,0.83,5964.54,2,3.0,3735.08
25/02/2021 13:00:00,15/06/2023 18:58:12,Gemini_BTCUSD_1h_17_12_17_to_10_03_23.csv,BTC_USD,HOUR,103145.28,3.224,25/02/2021 14:00:00,25/02/2021 16:00:00,25/02/2021 14:00:00,STOP_LOSS_HIT,LONG,51374.0,50734.18,53293.48,50734.18,1.606,3.6,1.26,6188.4,2,3.0,-2062.78
05/03/2020 14:00:00,15/06/2023 18:58:12,Gemini_BTCUSD_1h_17_12_17_to_10_03_23.csv,BTC_USD,HOUR,101082.5,23.784,05/03/2020 16:00:00,05/03/2020 17:00:00,05/03/2020 16:00:00,STOP_LOSS_HIT,SHORT,9044.0,9129.0,8789.0,9129.0,2.128,2.9,0.93,6064.92,2,3.0,-2021.64
03/03/2021 01:00:00,15/06/2023 18:58:12,Gemini_BTCUSD_1h_17_12_17_to_10_03_23.csv,BTC_USD,HOUR,99060.86,2.804,03/03/2021 03:00:00,03/03/2021 04:00:00,03/03/2021 04:00:00,EXPIRED,LONG,48879.0,49170.0,50998.81,48172.4,1.384,4.16,1.47,5943.95,2,3.0,815.96
14/05/2018 01:00:00,15/06/2023 18:58:12,Gemini_BTCUSD_1h_17_12_17_to_10_03_23.csv,BTC_USD,HOUR,99876.82,40.395,14/05/2018 05:00:00,14/05/2018 04:00:00,14/05/2018 03:00:00,TAKE_PROFIT_HIT,SHORT,8700.0,8551.66,8551.66,8749.45,3.519,1.73,0.57,5992.19,2,3.0,5992.19
24/06/2022 11:00:00,15/06/2023 18:58:12,Gemini_BTCUSD_1h_17_12_17_to_10_03_23.csv,BTC_USD,HOUR,105869.01,16.931,24/06/2022 12:00:00,24/06/2022 14:00:00,24/06/2022 14:00:00,EXPIRED,LONG,21157.0,21107.0,21532.18,21031.94,3.384,1.74,0.59,6352.17,2,3.0,-846.55
02/05/2020 19:00:00,15/06/2023 18:58:12,Gemini_BTCUSD_1h_17_12_17_to_10_03_23.csv,BTC_USD,HOUR,105022.46,63.458,02/05/2020 23:00:00,02/05/2020 22:00:00,02/05/2020 22:00:00,EXPIRED,LONG,8877.0,8940.0,8976.29,8843.9,5.364,1.11,0.37,6300.74,2,3.0,3997.85
23/09/2018 13:00:00,15/06/2023 18:58:12,Gemini_BTCUSD_1h_17_12_17_to_10_03_23.csv,BTC_USD,HOUR,109020.31,59.331,23/09/2018 14:00:00,23/09/2018 16:00:00,23/09/2018 14:00:00,STOP_LOSS_HIT,LONG,6728.0,6691.25,6838.26,6691.25,3.662,1.61,0.55,6541.84,2,3.0,-2180.41
08/04/2019 04:00:00,15/06/2023 18:58:12,Gemini_BTCUSD_1h_17_12_17_to_10_03_23.csv,BTC_USD,HOUR,106839.9,25.219,08/04/2019 05:00:00,08/04/2019 07:00:00,08/04/2019 07:00:00,STOP_LOSS_HIT,LONG,5318.0,5233.27,5572.19,5233.27,1.255,4.56,1.62,6410.42,2,3.0,-2136.81
09/07/2022 22:00:00,15/06/2023 18:58:12,Gemini_BTCUSD_1h_17_12_17_to_10_03_23.csv,BTC_USD,HOUR,104703.09,10.256,10/07/2022 00:00:00,10/07/2022 01:00:00,10/07/2022 01:00:00,EXPIRED,SHORT,21621.0,21400.0,21008.47,21825.18,2.118,2.92,0.94,6282.11,2,3.0,2266.58
09/02/2018 17:00:00,15/06/2023 18:58:12,Gemini_BTCUSD_1h_17_12_17_to_10_03_23.csv,BTC_USD,HOUR,106969.67,28.102,09/02/2018 18:00:00,09/02/2018 20:00:00,09/02/2018 20:00:00,EXPIRED,LONG,8611.0,8565.0,8839.4,8534.87,2.262,2.58,0.89,6418.5,2,3.0,-1292.69
11/02/2018 12:00:00,15/06/2023 18:58:12,Gemini_BTCUSD_1h_17_12_17_to_10_03_23.csv,BTC_USD,HOUR,105676.98,13.708,11/02/2018 13:00:00,11/02/2018 15:00:00,11/02/2018 15:00:00,EXPIRED,LONG,8302.0,8433.0,8764.53,8147.82,1.077,5.28,1.89,6340.36,2,3.0,1795.75
25/10/2019 11:00:00,15/06/2023 18:58:12,Gemini_BTCUSD_1h_17_12_17_to_10_03_23.csv,BTC_USD,HOUR,107472.73,26.996,25/10/2019 12:00:00,25/10/2019 14:00:00,25/10/2019 13:00:00,STOP_LOSS_HIT,SHORT,7584.0,7663.62,7345.15,7663.62,1.905,3.25,1.04,6447.99,2,3.0,-2149.42
06/09/2022 00:00:00,15/06/2023 18:58:12,Gemini_BTCUSD_1h_17_12_17_to_10_03_23.csv,BTC_USD,HOUR,105323.31,17.481,06/09/2022 01:00:00,06/09/2022 03:00:00,06/09/2022 01:00:00,STOP_LOSS_HIT,LONG,20100.0,19979.5,20461.49,19979.5,3.336,1.77,0.6,6319.21,2,3.0,-2106.46
13/01/2019 13:00:00,15/06/2023 18:58:12,Gemini_BTCUSD_1h_17_12_17_to_10_03_23.csv,BTC_USD,HOUR,103216.85,88.56,13/01/2019 15:00:00,13/01/2019 16:00:00,13/01/2019 16:00:00,TAKE_PROFIT_HIT,SHORT,3622.0,3552.08,3552.08,3645.31,3.108,1.97,0.64,6192.12,2,3.0,6192.12
17/11/2021 22:00:00,15/06/2023 18:58:12,Gemini_BTCUSD_1h_17_12_17_to_10_03_23.csv,BTC_USD,HOUR,109408.97,7.185,18/11/2021 02:00:00,18/11/2021 01:00:00,18/11/2021 01:00:00,TAKE_PROFIT_HIT,LONG,59985.0,60898.62,60898.62,59680.46,3.939,1.5,0.51,6564.36,2,3.0,6564.36
25/03/2021 18:00:00,15/06/2023 18:58:12,Gemini_BTCUSD_1h_17_12_17_to_10_03_23.csv,BTC_USD,HOUR,115973.33,11.962,25/03/2021 22:00:00,25/03/2021 21:00:00,25/03/2021 19:00:00,STOP_LOSS_HIT,LONG,52240.0,52046.1,52821.72,52046.1,5.388,1.1,0.37,6958.53,2,3.0,-2319.43
29/01/2021 11:00:00,15/06/2023 18:58:12,Gemini_BTCUSD_1h_17_12_17_to_10_03_23.csv,BTC_USD,HOUR,113653.9,7.629,29/01/2021 12:00:00,29/01/2021 14:00:00,29/01/2021 12:00:00,STOP_LOSS_HIT,LONG,37126.0,36828.06,38019.81,36828.06,2.492,2.35,0.81,6818.88,2,3.0,-2272.98
04/07/2019 03:00:00,15/06/2023 18:58:12,Gemini_BTCUSD_1h_17_12_17_to_10_03_23.csv,BTC_USD,HOUR,111380.92,32.149,04/07/2019 05:00:00,04/07/2019 06:00:00,04/07/2019 04:00:00,TAKE_PROFIT_HIT,SHORT,11900.0,11692.14,11692.14,11969.29,3.435,1.78,0.58,6682.49,2,3.0,6682.49
11/03/2021 23:00:00,15/06/2023 18:58:12,Gemini_BTCUSD_1h_17_12_17_to_10_03_23.csv,BTC_USD,HOUR,118063.41,2.679,12/03/2021 00:00:00,12/03/2021 02:00:00,12/03/2021 00:00:00,STOP_LOSS_HIT,LONG,57822.0,56940.59,60466.25,56940.59,1.312,4.37,1.55,7083.95,2,3.0,-2361.3
06/03/2020 10:00:00,15/06/2023 18:58:12,Gemini_BTCUSD_1h_17_12_17_to_10_03_23.csv,BTC_USD,HOUR,115702.11,19.993,06/03/2020 11:00:00,06/03/2020 13:00:00,06/03/2020 13:00:00,EXPIRED,LONG,9156.0,9068.0,9503.23,9040.26,1.582,3.65,1.28,6942.17,2,3.0,-1759.38
22/05/2020 05:00:00,15/06/2023 18:58:12,Gemini_BTCUSD_1h_17_12_17_to_10_03_23.csv,BTC_USD,HOUR,113942.73,52.376,22/05/2020 08:00:00,22/05/2020 08:00:00,22/05/2020 06:00:00,STOP_LOSS_HIT,SHORT,9035.0,9078.51,8904.48,9078.51,4.153,1.47,0.48,6836.12,2,3.0,-2278.88
04/01/2020 10:00:00,15/06/2023 18:58:12,Gemini_BTCUSD_1h_17_12_17_to_10_03_23.csv,BTC_USD,HOUR,111663.85,58.77,04/01/2020 11:00:00,04/01/2020 13:00:00,04/01/2020 13:00:00,EXPIRED,SHORT,7300.0,7289.0,7185.99,7338.0,3.842,1.59,0.52,6700.37,2,3.0,646.47
26/01/2020 07:00:00,15/06/2023 18:58:12,Gemini_BTCUSD_1h_17_12_17_to_10_03_23.csv,BTC_USD,HOUR,112310.32,22.132,26/01/2020 08:00:00,26/01/2020 10:00:00,26/01/2020 10:00:00,EXPIRED,LONG,8357.0,8416.0,8661.46,8255.51,1.647,3.52,1.23,6738.31,2,3.0,1305.79
22/08/2018 06:00:00,15/06/2023 18:58:12,Gemini_BTCUSD_1h_17_12_17_to_10_03_23.csv,BTC_USD,HOUR,113616.11,37.509,22/08/2018 08:00:00,22/08/2018 09:00:00,22/08/2018 09:00:00,EXPIRED,SHORT,6680.0,6665.0,6498.25,6740.58,2.205,2.8,0.9,6817.26,2,3.0,562.64
05/02/2019 12:00:00,15/06/2023 18:58:12,Gemini_BTCUSD_1h_17_12_17_to_10_03_23.csv,BTC_USD,HOUR,114178.75,69.6,05/02/2019 15:00:00,05/02/2019 15:00:00,05/02/2019 15:00:00,EXPIRED,SHORT,3421.0,3420.0,3322.58,3453.81,2.085,2.96,0.95,6850.03,2,3.0,69.6
14/05/2020 22:00:00,15/06/2023 18:58:12,Gemini_BTCUSD_1h_17_12_17_to_10_03_23.csv,BTC_USD,HOUR,114248.35,13.811,15/05/2020 00:00:00,15/05/2020 01:00:00,15/05/2020 01:00:00,EXPIRED,LONG,9762.0,9745.0,10258.35,9596.55,1.18,4.84,1.72,6855.09,2,3.0,-234.79
15/01/2018 04:00:00,15/06/2023 18:58:12,Gemini_BTCUSD_1h_17_12_17_to_10_03_23.csv,BTC_USD,HOUR,114013.56,32.824,15/01/2018 07:00:00,15/01/2018 07:00:00,15/01/2018 05:00:00,STOP_LOSS_HIT,LONG,13601.0,13531.53,13809.41,13531.53,3.916,1.51,0.51,6840.85,2,3.0,-2280.28
05/12/2022 02:00:00,15/06/2023 18:58:12,Gemini_BTCUSD_1h_17_12_17_to_10_03_23.csv,BTC_USD,HOUR,111733.28,6.997,05/12/2022 03:00:00,05/12/2022 05:00:00,05/12/2022 05:00:00,EXPIRED,LONG,17252.0,17344.0,18210.18,16932.61,1.08,5.26,1.89,6704.39,2,3.0,643.72
11/01/2022 19:00:00,15/06/2023 18:58:12,Gemini_BTCUSD_1h_17_12_17_to_10_03_23.csv,BTC_USD,HOUR,112377.0,3.424,11/01/2022 20:00:00,11/01/2022 22:00:00,11/01/2022 22:00:00,EXPIRED,LONG,43003.0,42732.0,44972.49,42346.51,1.31,4.38,1.55,6743.53,2,3.0,-927.9
23/05/2019 13:00:00,15/06/2023 18:58:12,Gemini_BTCUSD_1h_17_12_17_to_10_03_23.csv,BTC_USD,HOUR,111449.1,57.611,23/05/2019 15:00:00,23/05/2019 16:00:00,23/05/2019 14:00:00,STOP_LOSS_HIT,SHORT,7669.0,7707.69,7552.93,7707.69,3.964,1.54,0.5,6686.91,2,3.0,-2228.97
05/02/2021 13:00:00,15/06/2023 18:58:12,Gemini_BTCUSD_1h_17_12_17_to_10_03_23.csv,BTC_USD,HOUR,109220.13,3.508,05/02/2021 16:00:00,05/02/2021 16:00:00,05/02/2021 16:00:00,STOP_LOSS_HIT,LONG,38342.0,37719.23,40210.31,37719.23,1.231,4.65,1.65,6554.03,2,3.0,-2184.68
16/11/2019 04:00:00,15/06/2023 18:58:12,Gemini_BTCUSD_1h_17_12_17_to_10_03_23.csv,BTC_USD,HOUR,107035.45,50.275,16/11/2019 06:00:00,16/11/2019 07:00:00,16/11/2019 07:00:00,EXPIRED,SHORT,8461.0,8471.0,8333.26,8503.58,3.974,1.53,0.5,6422.13,2,3.0,-502.75
13/03/2021 08:00:00,15/06/2023 18:58:12,Gemini_BTCUSD_1h_17_12_17_to_10_03_23.csv,BTC_USD,HOUR,106532.7,2.167,13/03/2021 09:00:00,13/03/2021 11:00:00,13/03/2021 11:00:00,EXPIRED,LONG,57409.0,59798.0,60358.96,56425.69,1.168,4.89,1.74,6392.56,2,3.0,5176.96
17/11/2020 16:00:00,15/06/2023 18:58:12,Gemini_BTCUSD_1h_17_12_17_to_10_03_23.csv,BTC_USD,HOUR,111709.66,14.543,17/11/2020 18:00:00,17/11/2020 19:00:00,17/11/2020 17:00:00,STOP_LOSS_HIT,LONG,17663.0,17509.37,18123.91,17509.37,2.299,2.54,0.88,6703.01,2,3.0,-2234.24
28/03/2022 10:00:00,15/06/2023 18:58:12,Gemini_BTCUSD_1h_17_12_17_to_10_03_23.csv,BTC_USD,HOUR,109475.42,3.735,28/03/2022 11:00:00,28/03/2022 13:00:00,28/03/2022 13:00:00,EXPIRED,LONG,47234.0,47764.0,48992.46,46647.85,1.611,3.59,1.26,6567.85,2,3.0,1979.55
06/12/2021 17:00:00,15/06/2023 18:58:12,Gemini_BTCUSD_1h_17_12_17_to_10_03_23.csv,BTC_USD,HOUR,111454.97,4.072,06/12/2021 18:00:00,06/12/2021 20:00:00,06/12/2021 20:00:00,EXPIRED,LONG,49019.0,48867.0,50661.36,48471.55,1.791,3.24,1.13,6687.69,2,3.0,-618.94
03/12/2019 16:00:00,15/06/2023 18:58:13,Gemini_BTCUSD_1h_17_12_17_to_10_03_23.csv,BTC_USD,HOUR,110836.03,35.53,03/12/2019 17:00:00,03/12/2019 19:00:00,03/12/2019 19:00:00,EXPIRED,LONG,7330.0,7334.0,7517.17,7267.61,2.35,2.49,0.86,6650.15,2,3.0,142.12
16/01/2023 04:00:00,15/06/2023 18:58:13,Gemini_BTCUSD_1h_17_12_17_to_10_03_23.csv,BTC_USD,HOUR,110978.15,5.843,16/01/2023 05:00:00,16/01/2023 07:00:00,16/01/2023 07:00:00,EXPIRED,LONG,21164.0,21129.0,22303.61,20784.13,1.114,5.11,1.83,6658.74,2,3.0,-204.5
25/02/2019 16:00:00,15/06/2023 18:58:13,Gemini_BTCUSD_1h_17_12_17_to_10_03_23.csv,BTC_USD,HOUR,110773.65,997.974,25/02/2019 17:00:00,25/02/2019 19:00:00,25/02/2019 17:00:00,STOP_LOSS_HIT,LONG,3831.0,3828.78,3837.67,3828.78,34.514,0.17,0.06,6656.49,2,3.0,-2215.5
09/04/2018 00:00:00,15/06/2023 18:58:13,Gemini_BTCUSD_1h_17_12_17_to_10_03_23.csv,BTC_USD,HOUR,108558.15,53.596,09/04/2018 02:00:00,09/04/2018 03:00:00,09/04/2018 03:00:00,EXPIRED,LONG,7060.0,7128.0,7181.52,7019.49,3.486,1.69,0.58,6512.99,2,3.0,3644.53
03/07/2022 16:00:00,15/06/2023 18:58:13,Gemini_BTCUSD_1h_17_12_17_to_10_03_23.csv,BTC_USD,HOUR,112202.68,22.51,03/07/2022 20:00:00,03/07/2022 19:00:00,03/07/2022 19:00:00,TAKE_PROFIT_HIT,LONG,19134.0,19433.06,19433.06,19034.31,3.839,1.54,0.52,6731.84,2,3.0,6731.84
21/12/2019 17:00:00,15/06/2023 18:58:13,Gemini_BTCUSD_1h_17_12_17_to_10_03_23.csv,BTC_USD,HOUR,118934.52,24.963,21/12/2019 18:00:00,21/12/2019 20:00:00,21/12/2019 20:00:00,EXPIRED,LONG,7155.0,7153.0,7440.86,7059.71,1.502,3.84,1.35,7135.92,2,3.0,-49.93
04/09/2018 18:00:00,15/06/2023 18:58:13,Gemini_BTCUSD_1h_17_12_17_to_10_03_23.csv,BTC_USD,HOUR,118884.59,61.076,04/09/2018 19:00:00,04/09/2018 21:00:00,04/09/2018 21:00:00,EXPIRED,LONG,7344.0,7358.0,7460.79,7305.07,3.773,1.57,0.53,7133.07,2,3.0,855.06
29/04/2020 02:00:00,15/06/2023 18:58:13,Gemini_BTCUSD_1h_17_12_17_to_10_03_23.csv,BTC_USD,HOUR,119739.65,22.862,29/04/2020 05:00:00,29/04/2020 05:00:00,29/04/2020 05:00:00,EXPIRED,LONG,7802.0,7876.0,8116.25,7697.25,1.49,3.87,1.36,7184.38,2,3.0,1691.79
08/12/2021 19:00:00,15/06/2023 18:58:13,Gemini_BTCUSD_1h_17_12_17_to_10_03_23.csv,BTC_USD,HOUR,121431.44,3.624,08/12/2021 21:00:00,08/12/2021 22:00:00,08/12/2021 22:00:00,EXPIRED,SHORT,50481.0,50247.0,48470.31,51151.23,1.507,4.15,1.31,7286.74,2,3.0,848.02
19/03/2018 03:00:00,15/06/2023 18:58:13,Gemini_BTCUSD_1h_17_12_17_to_10_03_23.csv,BTC_USD,HOUR,122279.46,42.064,19/03/2018 06:00:00,19/03/2018 06:00:00,19/03/2018 05:00:00,TAKE_PROFIT_HIT,LONG,8174.0,8348.42,8348.42,8115.86,2.812,2.09,0.72,7336.8,2,3.0,7336.8
14/03/2019 00:00:00,15/06/2023 18:58:13,Gemini_BTCUSD_1h_17_12_17_to_10_03_23.csv,BTC_USD,HOUR,129616.26,42.483,14/03/2019 04:00:00,14/03/2019 03:00:00,14/03/2019 03:00:00,EXPIRED,LONG,3859.0,3851.0,4042.05,3797.98,1.265,4.53,1.61,7776.51,2,3.0,-339.86
17/11/2019 19:00:00,15/06/2023 18:58:13,Gemini_BTCUSD_1h_17_12_17_to_10_03_23.csv,BTC_USD,HOUR,129276.4,62.619,17/11/2019 20:00:00,17/11/2019 22:00:00,17/11/2019 22:00:00,EXPIRED,LONG,8554.0,8543.0,8677.88,8512.71,4.143,1.43,0.49,7757.24,2,3.0,-688.81
13/12/2019 18:00:00,15/06/2023 18:58:13,Gemini_BTCUSD_1h_17_12_17_to_10_03_23.csv,BTC_USD,HOUR,128587.59,40.906,13/12/2019 20:00:00,13/12/2019 21:00:00,13/12/2019 21:00:00,EXPIRED,LONG,7233.0,7240.0,7421.6,7170.13,2.301,2.54,0.88,7714.87,2,3.0,286.34
26/06/2020 13:00:00,15/06/2023 18:58:13,Gemini_BTCUSD_1h_17_12_17_to_10_03_23.csv,BTC_USD,HOUR,128873.93,26.245,26/06/2020 14:00:00,26/06/2020 16:00:00,26/06/2020 14:00:00,STOP_LOSS_HIT,LONG,9138.0,9039.79,9432.64,9039.79,1.861,3.12,1.09,7732.83,2,3.0,-2577.52
13/12/2022 02:00:00,15/06/2023 18:58:13,Gemini_BTCUSD_1h_17_12_17_to_10_03_23.csv,BTC_USD,HOUR,126296.41,21.264,13/12/2022 06:00:00,13/12/2022 05:00:00,13/12/2022 05:00:00,EXPIRED,LONG,17146.0,17191.0,17502.36,17027.21,2.887,2.04,0.7,7577.64,2,3.0,956.88
04/10/2019 01:00:00,15/06/2023 18:58:13,Gemini_BTCUSD_1h_17_12_17_to_10_03_23.csv,BTC_USD,HOUR,127253.29,37.66,04/10/2019 05:00:00,04/10/2019 04:00:00,04/10/2019 04:00:00,EXPIRED,LONG,8128.0,8071.0,8330.73,8060.42,2.405,2.43,0.84,7634.81,2,3.0,-2146.62
19/03/2021 11:00:00,15/06/2023 18:58:13,Gemini_BTCUSD_1h_17_12_17_to_10_03_23.csv,BTC_USD,HOUR,125106.67,3.437,19/03/2021 12:00:00,19/03/2021 14:00:00,19/03/2021 13:00:00,STOP_LOSS_HIT,LONG,58850.0,58121.92,61034.25,58121.92,1.617,3.58,1.25,7507.27,2,3.0,-2502.41
10/10/2019 20:00:00,15/06/2023 18:58:13,Gemini_BTCUSD_1h_17_12_17_to_10_03_23.csv,BTC_USD,HOUR,122604.26,49.328,11/10/2019 00:00:00,10/10/2019 23:00:00,10/10/2019 23:00:00,EXPIRED,LONG,8586.0,8590.0,8735.13,8536.29,3.454,1.71,0.58,7356.28,2,3.0,197.31
31/12/2020 23:00:00,15/06/2023 18:58:13,Gemini_BTCUSD_1h_17_12_17_to_10_03_23.csv,BTC_USD,HOUR,122801.57,14.607,01/01/2021 01:00:00,01/01/2021 02:00:00,01/01/2021 01:00:00,STOP_LOSS_HIT,SHORT,28980.0,29148.14,28475.58,29148.14,3.447,1.77,0.58,7368.06,2,3.0,-2456.02
09/09/2022 11:00:00,15/06/2023 18:58:13,Gemini_BTCUSD_1h_17_12_17_to_10_03_23.csv,BTC_USD,HOUR,120345.55,24.648,09/09/2022 12:00:00,09/09/2022 14:00:00,09/09/2022 12:00:00,TAKE_PROFIT_HIT,LONG,20948.0,21240.95,21240.95,20850.35,4.29,1.38,0.47,7220.63,2,3.0,7220.63
01/07/2022 19:00:00,15/06/2023 18:58:13,Gemini_BTCUSD_1h_17_12_17_to_10_03_23.csv,BTC_USD,HOUR,127566.18,21.765,01/07/2022 20:00:00,01/07/2022 22:00:00,01/07/2022 22:00:00,EXPIRED,LONG,19376.0,19272.0,19727.65,19258.78,3.306,1.78,0.61,7653.66,2,3.0,-2263.56
25/11/2021 01:00:00,15/06/2023 18:58:13,Gemini_BTCUSD_1h_17_12_17_to_10_03_23.csv,BTC_USD,HOUR,125302.62,8.516,25/11/2021 02:00:00,25/11/2021 04:00:00,25/11/2021 04:00:00,STOP_LOSS_HIT,LONG,57765.0,57470.71,58647.89,57470.71,3.926,1.51,0.51,7518.69,2,3.0,-2506.17
22/11/2020 22:00:00,15/06/2023 18:58:13,Gemini_BTCUSD_1h_17_12_17_to_10_03_23.csv,BTC_USD,HOUR,122796.45,25.625,23/11/2020 01:00:00,23/11/2020 01:00:00,22/11/2020 23:00:00,STOP_LOSS_HIT,LONG,18652.0,18556.16,18939.53,18556.16,3.892,1.52,0.52,7367.96,2,3.0,-2455.9
25/05/2022 03:00:00,15/06/2023 18:58:13,Gemini_BTCUSD_1h_17_12_17_to_10_03_23.csv,BTC_USD,HOUR,120340.55,8.13,25/05/2022 04:00:00,25/05/2022 06:00:00,25/05/2022 05:00:00,STOP_LOSS_HIT,LONG,30146.0,29849.96,31034.12,29849.96,2.037,2.86,0.99,7220.42,2,3.0,-2406.81
15/05/2019 02:00:00,15/06/2023 18:58:13,Gemini_BTCUSD_1h_17_12_17_to_10_03_23.csv,BTC_USD,HOUR,117933.74,16.284,15/05/2019 03:00:00,15/05/2019 05:00:00,15/05/2019 05:00:00,EXPIRED,LONG,8072.0,8026.0,8506.56,7927.15,1.115,5.11,1.83,7076.38,2,3.0,-749.06
29/06/2019 21:00:00,15/06/2023 18:58:13,Gemini_BTCUSD_1h_17_12_17_to_10_03_23.csv,BTC_USD,HOUR,117184.68,17.619,29/06/2019 22:00:00,30/06/2019 00:00:00,30/06/2019 00:00:00,EXPIRED,LONG,11943.0,12128.0,12342.06,11809.98,1.796,3.23,1.13,7031.04,2,3.0,3259.52
03/08/2022 17:00:00,15/06/2023 18:58:13,Gemini_BTCUSD_1h_17_12_17_to_10_03_23.csv,BTC_USD,HOUR,120444.2,9.026,03/08/2022 21:00:00,03/08/2022 20:00:00,03/08/2022 20:00:00,EXPIRED,LONG,23454.0,23330.0,24254.64,23187.12,1.758,3.3,1.15,7226.58,2,3.0,-1119.22
09/11/2019 15:00:00,15/06/2023 18:58:13,Gemini_BTCUSD_1h_17_12_17_to_10_03_23.csv,BTC_USD,HOUR,119324.98,53.774,09/11/2019 16:00:00,09/11/2019 18:00:00,09/11/2019 16:00:00,STOP_LOSS_HIT,LONG,8801.0,8756.62,8934.14,8756.62,3.966,1.49,0.51,7159.47,2,3.0,-2386.49
09/05/2018 09:00:00,15/06/2023 18:58:13,Gemini_BTCUSD_1h_17_12_17_to_10_03_23.csv,BTC_USD,HOUR,116938.49,53.888,09/05/2018 11:00:00,09/05/2018 12:00:00,09/05/2018 10:00:00,STOP_LOSS_HIT,SHORT,9099.0,9142.4,8968.81,9142.4,4.193,1.45,0.47,7015.68,2,3.0,-2338.74
05/04/2019 04:00:00,15/06/2023 18:58:13,Gemini_BTCUSD_1h_17_12_17_to_10_03_23.csv,BTC_USD,HOUR,114599.75,88.426,05/04/2019 07:00:00,05/04/2019 07:00:00,05/04/2019 07:00:00,EXPIRED,LONG,4949.0,4940.0,5026.76,4923.08,3.819,1.55,0.53,6876.01,2,3.0,-795.83
09/06/2019 09:00:00,15/06/2023 18:58:13,Gemini_BTCUSD_1h_17_12_17_to_10_03_23.csv,BTC_USD,HOUR,113803.92,25.248,09/06/2019 10:00:00,09/06/2019 12:00:00,09/06/2019 12:00:00,STOP_LOSS_HIT,LONG,7902.0,7811.85,8172.44,7811.85,1.753,3.31,1.15,6828.07,2,3.0,-2276.11
28/11/2022 20:00:00,15/06/2023 18:58:13,Gemini_BTCUSD_1h_17_12_17_to_10_03_23.csv,BTC_USD,HOUR,111527.81,15.505,28/11/2022 21:00:00,28/11/2022 23:00:00,28/11/2022 23:00:00,EXPIRED,LONG,16244.0,16212.0,16675.58,16100.14,2.258,2.59,0.89,6691.65,2,3.0,-496.16
25/01/2023 20:00:00,15/06/2023 18:58:13,Gemini_BTCUSD_1h_17_12_17_to_10_03_23.csv,BTC_USD,HOUR,111031.65,7.598,25/01/2023 22:00:00,25/01/2023 23:00:00,25/01/2023 23:00:00,EXPIRED,LONG,22941.0,23054.0,23817.75,22648.75,1.57,3.68,1.29,6661.55,2,3.0,858.57
20/01/2023 14:00:00,15/06/2023 18:58:13,Gemini_BTCUSD_1h_17_12_17_to_10_03_23.csv,BTC_USD,HOUR,111890.22,21.466,20/01/2023 16:00:00,20/01/2023 17:00:00,20/01/2023 17:00:00,EXPIRED,LONG,21150.0,21358.0,21462.76,21045.75,4.058,1.46,0.5,6713.71,2,3.0,4464.93
04/04/2019 13:00:00,15/06/2023 18:58:13,Gemini_BTCUSD_1h_17_12_17_to_10_03_23.csv,BTC_USD,HOUR,116355.15,51.991,04/04/2019 14:00:00,04/04/2019 16:00:00,04/04/2019 15:00:00,STOP_LOSS_HIT,LONG,5014.0,4969.24,5148.27,4969.24,2.24,2.61,0.9,6980.83,2,3.0,-2327.12
03/04/2018 05:00:00,15/06/2023 18:58:13,Gemini_BTCUSD_1h_17_12_17_to_10_03_23.csv,BTC_USD,HOUR,114028.03,20.702,03/04/2018 06:00:00,03/04/2018 08:00:00,03/04/2018 08:00:00,EXPIRED,LONG,7333.0,7343.0,7663.49,7222.84,1.331,4.31,1.53,6841.8,2,3.0,207.02
15/10/2018 05:00:00,15/06/2023 18:58:13,Gemini_BTCUSD_1h_17_12_17_to_10_03_23.csv,BTC_USD,HOUR,114235.05,68.879,15/10/2018 07:00:00,15/10/2018 08:00:00,15/10/2018 06:00:00,TAKE_PROFIT_HIT,LONG,6354.0,6453.51,6453.51,6320.83,3.831,1.54,0.52,6854.15,2,3.0,6854.15
16/03/2022 16:00:00,15/06/2023 18:58:13,Gemini_BTCUSD_1h_17_12_17_to_10_03_23.csv,BTC_USD,HOUR,121089.2,11.897,16/03/2022 18:00:00,16/03/2022 19:00:00,16/03/2022 17:00:00,STOP_LOSS_HIT,LONG,40324.0,40120.43,40934.71,40120.43,3.962,1.49,0.51,7265.62,2,3.0,-2421.87
23/11/2021 13:00:00,15/06/2023 18:58:13,Gemini_BTCUSD_1h_17_12_17_to_10_03_23.csv,BTC_USD,HOUR,118667.33,6.899,23/11/2021 14:00:00,23/11/2021 16:00:00,23/11/2021 16:00:00,EXPIRED,LONG,56786.0,57475.0,57818.03,56441.99,3.301,1.78,0.61,7119.97,2,3.0,4753.41
18/01/2022 19:00:00,15/06/2023 18:58:13,Gemini_BTCUSD_1h_17_12_17_to_10_03_23.csv,BTC_USD,HOUR,123420.74,3.32,18/01/2022 20:00:00,18/01/2022 22:00:00,18/01/2022 22:00:00,EXPIRED,LONG,41708.0,42504.0,43938.51,40964.5,1.122,5.08,1.81,7405.29,2,3.0,2642.72
04/06/2020 02:00:00,15/06/2023 18:58:13,Gemini_BTCUSD_1h_17_12_17_to_10_03_23.csv,BTC_USD,HOUR,126063.46,19.138,04/06/2020 03:00:00,04/06/2020 05:00:00,04/06/2020 05:00:00,EXPIRED,LONG,9674.0,9645.0,10069.22,9542.26,1.469,3.93,1.38,7563.72,2,3.0,-555.0
27/08/2018 20:00:00,15/06/2023 18:58:13,Gemini_BTCUSD_1h_17_12_17_to_10_03_23.csv,BTC_USD,HOUR,125508.46,46.253,27/08/2018 22:00:00,27/08/2018 23:00:00,27/08/2018 23:00:00,STOP_LOSS_HIT,SHORT,6722.0,6776.27,6559.19,6776.27,2.477,2.48,0.8,7530.45,2,3.0,-2510.15
02/05/2018 01:00:00,15/06/2023 18:58:13,Gemini_BTCUSD_1h_17_12_17_to_10_03_23.csv,BTC_USD,HOUR,122998.31,52.835,02/05/2018 05:00:00,02/05/2018 04:00:00,02/05/2018 04:00:00,EXPIRED,LONG,9025.0,9074.0,9164.67,8978.44,3.877,1.52,0.52,7379.46,2,3.0,2588.92
11/01/2021 10:00:00,15/06/2023 18:58:13,Gemini_BTCUSD_1h_17_12_17_to_10_03_23.csv,BTC_USD,HOUR,125587.23,8.147,11/01/2021 13:00:00,11/01/2021 13:00:00,11/01/2021 11:00:00,STOP_LOSS_HIT,LONG,35368.0,35059.69,36292.93,35059.69,2.294,2.55,0.88,7535.4,2,3.0,-2511.8
28/11/2018 09:00:00,15/06/2023 18:58:13,Gemini_BTCUSD_1h_17_12_17_to_10_03_23.csv,BTC_USD,HOUR,123075.43,53.05,28/11/2018 11:00:00,28/11/2018 12:00:00,28/11/2018 11:00:00,STOP_LOSS_HIT,SHORT,3972.0,4018.4,3832.8,4018.4,1.712,3.63,1.15,7384.56,2,3.0,-2461.52
17/07/2018 21:00:00,15/06/2023 18:58:13,Gemini_BTCUSD_1h_17_12_17_to_10_03_23.csv,BTC_USD,HOUR,120613.91,67.082,17/07/2018 22:00:00,18/07/2018 00:00:00,17/07/2018 22:00:00,STOP_LOSS_HIT,LONG,7352.0,7316.04,7459.87,7316.04,4.089,1.45,0.49,7236.14,2,3.0,-2412.27
02/08/2021 18:00:00,15/06/2023 18:58:13,Gemini_BTCUSD_1h_17_12_17_to_10_03_23.csv,BTC_USD,HOUR,118201.64,4.48,02/08/2021 20:00:00,02/08/2021 21:00:00,02/08/2021 19:00:00,STOP_LOSS_HIT,LONG,39650.0,39122.35,41232.95,39122.35,1.503,3.84,1.35,7091.62,2,3.0,-2363.87
27/07/2020 18:00:00,15/06/2023 18:58:13,Gemini_BTCUSD_1h_17_12_17_to_10_03_23.csv,BTC_USD,HOUR,115837.77,13.38,27/07/2020 19:00:00,27/07/2020 21:00:00,27/07/2020 21:00:00,EXPIRED,LONG,10864.0,11124.0,11383.47,10690.85,1.255,4.56,1.62,6950.51,2,3.0,3478.8
02/02/2021 02:00:00,15/06/2023 18:58:13,Gemini_BTCUSD_1h_17_12_17_to_10_03_23.csv,BTC_USD,HOUR,119316.57,3.943,02/02/2021 04:00:00,02/02/2021 05:00:00,02/02/2021 05:00:00,EXPIRED,LONG,33701.0,34016.0,35516.49,33095.84,1.114,5.11,1.83,7158.48,2,3.0,1242.05
05/12/2022 03:00:00,15/06/2023 18:58:13,Gemini_BTCUSD_1h_17_12_17_to_10_03_23.csv,BTC_USD,HOUR,120558.62,21.75,05/12/2022 04:00:00,05/12/2022 06:00:00,05/12/2022 06:00:00,EXPIRED,LONG,17202.0,17314.0,17534.59,17091.14,3.103,1.9,0.65,7233.83,2,3.0,2436.0
12/07/2020 06:00:00,15/06/2023 18:58:13,Gemini_BTCUSD_1h_17_12_17_to_10_03_23.csv,BTC_USD,HOUR,122994.62,22.209,12/07/2020 10:00:00,12/07/2020 09:00:00,12/07/2020 09:00:00,EXPIRED,LONG,9260.0,9266.0,9592.27,9149.24,1.672,3.46,1.21,7379.38,2,3.0,133.25
30/12/2020 10:00:00,15/06/2023 18:58:13,Gemini_BTCUSD_1h_17_12_17_to_10_03_23.csv,BTC_USD,HOUR,123127.87,16.863,30/12/2020 12:00:00,30/12/2020 13:00:00,30/12/2020 13:00:00,STOP_LOSS_HIT,SHORT,27849.0,27995.03,27410.9,27995.03,3.814,1.6,0.52,7387.68,2,3.0,-2462.5
14/05/2020 10:00:00,15/06/2023 18:58:13,Gemini_BTCUSD_1h_17_12_17_to_10_03_23.csv,BTC_USD,HOUR,120665.37,13.475,14/05/2020 11:00:00,14/05/2020 13:00:00,14/05/2020 13:00:00,EXPIRED,LONG,9652.0,9630.0,10189.27,9472.91,1.078,5.27,1.89,7239.71,2,3.0,-296.45
24/10/2020 17:00:00,15/06/2023 18:58:13,Gemini_BTCUSD_1h_17_12_17_to_10_03_23.csv,BTC_USD,HOUR,120368.92,31.966,24/10/2020 18:00:00,24/10/2020 20:00:00,24/10/2020 20:00:00,EXPIRED,LONG,13147.0,13121.0,13372.93,13071.69,3.491,1.69,0.58,7222.08,2,3.0,-831.12
13/04/2022 00:00:00,15/06/2023 18:58:13,Gemini_BTCUSD_1h_17_12_17_to_10_03_23.csv,BTC_USD,HOUR,119537.8,3.787,13/04/2022 01:00:00,13/04/2022 03:00:00,13/04/2022 03:00:00,EXPIRED,LONG,39951.0,40087.0,41845.09,39319.64,1.266,4.53,1.61,7172.92,2,3.0,515.03
11/02/2020 13:00:00,15/06/2023 18:58:13,Gemini_BTCUSD_1h_17_12_17_to_10_03_23.csv,BTC_USD,HOUR,120052.83,13.585,11/02/2020 14:00:00,11/02/2020 16:00:00,11/02/2020 16:00:00,EXPIRED,LONG,9861.0,10261.0,10391.22,9684.26,1.116,5.1,1.83,7203.04,2,3.0,5434.0
12/11/2020 06:00:00,15/06/2023 18:58:13,Gemini_BTCUSD_1h_17_12_17_to_10_03_23.csv,BTC_USD,HOUR,125486.83,27.787,12/11/2020 07:00:00,12/11/2020 09:00:00,12/11/2020 09:00:00,TAKE_PROFIT_HIT,LONG,15816.0,16086.97,16086.97,15725.68,3.502,1.68,0.57,7529.44,2,3.0,7529.44
12/05/2019 23:00:00,15/06/2023 18:58:13,Gemini_BTCUSD_1h_17_12_17_to_10_03_23.csv,BTC_USD,HOUR,133016.27,35.984,13/05/2019 00:00:00,13/05/2019 02:00:00,13/05/2019 00:00:00,STOP_LOSS_HIT,LONG,6976.0,6902.07,7197.8,6902.07,1.887,3.08,1.07,7981.25,2,3.0,-2660.3
07/11/2019 01:00:00,15/06/2023 18:58:13,Gemini_BTCUSD_1h_17_12_17_to_10_03_23.csv,BTC_USD,HOUR,130355.97,16.949,07/11/2019 03:00:00,07/11/2019 04:00:00,07/11/2019 04:00:00,EXPIRED,LONG,9326.0,9300.0,9787.47,9172.18,1.213,4.71,1.68,7821.46,2,3.0,-440.67
20/01/2019 21:00:00,15/06/2023 18:58:13,Gemini_BTCUSD_1h_17_12_17_to_10_03_23.csv,BTC_USD,HOUR,129915.3,134.977,21/01/2019 01:00:00,21/01/2019 00:00:00,21/01/2019 00:00:00,EXPIRED,LONG,3539.0,3534.0,3596.74,3519.75,3.677,1.61,0.55,7793.57,2,3.0,-674.88
24/06/2019 15:00:00,15/06/2023 18:58:13,Gemini_BTCUSD_1h_17_12_17_to_10_03_23.csv,BTC_USD,HOUR,129240.42,29.731,24/06/2019 19:00:00,24/06/2019 18:00:00,24/06/2019 16:00:00,STOP_LOSS_HIT,SHORT,10918.0,11004.94,10657.2,11004.94,2.512,2.45,0.79,7753.84,2,3.0,-2584.81
20/06/2022 17:00:00,15/06/2023 18:58:13,Gemini_BTCUSD_1h_17_12_17_to_10_03_23.csv,BTC_USD,HOUR,126655.61,25.15,20/06/2022 21:00:00,20/06/2022 20:00:00,20/06/2022 18:00:00,STOP_LOSS_HIT,SHORT,19959.0,20059.72,19656.85,20059.72,3.963,1.54,0.5,7599.07,2,3.0,-2533.11
22/12/2018 20:00:00,15/06/2023 18:58:13,Gemini_BTCUSD_1h_17_12_17_to_10_03_23.csv,BTC_USD,HOUR,124122.5,32.003,22/12/2018 21:00:00,22/12/2018 23:00:00,22/12/2018 23:00:00,EXPIRED,LONG,3891.0,3979.0,4123.72,3813.43,1.003,5.64,2.03,7447.74,2,3.0,2816.26
03/07/2019 04:00:00,15/06/2023 18:58:13,Gemini_BTCUSD_1h_17_12_17_to_10_03_23.csv,BTC_USD,HOUR,126938.76,40.228,03/07/2019 06:00:00,03/07/2019 07:00:00,03/07/2019 05:00:00,STOP_LOSS_HIT,SHORT,11282.0,11345.11,11092.66,11345.11,3.575,1.71,0.56,7616.77,2,3.0,-2538.79
23/06/2022 10:00:00,15/06/2023 18:58:13,Gemini_BTCUSD_1h_17_12_17_to_10_03_23.csv,BTC_USD,HOUR,124399.97,6.181,23/06/2022 11:00:00,23/06/2022 13:00:00,23/06/2022 13:00:00,EXPIRED,LONG,20682.0,20448.0,21889.54,20279.49,1.028,5.52,1.98,7463.8,2,3.0,-1446.35
10/03/2021 14:00:00,15/06/2023 18:58:13,Gemini_BTCUSD_1h_17_12_17_to_10_03_23.csv,BTC_USD,HOUR,122953.62,3.11,10/03/2021 15:00:00,10/03/2021 17:00:00,10/03/2021 17:00:00,EXPIRED,LONG,56230.0,56921.0,58602.27,55439.24,1.422,4.05,1.43,7377.76,2,3.0,2149.01
01/08/2020 12:00:00,15/06/2023 18:58:13,Gemini_BTCUSD_1h_17_12_17_to_10_03_23.csv,BTC_USD,HOUR,125102.63,22.523,01/08/2020 13:00:00,01/08/2020 15:00:00,01/08/2020 13:00:00,STOP_LOSS_HIT,LONG,11680.0,11568.91,12013.27,11568.91,2.103,2.77,0.96,7506.24,2,3.0,-2502.08
08/12/2020 01:00:00,15/06/2023 18:58:13,Gemini_BTCUSD_1h_17_12_17_to_10_03_23.csv,BTC_USD,HOUR,122600.55,7.12,08/12/2020 03:00:00,08/12/2020 04:00:00,08/12/2020 04:00:00,EXPIRED,LONG,19230.0,19190.0,20263.13,18885.63,1.117,5.1,1.82,7355.89,2,3.0,-284.8
06/09/2020 04:00:00,15/06/2023 18:58:13,Gemini_BTCUSD_1h_17_12_17_to_10_03_23.csv,BTC_USD,HOUR,122315.75,45.513,06/09/2020 05:00:00,06/09/2020 07:00:00,06/09/2020 05:00:00,STOP_LOSS_HIT,SHORT,10039.0,10092.75,9877.76,10092.75,3.735,1.63,0.53,7338.52,2,3.0,-2446.32
28/04/2018 02:00:00,15/06/2023 18:58:13,Gemini_BTCUSD_1h_17_12_17_to_10_03_23.csv,BTC_USD,HOUR,119869.43,51.193,28/04/2018 06:00:00,28/04/2018 05:00:00,28/04/2018 05:00:00,EXPIRED,LONG,9055.0,9139.0,9195.49,9008.17,3.867,1.53,0.52,7192.1,2,3.0,4300.21
14/02/2021 23:00:00,15/06/2023 18:58:13,Gemini_BTCUSD_1h_17_12_17_to_10_03_23.csv,BTC_USD,HOUR,124169.64,10.338,15/02/2021 00:00:00,15/02/2021 02:00:00,15/02/2021 01:00:00,STOP_LOSS_HIT,LONG,48649.0,48408.78,49369.67,48408.78,4.05,1.46,0.5,7450.29,2,3.0,-2483.39
05/11/2022 00:00:00,15/06/2023 18:58:13,Gemini_BTCUSD_1h_17_12_17_to_10_03_23.csv,BTC_USD,HOUR,121686.25,9.207,05/11/2022 02:00:00,05/11/2022 03:00:00,05/11/2022 03:00:00,EXPIRED,LONG,21418.0,21455.0,22210.98,21153.68,1.621,3.57,1.25,7300.97,2,3.0,340.66
06/02/2022 12:00:00,15/06/2023 18:58:13,Gemini_BTCUSD_1h_17_12_17_to_10_03_23.csv,BTC_USD,HOUR,122026.91,8.696,06/02/2022 14:00:00,06/02/2022 15:00:00,06/02/2022 14:00:00,STOP_LOSS_HIT,SHORT,41637.0,41917.64,40795.1,41917.64,2.967,2.06,0.67,7321.16,2,3.0,-2440.45
14/01/2022 19:00:00,15/06/2023 18:58:13,Gemini_BTCUSD_1h_17_12_17_to_10_03_23.csv,BTC_USD,HOUR,119586.46,10.365,14/01/2022 20:00:00,14/01/2022 22:00:00,14/01/2022 21:00:00,STOP_LOSS_HIT,SHORT,43100.0,43330.75,42407.75,43330.75,3.736,1.63,0.53,7175.17,2,3.0,-2391.72
19/12/2019 12:00:00,15/06/2023 18:58:13,Gemini_BTCUSD_1h_17_12_17_to_10_03_23.csv,BTC_USD,HOUR,117194.74,20.444,19/12/2019 13:00:00,19/12/2019 15:00:00,19/12/2019 14:00:00,STOP_LOSS_HIT,LONG,7182.0,7067.35,7525.94,7067.35,1.253,4.57,1.62,7031.51,2,3.0,-2343.9
19/02/2021 10:00:00,15/06/2023 18:58:13,Gemini_BTCUSD_1h_17_12_17_to_10_03_23.csv,BTC_USD,HOUR,114850.84,5.328,19/02/2021 11:00:00,19/02/2021 13:00:00,19/02/2021 13:00:00,EXPIRED,LONG,52657.0,52793.0,53950.28,52225.91,2.443,2.4,0.83,6890.6,2,3.0,724.61
14/10/2018 20:00:00,15/06/2023 18:58:13,Gemini_BTCUSD_1h_17_12_17_to_10_03_23.csv,BTC_USD,HOUR,115575.45,69.499,15/10/2018 00:00:00,14/10/2018 23:00:00,14/10/2018 23:00:00,STOP_LOSS_HIT,LONG,6218.0,6184.74,6317.79,6184.74,3.739,1.58,0.54,6935.31,2,3.0,-2311.54
18/10/2019 20:00:00,15/06/2023 18:58:13,Gemini_BTCUSD_1h_17_12_17_to_10_03_23.csv,BTC_USD,HOUR,113263.91,16.549,18/10/2019 21:00:00,18/10/2019 23:00:00,18/10/2019 23:00:00,EXPIRED,LONG,7945.0,7961.0,8355.63,7808.12,1.161,4.91,1.75,6795.52,2,3.0,264.78
07/01/2022 10:00:00,15/06/2023 18:58:13,Gemini_BTCUSD_1h_17_12_17_to_10_03_23.csv,BTC_USD,HOUR,113528.69,3.602,07/01/2022 12:00:00,07/01/2022 13:00:00,07/01/2022 13:00:00,STOP_LOSS_HIT,LONG,42170.0,41539.6,44061.21,41539.6,1.338,4.29,1.52,6812.14,2,3.0,-2270.7
04/10/2019 10:00:00,15/06/2023 18:58:13,Gemini_BTCUSD_1h_17_12_17_to_10_03_23.csv,BTC_USD,HOUR,111257.99,46.079,04/10/2019 11:00:00,04/10/2019 13:00:00,04/10/2019 11:00:00,STOP_LOSS_HIT,SHORT,8128.0,8176.29,7983.12,8176.29,3.366,1.81,0.59,6675.93,2,3.0,-2225.15
14/02/2019 23:00:00,15/06/2023 18:58:13,Gemini_BTCUSD_1h_17_12_17_to_10_03_23.csv,BTC_USD,HOUR,109032.84,97.875,15/02/2019 01:00:00,15/02/2019 02:00:00,15/02/2019 02:00:00,EXPIRED,SHORT,3562.0,3572.0,3495.16,3584.28,3.197,1.91,0.62,6541.97,2,3.0,-978.75
21/06/2021 02:00:00,15/06/2023 18:58:13,Gemini_BTCUSD_1h_17_12_17_to_10_03_23.csv,BTC_USD,HOUR,108054.09,12.772,21/06/2021 03:00:00,21/06/2021 05:00:00,21/06/2021 03:00:00,STOP_LOSS_HIT,LONG,35137.0,34967.8,35644.6,34967.8,4.153,1.42,0.48,6483.07,2,3.0,-2161.02
16/03/2022 20:00:00,15/06/2023 18:58:13,Gemini_BTCUSD_1h_17_12_17_to_10_03_23.csv,BTC_USD,HOUR,105893.07,11.052,16/03/2022 21:00:00,16/03/2022 23:00:00,16/03/2022 23:00:00,EXPIRED,SHORT,41245.0,41143.0,40670.11,41436.63,4.305,1.41,0.46,6353.68,2,3.0,1127.3
02/05/2022 10:00:00,15/06/2023 18:58:13,Gemini_BTCUSD_1h_17_12_17_to_10_03_23.csv,BTC_USD,HOUR,107020.37,10.434,02/05/2022 11:00:00,02/05/2022 13:00:00,02/05/2022 11:00:00,STOP_LOSS_HIT,LONG,38701.0,38495.86,39316.43,38495.86,3.773,1.57,0.53,6421.4,2,3.0,-2140.43
17/02/2021 18:00:00,15/06/2023 18:58:13,Gemini_BTCUSD_1h_17_12_17_to_10_03_23.csv,BTC_USD,HOUR,104879.94,2.575,17/02/2021 19:00:00,17/02/2021 21:00:00,17/02/2021 21:00:00,EXPIRED,LONG,51413.0,52412.0,53856.8,50598.4,1.262,4.54,1.61,6292.79,2,3.0,2572.43
26/09/2019 23:00:00,15/06/2023 18:58:13,Gemini_BTCUSD_1h_17_12_17_to_10_03_23.csv,BTC_USD,HOUR,107452.37,22.617,27/09/2019 01:00:00,27/09/2019 02:00:00,27/09/2019 00:00:00,STOP_LOSS_HIT,LONG,8065.0,7969.98,8350.06,7969.98,1.698,3.41,1.19,6447.2,2,3.0,-2149.07
18/10/2020 00:00:00,15/06/2023 18:58:13,Gemini_BTCUSD_1h_17_12_17_to_10_03_23.csv,BTC_USD,HOUR,105303.3,38.078,18/10/2020 01:00:00,18/10/2020 03:00:00,18/10/2020 03:00:00,EXPIRED,LONG,11383.0,11378.0,11548.93,11327.69,4.116,1.44,0.49,6318.28,2,3.0,-190.39
13/12/2021 09:00:00,15/06/2023 18:58:13,Gemini_BTCUSD_1h_17_12_17_to_10_03_23.csv,BTC_USD,HOUR,105112.91,8.901,13/12/2021 10:00:00,13/12/2021 12:00:00,13/12/2021 12:00:00,EXPIRED,SHORT,48892.0,48614.0,48183.44,49128.19,4.14,1.47,0.48,6306.89,2,3.0,2474.48
13/03/2021 12:00:00,15/06/2023 18:58:13,Gemini_BTCUSD_1h_17_12_17_to_10_03_23.csv,BTC_USD,HOUR,107587.39,7.072,13/03/2021 15:00:00,13/03/2021 15:00:00,13/03/2021 13:00:00,STOP_LOSS_HIT,LONG,59896.0,59591.74,60808.8,59591.74,3.937,1.5,0.51,6455.32,2,3.0,-2151.73
03/08/2022 11:00:00,15/06/2023 18:58:13,Gemini_BTCUSD_1h_17_12_17_to_10_03_23.csv,BTC_USD,HOUR,105435.66,16.037,03/08/2022 13:00:00,03/08/2022 14:00:00,03/08/2022 12:00:00,STOP_LOSS_HIT,LONG,23415.0,23283.51,23809.49,23283.51,3.561,1.66,0.56,6326.44,2,3.0,-2108.71
24/08/2019 04:00:00,15/06/2023 18:58:13,Gemini_BTCUSD_1h_17_12_17_to_10_03_23.csv,BTC_USD,HOUR,103326.95,25.662,24/08/2019 07:00:00,24/08/2019 07:00:00,24/08/2019 07:00:00,EXPIRED,SHORT,10354.0,10317.0,10112.4,10434.53,2.571,2.39,0.77,6199.94,2,3.0,949.49
08/02/2022 04:00:00,15/06/2023 18:58:13,Gemini_BTCUSD_1h_17_12_17_to_10_03_23.csv,BTC_USD,HOUR,104276.44,3.023,08/02/2022 05:00:00,08/02/2022 07:00:00,08/02/2022 07:00:00,EXPIRED,LONG,44408.0,44908.0,46477.99,43718.01,1.287,4.45,1.58,6257.58,2,3.0,1511.5
30/01/2018 07:00:00,15/06/2023 18:58:13,Gemini_BTCUSD_1h_17_12_17_to_10_03_23.csv,BTC_USD,HOUR,105787.94,38.44,30/01/2018 11:00:00,30/01/2018 10:00:00,30/01/2018 09:00:00,STOP_LOSS_HIT,LONG,11005.0,10949.96,11170.11,10949.96,3.999,1.48,0.5,6346.83,2,3.0,-2115.74
23/08/2018 07:00:00,15/06/2023 18:58:13,Gemini_BTCUSD_1h_17_12_17_to_10_03_23.csv,BTC_USD,HOUR,103672.2,59.719,23/08/2018 08:00:00,23/08/2018 10:00:00,23/08/2018 10:00:00,EXPIRED,LONG,6430.0,6420.0,6534.17,6395.28,3.704,1.59,0.54,6220.93,2,3.0,-597.19
13/02/2021 04:00:00,15/06/2023 18:58:13,Gemini_BTCUSD_1h_17_12_17_to_10_03_23.csv,BTC_USD,HOUR,103075.01,2.554,13/02/2021 05:00:00,13/02/2021 07:00:00,13/02/2021 07:00:00,STOP_LOSS_HIT,LONG,47972.0,47164.96,50393.14,47164.96,1.189,4.8,1.71,6183.59,2,3.0,-2061.18
17/01/2018 03:00:00,15/06/2023 18:58:13,Gemini_BTCUSD_1h_17_12_17_to_10_03_23.csv,BTC_USD,HOUR,101013.83,29.571,17/01/2018 07:00:00,17/01/2018 06:00:00,17/01/2018 04:00:00,STOP_LOSS_HIT,SHORT,10999.0,11067.32,10794.03,11067.32,3.22,1.9,0.62,6061.17,2,3.0,-2020.29
10/03/2023 09:00:00,15/06/2023 18:58:13,Gemini_BTCUSD_1h_17_12_17_to_10_03_23.csv,BTC_USD,HOUR,98993.54,8.255,10/03/2023 13:00:00,10/03/2023 12:00:00,10/03/2023 10:00:00,STOP_LOSS_HIT,LONG,19828.0,19588.15,20547.56,19588.15,1.653,3.5,1.22,5939.97,2,3.0,-1979.96
23/03/2018 10:00:00,15/06/2023 18:58:13,Gemini_BTCUSD_1h_17_12_17_to_10_03_23.csv,BTC_USD,HOUR,97013.58,36.444,23/03/2018 12:00:00,23/03/2018 13:00:00,23/03/2018 12:00:00,STOP_LOSS_HIT,LONG,8480.0,8426.76,8639.72,8426.76,3.186,1.85,0.63,5820.84,2,3.0,-1940.28
10/11/2021 02:00:00,15/06/2023 18:58:13,Gemini_BTCUSD_1h_17_12_17_to_10_03_23.csv,BTC_USD,HOUR,95073.3,5.556,10/11/2021 04:00:00,10/11/2021 05:00:00,10/11/2021 05:00:00,EXPIRED,SHORT,66805.0,66371.0,65778.26,67147.25,3.904,1.56,0.51,5704.57,2,3.0,2411.3
03/11/2021 03:00:00,15/06/2023 18:58:13,Gemini_BTCUSD_1h_17_12_17_to_10_03_23.csv,BTC_USD,HOUR,97484.6,3.753,03/11/2021 07:00:00,03/11/2021 06:00:00,03/11/2021 06:00:00,EXPIRED,SHORT,63258.0,62890.0,61699.48,63777.51,2.435,2.53,0.81,5849.13,2,3.0,1381.1
05/06/2020 10:00:00,15/06/2023 18:58:13,Gemini_BTCUSD_1h_17_12_17_to_10_03_23.csv,BTC_USD,HOUR,98865.7,39.475,05/06/2020 11:00:00,05/06/2020 13:00:00,05/06/2020 11:00:00,STOP_LOSS_HIT,LONG,9709.0,9658.91,9859.26,9658.91,3.877,1.52,0.52,5931.51,2,3.0,-1977.3
04/05/2020 22:00:00,15/06/2023 18:58:13,Gemini_BTCUSD_1h_17_12_17_to_10_03_23.csv,BTC_USD,HOUR,96888.4,17.176,04/05/2020 23:00:00,05/05/2020 01:00:00,05/05/2020 01:00:00,EXPIRED,LONG,8882.0,8894.0,9220.46,8769.18,1.575,3.67,1.29,5813.39,2,3.0,206.11
25/04/2021 13:00:00,15/06/2023 18:58:13,Gemini_BTCUSD_1h_17_12_17_to_10_03_23.csv,BTC_USD,HOUR,97094.51,2.526,25/04/2021 17:00:00,25/04/2021 16:00:00,25/04/2021 16:00:00,EXPIRED,LONG,49939.0,50453.0,52245.28,49170.24,1.299,4.41,1.56,5825.66,2,3.0,1298.36
23/07/2018 05:00:00,15/06/2023 18:58:13,Gemini_BTCUSD_1h_17_12_17_to_10_03_23.csv,BTC_USD,HOUR,98392.87,42.521,23/07/2018 06:00:00,23/07/2018 08:00:00,23/07/2018 07:00:00,TAKE_PROFIT_HIT,LONG,7636.0,7774.84,7774.84,7589.72,3.3,1.79,0.61,5903.62,2,3.0,5903.62
09/11/2020 11:00:00,15/06/2023 18:58:13,Gemini_BTCUSD_1h_17_12_17_to_10_03_23.csv,BTC_USD,HOUR,104296.49,12.982,09/11/2020 12:00:00,09/11/2020 14:00:00,09/11/2020 12:00:00,STOP_LOSS_HIT,LONG,15814.0,15653.32,16296.04,15653.32,1.968,2.96,1.03,6257.84,2,3.0,-2085.95
31/08/2022 03:00:00,15/06/2023 18:58:13,Gemini_BTCUSD_1h_17_12_17_to_10_03_23.csv,BTC_USD,HOUR,102210.54,12.44,31/08/2022 04:00:00,31/08/2022 06:00:00,31/08/2022 06:00:00,STOP_LOSS_HIT,LONG,20414.0,20249.67,20907.0,20249.67,2.485,2.36,0.81,6132.92,2,3.0,-2044.27
21/10/2020 12:00:00,15/06/2023 18:58:13,Gemini_BTCUSD_1h_17_12_17_to_10_03_23.csv,BTC_USD,HOUR,100166.27,9.038,21/10/2020 16:00:00,21/10/2020 15:00:00,21/10/2020 15:00:00,EXPIRED,LONG,12424.0,12752.0,13088.97,12202.35,1.121,5.08,1.82,6010.0,2,3.0,2964.46
29/04/2019 18:00:00,15/06/2023 18:58:13,Gemini_BTCUSD_1h_17_12_17_to_10_03_23.csv,BTC_USD,HOUR,103130.73,63.154,29/04/2019 22:00:00,29/04/2019 21:00:00,29/04/2019 21:00:00,EXPIRED,SHORT,5154.0,5138.0,5056.01,5186.66,3.156,1.94,0.63,6188.46,2,3.0,1010.46
06/12/2019 14:00:00,15/06/2023 18:58:13,Gemini_BTCUSD_1h_17_12_17_to_10_03_23.csv,BTC_USD,HOUR,104141.19,32.754,06/12/2019 18:00:00,06/12/2019 17:00:00,06/12/2019 17:00:00,STOP_LOSS_HIT,SHORT,7384.0,7447.59,7193.24,7447.59,2.322,2.65,0.85,6248.15,2,3.0,-2082.83
10/04/2018 04:00:00,15/06/2023 18:58:13,Gemini_BTCUSD_1h_17_12_17_to_10_03_23.csv,BTC_USD,HOUR,102058.36,54.344,10/04/2018 06:00:00,10/04/2018 07:00:00,10/04/2018 07:00:00,EXPIRED,SHORT,6763.0,6723.0,6650.33,6800.56,3.601,1.69,0.55,6122.94,2,3.0,2173.76
26/06/2019 03:00:00,15/06/2023 18:58:13,Gemini_BTCUSD_1h_17_12_17_to_10_03_23.csv,BTC_USD,HOUR,104232.12,13.689,26/06/2019 07:00:00,26/06/2019 06:00:00,26/06/2019 05:00:00,TAKE_PROFIT_HIT,LONG,12250.0,12706.88,12706.88,12097.71,1.609,3.6,1.26,6254.23,2,3.0,6254.23
09/09/2019 05:00:00,15/06/2023 18:58:13,Gemini_BTCUSD_1h_17_12_17_to_10_03_23.csv,BTC_USD,HOUR,110486.35,42.593,09/09/2019 07:00:00,09/09/2019 08:00:00,09/09/2019 07:00:00,TAKE_PROFIT_HIT,SHORT,10308.0,10152.37,10152.37,10359.88,3.974,1.53,0.5,6628.75,2,3.0,6628.75
17/05/2018 00:00:00,15/06/2023 18:58:13,Gemini_BTCUSD_1h_17_12_17_to_10_03_23.csv,BTC_USD,HOUR,117115.1,16.733,17/05/2018 01:00:00,17/05/2018 03:00:00,17/05/2018 03:00:00,EXPIRED,LONG,8350.0,8363.0,8769.94,8210.02,1.193,4.79,1.7,7026.86,2,3.0,217.53
27/04/2019 18:00:00,15/06/2023 18:58:13,Gemini_BTCUSD_1h_17_12_17_to_10_03_23.csv,BTC_USD,HOUR,117332.63,22.538,27/04/2019 19:00:00,27/04/2019 21:00:00,27/04/2019 21:00:00,EXPIRED,LONG,5176.0,5212.0,5488.37,5071.88,0.994,5.69,2.05,7040.2,2,3.0,811.37
13/01/2022 10:00:00,15/06/2023 18:58:13,Gemini_BTCUSD_1h_17_12_17_to_10_03_23.csv,BTC_USD,HOUR,118144.0,9.728,13/01/2022 13:00:00,13/01/2022 13:00:00,13/01/2022 13:00:00,EXPIRED,SHORT,43817.0,43955.0,43088.31,44059.9,3.608,1.69,0.55,7088.7,2,3.0,-1342.46
31/08/2021 08:00:00,15/06/2023 18:58:13,Gemini_BTCUSD_1h_17_12_17_to_10_03_23.csv,BTC_USD,HOUR,116801.54,3.013,31/08/2021 09:00:00,31/08/2021 11:00:00,31/08/2021 11:00:00,EXPIRED,SHORT,47745.0,47976.0,45419.43,48520.19,1.232,5.12,1.6,7006.94,2,3.0,-696.0
03/06/2019 22:00:00,15/06/2023 18:58:13,Gemini_BTCUSD_1h_17_12_17_to_10_03_23.csv,BTC_USD,HOUR,116105.54,49.114,03/06/2019 23:00:00,04/06/2019 01:00:00,03/06/2019 23:00:00,STOP_LOSS_HIT,LONG,8479.0,8431.72,8620.85,8431.72,3.587,1.65,0.56,6966.82,2,3.0,-2322.11
17/01/2023 12:00:00,15/06/2023 18:58:13,Gemini_BTCUSD_1h_17_12_17_to_10_03_23.csv,BTC_USD,HOUR,113783.43,9.43,17/01/2023 13:00:00,17/01/2023 15:00:00,17/01/2023 15:00:00,EXPIRED,LONG,21262.0,21189.0,21985.98,21020.68,1.762,3.29,1.15,6827.13,2,3.0,-688.39
05/11/2022 06:00:00,15/06/2023 18:58:13,Gemini_BTCUSD_1h_17_12_17_to_10_03_23.csv,BTC_USD,HOUR,113095.04,14.855,05/11/2022 09:00:00,05/11/2022 09:00:00,05/11/2022 08:00:00,STOP_LOSS_HIT,LONG,21408.0,21255.73,21864.81,21255.73,2.812,2.09,0.72,6785.91,2,3.0,-2261.97
12/11/2021 14:00:00,15/06/2023 18:58:13,Gemini_BTCUSD_1h_17_12_17_to_10_03_23.csv,BTC_USD,HOUR,110833.07,2.744,12/11/2021 17:00:00,12/11/2021 17:00:00,12/11/2021 17:00:00,EXPIRED,LONG,63486.0,63192.0,65909.67,62678.11,1.572,3.68,1.29,6650.55,2,3.0,-806.74
12/11/2019 17:00:00,15/06/2023 18:58:13,Gemini_BTCUSD_1h_17_12_17_to_10_03_23.csv,BTC_USD,HOUR,110026.33,42.35,12/11/2019 19:00:00,12/11/2019 20:00:00,12/11/2019 20:00:00,STOP_LOSS_HIT,SHORT,8727.0,8778.96,8571.12,8778.96,3.359,1.82,0.59,6601.52,2,3.0,-2200.51
23/01/2022 07:00:00,15/06/2023 18:58:13,Gemini_BTCUSD_1h_17_12_17_to_10_03_23.csv,BTC_USD,HOUR,107825.82,2.882,23/01/2022 09:00:00,23/01/2022 10:00:00,23/01/2022 10:00:00,EXPIRED,LONG,35618.0,35924.0,37862.64,34869.79,0.952,5.93,2.15,6469.05,2,3.0,881.89
09/11/2020 10:00:00,15/06/2023 18:58:13,Gemini_BTCUSD_1h_17_12_17_to_10_03_23.csv,BTC_USD,HOUR,108707.71,27.643,09/11/2020 12:00:00,09/11/2020 13:00:00,09/11/2020 11:00:00,STOP_LOSS_HIT,SHORT,15487.0,15565.65,15251.06,15565.65,3.938,1.55,0.51,6522.09,2,3.0,-2174.12
08/02/2018 03:00:00,15/06/2023 18:58:13,Gemini_BTCUSD_1h_17_12_17_to_10_03_23.csv,BTC_USD,HOUR,106533.59,19.101,08/02/2018 05:00:00,08/02/2018 06:00:00,08/02/2018 06:00:00,EXPIRED,LONG,7973.0,8027.0,8307.66,7861.45,1.43,4.03,1.42,6392.34,2,3.0,1031.45
01/01/2023 18:00:00,15/06/2023 18:58:13,Gemini_BTCUSD_1h_17_12_17_to_10_03_23.csv,BTC_USD,HOUR,107565.04,7.563,01/01/2023 19:00:00,01/01/2023 21:00:00,01/01/2023 21:00:00,EXPIRED,LONG,16593.0,16603.0,17446.32,16308.56,1.167,4.89,1.74,6453.66,2,3.0,75.63
18/07/2021 02:00:00,15/06/2023 18:58:13,Gemini_BTCUSD_1h_17_12_17_to_10_03_23.csv,BTC_USD,HOUR,107640.67,12.206,18/07/2021 05:00:00,18/07/2021 05:00:00,18/07/2021 05:00:00,EXPIRED,LONG,32212.0,32070.0,32741.1,32035.63,3.653,1.62,0.55,6458.19,2,3.0,-1733.25
24/11/2022 19:00:00,15/06/2023 18:58:13,Gemini_BTCUSD_1h_17_12_17_to_10_03_23.csv,BTC_USD,HOUR,105907.42,7.35,24/11/2022 20:00:00,24/11/2022 22:00:00,24/11/2022 22:00:00,EXPIRED,LONG,16554.0,16595.0,17418.58,16265.81,1.149,4.96,1.77,6354.66,2,3.0,301.35
01/05/2022 16:00:00,15/06/2023 18:58:13,Gemini_BTCUSD_1h_17_12_17_to_10_03_23.csv,BTC_USD,HOUR,106208.77,3.437,01/05/2022 17:00:00,01/05/2022 19:00:00,01/05/2022 19:00:00,EXPIRED,SHORT,38505.0,37808.0,36651.11,39122.97,1.246,5.06,1.58,6371.82,2,3.0,2395.59
17/08/2022 04:00:00,15/06/2023 18:58:13,Gemini_BTCUSD_1h_17_12_17_to_10_03_23.csv,BTC_USD,HOUR,108604.36,4.765,17/08/2022 05:00:00,17/08/2022 07:00:00,17/08/2022 07:00:00,EXPIRED,LONG,24072.0,23815.0,25439.49,23616.17,1.056,5.38,1.93,6516.09,2,3.0,-1224.6
19/03/2021 16:00:00,15/06/2023 18:58:13,Gemini_BTCUSD_1h_17_12_17_to_10_03_23.csv,BTC_USD,HOUR,107379.76,4.155,19/03/2021 17:00:00,19/03/2021 19:00:00,19/03/2021 18:00:00,STOP_LOSS_HIT,LONG,58874.0,58357.11,60424.67,58357.11,2.278,2.57,0.89,6443.03,2,3.0,-2147.68
06/11/2018 02:00:00,15/06/2023 18:58:13,Gemini_BTCUSD_1h_17_12_17_to_10_03_23.csv,BTC_USD,HOUR,105232.08,58.724,06/11/2018 04:00:00,06/11/2018 05:00:00,06/11/2018 05:00:00,EXPIRED,LONG,6402.0,6393.0,6509.53,6366.16,3.573,1.65,0.56,6314.59,2,3.0,-528.52
30/10/2018 13:00:00,15/06/2023 18:58:13,Gemini_BTCUSD_1h_17_12_17_to_10_03_23.csv,BTC_USD,HOUR,104703.56,57.309,30/10/2018 16:00:00,30/10/2018 16:00:00,30/10/2018 16:00:00,EXPIRED,LONG,6256.0,6259.0,6365.63,6219.46,3.424,1.72,0.59,6282.79,2,3.0,171.93
13/07/2019 18:00:00,15/06/2023 18:58:13,Gemini_BTCUSD_1h_17_12_17_to_10_03_23.csv,BTC_USD,HOUR,104875.49,30.946,13/07/2019 20:00:00,13/07/2019 21:00:00,13/07/2019 19:00:00,STOP_LOSS_HIT,SHORT,11134.0,11201.78,10930.68,11201.78,3.285,1.86,0.61,6291.94,2,3.0,-2097.52
04/01/2018 01:00:00,15/06/2023 18:58:13,Gemini_BTCUSD_1h_17_12_17_to_10_03_23.csv,BTC_USD,HOUR,102777.97,9.924,04/01/2018 03:00:00,04/01/2018 04:00:00,04/01/2018 03:00:00,STOP_LOSS_HIT,LONG,15361.0,15153.86,15982.43,15153.86,1.483,3.89,1.37,6167.07,2,3.0,-2055.66
21/10/2022 03:00:00,15/06/2023 18:58:13,Gemini_BTCUSD_1h_17_12_17_to_10_03_23.csv,BTC_USD,HOUR,100722.31,7.176,21/10/2022 04:00:00,21/10/2022 06:00:00,21/10/2022 06:00:00,EXPIRED,LONG,19054.0,19042.0,19896.16,18773.28,1.358,4.23,1.5,6043.34,2,3.0,-86.11
13/12/2022 23:00:00,15/06/2023 18:58:13,Gemini_BTCUSD_1h_17_12_17_to_10_03_23.csv,BTC_USD,HOUR,100636.2,12.409,14/12/2022 00:00:00,14/12/2022 02:00:00,14/12/2022 02:00:00,EXPIRED,LONG,17776.0,17789.0,18262.62,17613.8,2.192,2.66,0.92,6038.47,2,3.0,161.32
22/11/2018 19:00:00,15/06/2023 18:58:13,Gemini_BTCUSD_1h_17_12_17_to_10_03_23.csv,BTC_USD,HOUR,100797.52,37.972,22/11/2018 23:00:00,22/11/2018 22:00:00,22/11/2018 22:00:00,EXPIRED,LONG,4397.0,4412.0,4556.26,4343.91,1.656,3.5,1.22,6047.42,2,3.0,569.58
08/11/2021 05:00:00,15/06/2023 18:58:13,Gemini_BTCUSD_1h_17_12_17_to_10_03_23.csv,BTC_USD,HOUR,101367.1,5.717,08/11/2021 07:00:00,08/11/2021 08:00:00,08/11/2021 06:00:00,STOP_LOSS_HIT,SHORT,65487.0,65841.64,64423.09,65841.64,3.693,1.65,0.54,6082.37,2,3.0,-2027.48
14/06/2021 16:00:00,15/06/2023 18:58:13,Gemini_BTCUSD_1h_17_12_17_to_10_03_23.csv,BTC_USD,HOUR,99339.62,3.356,14/06/2021 17:00:00,14/06/2021 19:00:00,14/06/2021 19:00:00,STOP_LOSS_HIT,LONG,40192.0,39600.04,41967.87,39600.04,1.358,4.23,1.49,5959.82,2,3.0,-1986.62
10/01/2021 14:00:00,15/06/2023 18:58:13,Gemini_BTCUSD_1h_17_12_17_to_10_03_23.csv,BTC_USD,HOUR,97353.0,5.183,10/01/2021 16:00:00,10/01/2021 17:00:00,10/01/2021 15:00:00,STOP_LOSS_HIT,SHORT,39505.0,39880.66,38378.03,39880.66,2.103,2.94,0.94,5841.09,2,3.0,-1947.05
08/06/2020 18:00:00,15/06/2023 18:58:13,Gemini_BTCUSD_1h_17_12_17_to_10_03_23.csv,BTC_USD,HOUR,95405.95,36.568,08/06/2020 20:00:00,08/06/2020 21:00:00,08/06/2020 21:00:00,EXPIRED,SHORT,9708.0,9717.0,9551.45,9760.18,3.721,1.64,0.53,5724.72,2,3.0,-329.11
06/06/2022 15:00:00,15/06/2023 18:58:13,Gemini_BTCUSD_1h_17_12_17_to_10_03_23.csv,BTC_USD,HOUR,95076.84,3.368,06/06/2022 19:00:00,06/06/2022 18:00:00,06/06/2022 18:00:00,EXPIRED,LONG,31519.0,31329.0,33213.0,30954.34,1.117,5.1,1.82,5705.39,2,3.0,-639.92
14/04/2021 06:00:00,15/06/2023 18:58:13,Gemini_BTCUSD_1h_17_12_17_to_10_03_23.csv,BTC_USD,HOUR,94436.92,6.168,14/04/2021 07:00:00,14/04/2021 09:00:00,14/04/2021 07:00:00,STOP_LOSS_HIT,LONG,64626.0,64319.78,65544.68,64319.78,4.221,1.4,0.48,5666.42,2,3.0,-1888.76
22/05/2019 17:00:00,15/06/2023 18:58:13,Gemini_BTCUSD_1h_17_12_17_to_10_03_23.csv,BTC_USD,HOUR,92548.16,14.41,22/05/2019 18:00:00,22/05/2019 20:00:00,22/05/2019 20:00:00,STOP_LOSS_HIT,LONG,7908.0,7779.55,8293.36,7779.55,1.231,4.65,1.65,5553.04,2,3.0,-1850.96
08/10/2020 17:00:00,15/06/2023 18:58:13,Gemini_BTCUSD_1h_17_12_17_to_10_03_23.csv,BTC_USD,HOUR,90697.2,13.914,08/10/2020 18:00:00,08/10/2020 20:00:00,08/10/2020 20:00:00,EXPIRED,LONG,10885.0,10895.0,11276.11,10754.63,1.67,3.47,1.21,5441.9,2,3.0,139.14
09/06/2018 04:00:00,15/06/2023 18:58:13,Gemini_BTCUSD_1h_17_12_17_to_10_03_23.csv,BTC_USD,HOUR,90836.34,28.206,09/06/2018 05:00:00,09/06/2018 07:00:00,09/06/2018 07:00:00,EXPIRED,LONG,7656.0,7653.0,7849.24,7591.59,2.377,2.46,0.85,5450.53,2,3.0,-84.62
20/12/2020 20:00:00,15/06/2023 18:58:13,Gemini_BTCUSD_1h_17_12_17_to_10_03_23.csv,BTC_USD,HOUR,90751.72,5.611,20/12/2020 21:00:00,20/12/2020 23:00:00,20/12/2020 21:00:00,STOP_LOSS_HIT,LONG,24178.0,23854.53,25148.41,23854.53,1.495,3.86,1.36,5444.97,2,3.0,-1814.99
25/07/2021 18:00:00,15/06/2023 18:58:13,Gemini_BTCUSD_1h_17_12_17_to_10_03_23.csv,BTC_USD,HOUR,88936.73,2.737,25/07/2021 19:00:00,25/07/2021 21:00:00,25/07/2021 21:00:00,EXPIRED,LONG,34443.0,34598.0,36392.52,33793.16,1.06,5.36,1.92,5335.84,2,3.0,424.24
21/08/2022 00:00:00,15/06/2023 18:58:13,Gemini_BTCUSD_1h_17_12_17_to_10_03_23.csv,BTC_USD,HOUR,89360.97,17.148,21/08/2022 03:00:00,21/08/2022 03:00:00,21/08/2022 03:00:00,EXPIRED,LONG,21173.0,21213.0,21485.65,21068.78,4.063,1.46,0.49,5361.32,2,3.0,685.92
24/10/2021 17:00:00,15/06/2023 18:58:13,Gemini_BTCUSD_1h_17_12_17_to_10_03_23.csv,BTC_USD,HOUR,90046.89,3.721,24/10/2021 19:00:00,24/10/2021 20:00:00,24/10/2021 20:00:00,STOP_LOSS_HIT,SHORT,60320.0,60804.03,58867.93,60804.03,2.493,2.47,0.8,5403.15,2,3.0,-1801.08
12/09/2020 08:00:00,15/06/2023 18:58:13,Gemini_BTCUSD_1h_17_12_17_to_10_03_23.csv,BTC_USD,HOUR,88245.81,35.263,12/09/2020 11:00:00,12/09/2020 11:00:00,12/09/2020 11:00:00,EXPIRED,SHORT,10334.0,10342.0,10183.85,10384.05,4.129,1.47,0.48,5294.74,2,3.0,-282.1
19/01/2020 04:00:00,15/06/2023 18:58:13,Gemini_BTCUSD_1h_17_12_17_to_10_03_23.csv,BTC_USD,HOUR,87963.71,10.775,19/01/2020 05:00:00,19/01/2020 07:00:00,19/01/2020 07:00:00,EXPIRED,LONG,9136.0,9070.0,9625.84,8972.72,1.119,5.09,1.82,5278.03,2,3.0,-711.15
23/11/2022 00:00:00,15/06/2023 18:58:13,Gemini_BTCUSD_1h_17_12_17_to_10_03_23.csv,BTC_USD,HOUR,87252.56,6.097,23/11/2022 01:00:00,23/11/2022 03:00:00,23/11/2022 03:00:00,EXPIRED,LONG,16163.0,16564.0,17021.61,15876.8,1.129,5.04,1.8,5234.95,2,3.0,2444.9
10/07/2021 16:00:00,15/06/2023 18:58:13,Gemini_BTCUSD_1h_17_12_17_to_10_03_23.csv,BTC_USD,HOUR,89697.46,16.361,10/07/2021 17:00:00,10/07/2021 19:00:00,10/07/2021 17:00:00,STOP_LOSS_HIT,LONG,34037.0,33927.35,34365.95,33927.35,6.208,0.96,0.32,5381.95,2,3.0,-1793.98
19/09/2018 06:00:00,15/06/2023 18:58:13,Gemini_BTCUSD_1h_17_12_17_to_10_03_23.csv,BTC_USD,HOUR,87903.48,56.294,19/09/2018 07:00:00,19/09/2018 09:00:00,19/09/2018 09:00:00,STOP_LOSS_HIT,LONG,6343.0,6311.77,6436.68,6311.77,4.062,1.46,0.49,5273.62,2,3.0,-1758.06
25/10/2018 23:00:00,15/06/2023 18:58:13,Gemini_BTCUSD_1h_17_12_17_to_10_03_23.csv,BTC_USD,HOUR,86145.42,23.015,26/10/2018 01:00:00,26/10/2018 02:00:00,26/10/2018 02:00:00,EXPIRED,SHORT,6390.0,6391.0,6165.43,6464.86,1.707,3.64,1.16,5168.48,2,3.0,-23.01
22/05/2020 20:00:00,15/06/2023 18:58:13,Gemini_BTCUSD_1h_17_12_17_to_10_03_23.csv,BTC_USD,HOUR,86122.41,34.442,22/05/2020 22:00:00,22/05/2020 23:00:00,22/05/2020 23:00:00,EXPIRED,SHORT,9183.0,9165.0,9032.96,9233.01,3.672,1.66,0.54,5167.68,2,3.0,619.96
02/01/2021 08:00:00,15/06/2023 18:58:13,Gemini_BTCUSD_1h_17_12_17_to_10_03_23.csv,BTC_USD,HOUR,86742.37,4.979,02/01/2021 09:00:00,02/01/2021 11:00:00,02/01/2021 10:00:00,STOP_LOSS_HIT,LONG,29895.0,29546.59,30940.23,29546.59,1.716,3.38,1.18,5204.2,2,3.0,-1734.73
14/04/2019 16:00:00,15/06/2023 18:58:13,Gemini_BTCUSD_1h_17_12_17_to_10_03_23.csv,BTC_USD,HOUR,85007.64,40.518,14/04/2019 20:00:00,14/04/2019 19:00:00,14/04/2019 19:00:00,EXPIRED,SHORT,5081.0,5091.0,4955.11,5122.96,2.422,2.54,0.82,5100.81,2,3.0,-405.18
26/03/2022 18:00:00,15/06/2023 18:58:14,Gemini_BTCUSD_1h_17_12_17_to_10_03_23.csv,BTC_USD,HOUR,84602.46,7.515,26/03/2022 19:00:00,26/03/2022 21:00:00,26/03/2022 21:00:00,EXPIRED,LONG,44483.0,44454.0,45158.46,44257.85,3.951,1.5,0.51,5076.08,2,3.0,-217.93
03/04/2019 01:00:00,15/06/2023 18:58:14,Gemini_BTCUSD_1h_17_12_17_to_10_03_23.csv,BTC_USD,HOUR,84384.53,20.205,03/04/2019 02:00:00,03/04/2019 04:00:00,03/04/2019 04:00:00,STOP_LOSS_HIT,LONG,4970.0,4886.47,5220.6,4886.47,1.19,4.8,1.71,5063.37,2,3.0,-1687.72
09/03/2021 15:00:00,15/06/2023 18:58:14,Gemini_BTCUSD_1h_17_12_17_to_10_03_23.csv,BTC_USD,HOUR,82696.81,5.478,09/03/2021 17:00:00,09/03/2021 18:00:00,09/03/2021 18:00:00,EXPIRED,SHORT,54150.0,53933.0,53244.22,54451.93,3.587,1.7,0.55,4961.86,2,3.0,1188.73
25/05/2021 00:00:00,15/06/2023 18:58:14,Gemini_BTCUSD_1h_17_12_17_to_10_03_23.csv,BTC_USD,HOUR,83885.54,7.848,25/05/2021 02:00:00,25/05/2021 03:00:00,25/05/2021 01:00:00,TAKE_PROFIT_HIT,SHORT,39474.0,38832.7,38832.7,39687.77,3.693,1.65,0.54,5032.92,2,3.0,5032.92
21/12/2022 09:00:00,15/06/2023 18:58:14,Gemini_BTCUSD_1h_17_12_17_to_10_03_23.csv,BTC_USD,HOUR,88918.46,8.485,21/12/2022 10:00:00,21/12/2022 12:00:00,21/12/2022 12:00:00,EXPIRED,LONG,16875.0,16845.0,17503.79,16665.4,1.61,3.59,1.26,5335.28,2,3.0,-254.55
23/04/2019 22:00:00,15/06/2023 18:58:14,Gemini_BTCUSD_1h_17_12_17_to_10_03_23.csv,BTC_USD,HOUR,88663.91,35.135,24/04/2019 01:00:00,24/04/2019 01:00:00,24/04/2019 01:00:00,EXPIRED,SHORT,5560.0,5550.0,5408.58,5610.47,2.203,2.8,0.9,5320.14,2,3.0,351.35
07/09/2021 01:00:00,15/06/2023 18:58:14,Gemini_BTCUSD_1h_17_12_17_to_10_03_23.csv,BTC_USD,HOUR,89015.26,2.302,07/09/2021 02:00:00,07/09/2021 04:00:00,07/09/2021 04:00:00,EXPIRED,LONG,52538.0,52539.0,54858.26,51764.58,1.359,4.23,1.49,5341.24,2,3.0,2.3
05/06/2022 14:00:00,15/06/2023 18:58:14,Gemini_BTCUSD_1h_17_12_17_to_10_03_23.csv,BTC_USD,HOUR,89017.56,4.868,05/06/2022 15:00:00,05/06/2022 17:00:00,05/06/2022 17:00:00,EXPIRED,LONG,29782.0,29994.0,30879.14,29416.29,1.629,3.55,1.24,5340.88,2,3.0,1032.02
20/03/2020 12:00:00,15/06/2023 18:58:14,Gemini_BTCUSD_1h_17_12_17_to_10_03_23.csv,BTC_USD,HOUR,90049.58,32.805,20/03/2020 15:00:00,20/03/2020 15:00:00,20/03/2020 13:00:00,STOP_LOSS_HIT,LONG,6637.0,6582.1,6801.7,6582.1,2.418,2.42,0.83,5402.98,2,3.0,-1800.99
13/01/2020 00:00:00,15/06/2023 18:58:14,Gemini_BTCUSD_1h_17_12_17_to_10_03_23.csv,BTC_USD,HOUR,88248.59,17.646,13/01/2020 01:00:00,13/01/2020 03:00:00,13/01/2020 03:00:00,EXPIRED,LONG,8144.0,8100.0,8444.07,8043.98,1.628,3.55,1.24,5295.04,2,3.0,-776.42
09/06/2020 18:00:00,15/06/2023 18:58:14,Gemini_BTCUSD_1h_17_12_17_to_10_03_23.csv,BTC_USD,HOUR,87472.17,35.696,09/06/2020 22:00:00,09/06/2020 21:00:00,09/06/2020 20:00:00,STOP_LOSS_HIT,SHORT,9712.0,9761.01,9564.98,9761.01,3.963,1.54,0.5,5248.03,2,3.0,-1749.46
09/08/2018 03:00:00,15/06/2023 18:58:14,Gemini_BTCUSD_1h_17_12_17_to_10_03_23.csv,BTC_USD,HOUR,85722.71,16.883,09/08/2018 04:00:00,09/08/2018 06:00:00,09/08/2018 06:00:00,EXPIRED,LONG,6320.0,6360.0,6624.65,6218.45,1.245,4.6,1.63,5143.41,2,3.0,675.32
09/11/2021 03:00:00,15/06/2023 18:58:14,Gemini_BTCUSD_1h_17_12_17_to_10_03_23.csv,BTC_USD,HOUR,86398.03,4.359,09/11/2021 06:00:00,09/11/2021 06:00:00,09/11/2021 06:00:00,EXPIRED,SHORT,68526.0,68054.0,67336.81,68922.4,3.457,1.77,0.58,5183.68,2,3.0,2057.45
07/12/2019 03:00:00,15/06/2023 18:58:14,Gemini_BTCUSD_1h_17_12_17_to_10_03_23.csv,BTC_USD,HOUR,88455.48,41.104,07/12/2019 04:00:00,07/12/2019 06:00:00,07/12/2019 04:00:00,STOP_LOSS_HIT,SHORT,7546.0,7589.04,7416.88,7589.04,3.507,1.74,0.57,5307.35,2,3.0,-1769.12
13/05/2021 16:00:00,15/06/2023 18:58:14,Gemini_BTCUSD_1h_17_12_17_to_10_03_23.csv,BTC_USD,HOUR,86686.36,4.26,13/05/2021 20:00:00,13/05/2021 19:00:00,13/05/2021 17:00:00,STOP_LOSS_HIT,LONG,48683.0,48276.03,49903.94,48276.03,2.392,2.45,0.84,5201.2,2,3.0,-1733.69
07/05/2020 23:00:00,15/06/2023 18:58:14,Gemini_BTCUSD_1h_17_12_17_to_10_03_23.csv,BTC_USD,HOUR,84952.67,32.424,08/05/2020 03:00:00,08/05/2020 02:00:00,08/05/2020 00:00:00,STOP_LOSS_HIT,LONG,10004.0,9951.6,10161.19,9951.6,3.818,1.55,0.53,5096.73,2,3.0,-1699.02
23/04/2019 06:00:00,15/06/2023 18:58:14,Gemini_BTCUSD_1h_17_12_17_to_10_03_23.csv,BTC_USD,HOUR,83253.65,20.41,23/04/2019 08:00:00,23/04/2019 09:00:00,23/04/2019 09:00:00,EXPIRED,LONG,5537.0,5536.0,5781.73,5455.42,1.357,4.23,1.5,4994.94,2,3.0,-20.41
20/02/2021 13:00:00,15/06/2023 18:58:14,Gemini_BTCUSD_1h_17_12_17_to_10_03_23.csv,BTC_USD,HOUR,83233.24,3.09,20/02/2021 14:00:00,20/02/2021 16:00:00,20/02/2021 14:00:00,STOP_LOSS_HIT,LONG,57307.0,56768.31,58923.06,56768.31,2.127,2.74,0.95,4993.63,2,3.0,-1664.55
22/07/2020 14:00:00,15/06/2023 18:58:14,Gemini_BTCUSD_1h_17_12_17_to_10_03_23.csv,BTC_USD,HOUR,81568.69,12.94,22/07/2020 18:00:00,22/07/2020 17:00:00,22/07/2020 17:00:00,EXPIRED,LONG,9348.0,9369.0,9726.2,9221.93,1.483,3.89,1.37,4893.91,2,3.0,271.74
16/06/2021 05:00:00,15/06/2023 18:58:14,Gemini_BTCUSD_1h_17_12_17_to_10_03_23.csv,BTC_USD,HOUR,81840.43,2.99,16/06/2021 06:00:00,16/06/2021 08:00:00,16/06/2021 08:00:00,EXPIRED,LONG,40279.0,40052.0,41921.1,39731.64,1.472,3.92,1.38,4909.88,2,3.0,-678.73
12/09/2021 08:00:00,15/06/2023 18:58:14,Gemini_BTCUSD_1h_17_12_17_to_10_03_23.csv,BTC_USD,HOUR,81161.7,3.506,12/09/2021 11:00:00,12/09/2021 11:00:00,12/09/2021 11:00:00,EXPIRED,LONG,46114.0,46090.0,47502.85,45651.05,1.992,2.92,1.01,4869.31,2,3.0,-84.14
05/09/2021 03:00:00,15/06/2023 18:58:14,Gemini_BTCUSD_1h_17_12_17_to_10_03_23.csv,BTC_USD,HOUR,81077.56,1.89,05/09/2021 04:00:00,05/09/2021 06:00:00,05/09/2021 06:00:00,EXPIRED,LONG,49692.0,49884.0,52265.48,48834.17,1.158,4.92,1.76,4863.88,2,3.0,362.88
14/06/2019 13:00:00,15/06/2023 18:58:14,Gemini_BTCUSD_1h_17_12_17_to_10_03_23.csv,BTC_USD,HOUR,81440.44,15.317,14/06/2019 14:00:00,14/06/2019 16:00:00,14/06/2019 16:00:00,EXPIRED,LONG,8408.0,8370.0,8727.01,8301.66,1.581,3.66,1.28,4886.28,2,3.0,-582.05
19/09/2018 15:00:00,15/06/2023 18:58:14,Gemini_BTCUSD_1h_17_12_17_to_10_03_23.csv,BTC_USD,HOUR,80858.39,50.067,19/09/2018 16:00:00,19/09/2018 18:00:00,19/09/2018 18:00:00,STOP_LOSS_HIT,LONG,6323.0,6290.7,6419.89,6290.7,3.915,1.51,0.51,4850.99,2,3.0,-1617.16
26/08/2020 03:00:00,15/06/2023 18:58:14,Gemini_BTCUSD_1h_17_12_17_to_10_03_23.csv,BTC_USD,HOUR,79241.23,16.002,26/08/2020 05:00:00,26/08/2020 06:00:00,26/08/2020 06:00:00,EXPIRED,SHORT,11368.0,11333.0,11070.87,11467.04,2.296,2.68,0.86,4754.67,2,3.0,560.07
18/02/2020 16:00:00,15/06/2023 18:58:14,Gemini_BTCUSD_1h_17_12_17_to_10_03_23.csv,BTC_USD,HOUR,79801.3,31.736,18/02/2020 19:00:00,18/02/2020 19:00:00,18/02/2020 19:00:00,EXPIRED,LONG,9942.0,10073.0,10092.88,9891.71,3.954,1.49,0.51,4788.33,2,3.0,4157.42
07/04/2019 07:00:00,15/06/2023 18:58:14,Gemini_BTCUSD_1h_17_12_17_to_10_03_23.csv,BTC_USD,HOUR,83958.72,26.286,07/04/2019 09:00:00,07/04/2019 10:00:00,07/04/2019 10:00:00,EXPIRED,SHORT,5131.0,5106.0,4939.37,5194.88,1.606,3.88,1.23,5037.19,2,3.0,657.15
20/11/2018 19:00:00,15/06/2023 18:58:14,Gemini_BTCUSD_1h_17_12_17_to_10_03_23.csv,BTC_USD,HOUR,84615.87,33.228,20/11/2018 21:00:00,20/11/2018 22:00:00,20/11/2018 20:00:00,TAKE_PROFIT_HIT,SHORT,4491.0,4338.2,4338.2,4541.93,1.764,3.52,1.12,5077.24,2,3.0,5077.24
21/03/2019 08:00:00,15/06/2023 18:58:14,Gemini_BTCUSD_1h_17_12_17_to_10_03_23.csv,BTC_USD,HOUR,89693.11,54.909,21/03/2019 10:00:00,21/03/2019 11:00:00,21/03/2019 11:00:00,EXPIRED,LONG,4034.0,4036.0,4132.0,4001.33,2.47,2.37,0.82,5381.08,2,3.0,109.82
18/10/2022 12:00:00,15/06/2023 18:58:14,Gemini_BTCUSD_1h_17_12_17_to_10_03_23.csv,BTC_USD,HOUR,89802.93,13.586,18/10/2022 15:00:00,18/10/2022 15:00:00,18/10/2022 14:00:00,STOP_LOSS_HIT,LONG,19637.0,19504.8,20033.61,19504.8,2.971,1.98,0.68,5388.34,2,3.0,-1796.07
27/01/2020 13:00:00,15/06/2023 18:58:14,Gemini_BTCUSD_1h_17_12_17_to_10_03_23.csv,BTC_USD,HOUR,88006.86,13.556,27/01/2020 14:00:00,27/01/2020 16:00:00,27/01/2020 16:00:00,EXPIRED,LONG,8713.0,8767.0,9102.53,8583.16,1.342,4.28,1.51,5280.47,2,3.0,732.02
31/07/2019 10:00:00,15/06/2023 18:58:14,Gemini_BTCUSD_1h_17_12_17_to_10_03_23.csv,BTC_USD,HOUR,88738.88,34.045,31/07/2019 11:00:00,31/07/2019 13:00:00,31/07/2019 13:00:00,TAKE_PROFIT_HIT,LONG,9776.0,9932.39,9932.39,9723.87,3.751,1.57,0.54,5324.3,2,3.0,5324.3
06/01/2020 06:00:00,15/06/2023 18:58:14,Gemini_BTCUSD_1h_17_12_17_to_10_03_23.csv,BTC_USD,HOUR,94063.18,37.588,06/01/2020 08:00:00,06/01/2020 09:00:00,06/01/2020 09:00:00,EXPIRED,SHORT,7516.0,7535.0,7365.87,7566.05,3.003,2.04,0.66,5643.09,2,3.0,-714.17
21/12/2018 02:00:00,15/06/2023 18:58:14,Gemini_BTCUSD_1h_17_12_17_to_10_03_23.csv,BTC_USD,HOUR,93349.01,35.65,21/12/2018 03:00:00,21/12/2018 05:00:00,21/12/2018 05:00:00,STOP_LOSS_HIT,LONG,4034.0,3981.63,4191.12,3981.63,1.541,3.75,1.32,5601.33,2,3.0,-1866.99
25/10/2022 23:00:00,15/06/2023 18:58:14,Gemini_BTCUSD_1h_17_12_17_to_10_03_23.csv,BTC_USD,HOUR,91482.02,15.395,26/10/2022 03:00:00,26/10/2022 02:00:00,26/10/2022 02:00:00,EXPIRED,LONG,20089.0,20213.0,20445.54,19970.15,3.381,1.74,0.6,5488.93,2,3.0,1908.98
21/02/2021 15:00:00,15/06/2023 18:58:14,Gemini_BTCUSD_1h_17_12_17_to_10_03_23.csv,BTC_USD,HOUR,93391.0,5.62,21/02/2021 19:00:00,21/02/2021 18:00:00,21/02/2021 16:00:00,STOP_LOSS_HIT,LONG,57406.0,57073.63,58403.12,57073.63,3.455,1.71,0.58,5603.81,2,3.0,-1867.92
02/07/2022 08:00:00,15/06/2023 18:58:14,Gemini_BTCUSD_1h_17_12_17_to_10_03_23.csv,BTC_USD,HOUR,91523.08,12.401,02/07/2022 09:00:00,02/07/2022 11:00:00,02/07/2022 11:00:00,EXPIRED,LONG,19078.0,19165.0,19520.85,18930.39,2.585,2.27,0.78,5491.78,2,3.0,1078.89
23/04/2019 15:00:00,15/06/2023 18:58:14,Gemini_BTCUSD_1h_17_12_17_to_10_03_23.csv,BTC_USD,HOUR,92601.97,18.109,23/04/2019 16:00:00,23/04/2019 18:00:00,23/04/2019 18:00:00,EXPIRED,LONG,5566.0,5604.0,5872.81,5463.73,1.088,5.22,1.87,5556.02,2,3.0,688.14
14/04/2022 10:00:00,15/06/2023 18:58:14,Gemini_BTCUSD_1h_17_12_17_to_10_03_23.csv,BTC_USD,HOUR,93290.11,9.183,14/04/2022 13:00:00,14/04/2022 13:00:00,14/04/2022 12:00:00,STOP_LOSS_HIT,SHORT,40949.0,41152.17,40339.48,41152.17,4.031,1.51,0.49,5597.22,2,3.0,-1865.71
27/05/2020 04:00:00,15/06/2023 18:58:14,Gemini_BTCUSD_1h_17_12_17_to_10_03_23.csv,BTC_USD,HOUR,91424.4,34.736,27/05/2020 06:00:00,27/05/2020 07:00:00,27/05/2020 07:00:00,EXPIRED,SHORT,8851.0,8841.0,8693.08,8903.64,3.363,1.82,0.59,5485.51,2,3.0,347.36
23/07/2020 04:00:00,15/06/2023 18:58:14,Gemini_BTCUSD_1h_17_12_17_to_10_03_23.csv,BTC_USD,HOUR,91771.76,36.381,23/07/2020 05:00:00,23/07/2020 07:00:00,23/07/2020 07:00:00,EXPIRED,LONG,9517.0,9504.0,9668.34,9466.55,3.773,1.57,0.53,5505.9,2,3.0,-472.95
07/09/2019 11:00:00,15/06/2023 18:58:14,Gemini_BTCUSD_1h_17_12_17_to_10_03_23.csv,BTC_USD,HOUR,91298.81,32.08,07/09/2019 12:00:00,07/09/2019 14:00:00,07/09/2019 14:00:00,EXPIRED,LONG,10427.0,10424.0,10597.75,10370.08,3.664,1.61,0.55,5477.66,2,3.0,-96.24
26/09/2022 01:00:00,15/06/2023 18:58:14,Gemini_BTCUSD_1h_17_12_17_to_10_03_23.csv,BTC_USD,HOUR,91202.57,18.417,26/09/2022 03:00:00,26/09/2022 04:00:00,26/09/2022 04:00:00,EXPIRED,LONG,18888.0,18814.0,19185.12,18788.96,3.814,1.55,0.53,5472.06,2,3.0,-1362.86
26/02/2022 14:00:00,15/06/2023 18:58:14,Gemini_BTCUSD_1h_17_12_17_to_10_03_23.csv,BTC_USD,HOUR,89839.71,9.14,26/02/2022 17:00:00,26/02/2022 17:00:00,26/02/2022 17:00:00,EXPIRED,SHORT,39236.0,39289.0,38646.27,39432.58,3.992,1.53,0.5,5390.13,2,3.0,-484.42
19/03/2022 05:00:00,15/06/2023 18:58:14,Gemini_BTCUSD_1h_17_12_17_to_10_03_23.csv,BTC_USD,HOUR,89355.29,3.353,19/03/2022 06:00:00,19/03/2022 08:00:00,19/03/2022 08:00:00,EXPIRED,LONG,41762.0,41728.0,43360.99,41229.01,1.567,3.69,1.29,5361.41,2,3.0,-114.0
10/04/2018 06:00:00,15/06/2023 18:58:14,Gemini_BTCUSD_1h_17_12_17_to_10_03_23.csv,BTC_USD,HOUR,89241.29,48.792,10/04/2018 09:00:00,10/04/2018 09:00:00,10/04/2018 09:00:00,STOP_LOSS_HIT,SHORT,6708.0,6744.58,6598.27,6744.58,3.668,1.66,0.54,5353.95,2,3.0,-1784.81
20/05/2018 12:00:00,15/06/2023 18:58:14,Gemini_BTCUSD_1h_17_12_17_to_10_03_23.csv,BTC_USD,HOUR,87456.48,15.187,20/05/2018 13:00:00,20/05/2018 15:00:00,20/05/2018 15:00:00,EXPIRED,LONG,8320.0,8375.0,8665.52,8204.83,1.445,3.99,1.4,5247.41,2,3.0,835.29
03/06/2018 04:00:00,15/06/2023 18:58:14,Gemini_BTCUSD_1h_17_12_17_to_10_03_23.csv,BTC_USD,HOUR,88291.77,42.996,03/06/2018 07:00:00,03/06/2018 07:00:00,03/06/2018 06:00:00,TAKE_PROFIT_HIT,LONG,7650.0,7773.22,7773.22,7608.93,3.725,1.59,0.54,5297.97,2,3.0,5297.97
20/10/2020 17:00:00,15/06/2023 18:58:14,Gemini_BTCUSD_1h_17_12_17_to_10_03_23.csv,BTC_USD,HOUR,93589.74,9.439,20/10/2020 18:00:00,20/10/2020 20:00:00,20/10/2020 20:00:00,EXPIRED,LONG,11972.0,11908.0,12566.9,11773.7,1.207,4.73,1.68,5615.26,2,3.0,-604.1
03/05/2018 00:00:00,15/06/2023 18:58:14,Gemini_BTCUSD_1h_17_12_17_to_10_03_23.csv,BTC_USD,HOUR,92985.64,40.114,03/05/2018 01:00:00,03/05/2018 03:00:00,03/05/2018 03:00:00,EXPIRED,LONG,9183.0,9255.0,9322.08,9136.64,3.962,1.49,0.51,5579.06,2,3.0,2888.21
11/06/2019 00:00:00,15/06/2023 18:58:14,Gemini_BTCUSD_1h_17_12_17_to_10_03_23.csv,BTC_USD,HOUR,95873.85,15.752,11/06/2019 01:00:00,11/06/2019 03:00:00,11/06/2019 03:00:00,EXPIRED,LONG,8005.0,7971.0,8370.19,7883.27,1.315,4.36,1.54,5752.47,2,3.0,-535.57
12/05/2022 19:00:00,15/06/2023 18:58:14,Gemini_BTCUSD_1h_17_12_17_to_10_03_23.csv,BTC_USD,HOUR,95338.28,7.19,12/05/2022 21:00:00,12/05/2022 22:00:00,12/05/2022 20:00:00,STOP_LOSS_HIT,SHORT,28550.0,28815.21,27754.39,28815.21,2.153,2.87,0.92,5720.44,2,3.0,-1906.86
28/08/2021 13:00:00,15/06/2023 18:58:14,Gemini_BTCUSD_1h_17_12_17_to_10_03_23.csv,BTC_USD,HOUR,93431.42,7.551,28/08/2021 14:00:00,28/08/2021 16:00:00,28/08/2021 16:00:00,STOP_LOSS_HIT,SHORT,48766.0,49013.48,48023.58,49013.48,3.941,1.55,0.5,5606.01,2,3.0,-1868.72
18/08/2022 14:00:00,15/06/2023 18:58:14,Gemini_BTCUSD_1h_17_12_17_to_10_03_23.csv,BTC_USD,HOUR,91562.7,13.427,18/08/2022 18:00:00,18/08/2022 17:00:00,18/08/2022 16:00:00,STOP_LOSS_HIT,LONG,23420.0,23283.61,23829.16,23283.61,3.434,1.72,0.59,5493.79,2,3.0,-1831.31
22/04/2021 14:00:00,15/06/2023 18:58:14,Gemini_BTCUSD_1h_17_12_17_to_10_03_23.csv,BTC_USD,HOUR,89731.39,1.737,22/04/2021 16:00:00,22/04/2021 17:00:00,22/04/2021 17:00:00,STOP_LOSS_HIT,LONG,54785.0,53751.86,57884.44,53751.86,1.061,5.35,1.92,5383.73,2,3.0,-1794.56
31/07/2020 15:00:00,15/06/2023 18:58:14,Gemini_BTCUSD_1h_17_12_17_to_10_03_23.csv,BTC_USD,HOUR,87936.83,26.559,31/07/2020 17:00:00,31/07/2020 18:00:00,31/07/2020 16:00:00,STOP_LOSS_HIT,SHORT,11375.0,11441.22,11176.35,11441.22,3.436,1.78,0.58,5275.95,2,3.0,-1758.74
16/09/2021 09:00:00,15/06/2023 18:58:14,Gemini_BTCUSD_1h_17_12_17_to_10_03_23.csv,BTC_USD,HOUR,86178.09,2.707,16/09/2021 11:00:00,16/09/2021 12:00:00,16/09/2021 12:00:00,EXPIRED,SHORT,47939.0,48073.0,46029.21,48575.6,1.506,4.15,1.31,5169.8,2,3.0,-362.74
08/03/2023 12:00:00,15/06/2023 18:58:14,Gemini_BTCUSD_1h_17_12_17_to_10_03_23.csv,BTC_USD,HOUR,85815.35,15.32,08/03/2023 13:00:00,08/03/2023 15:00:00,08/03/2023 15:00:00,STOP_LOSS_HIT,LONG,22000.0,21887.97,22336.09,21887.97,3.928,1.5,0.51,5148.9,2,3.0,-1716.3
05/09/2022 16:00:00,15/06/2023 18:58:14,Gemini_BTCUSD_1h_17_12_17_to_10_03_23.csv,BTC_USD,HOUR,84099.05,8.166,05/09/2022 17:00:00,05/09/2022 19:00:00,05/09/2022 19:00:00,EXPIRED,LONG,19842.0,19708.0,20459.93,19636.02,1.927,3.02,1.05,5046.02,2,3.0,-1094.24
13/01/2018 10:00:00,15/06/2023 18:58:14,Gemini_BTCUSD_1h_17_12_17_to_10_03_23.csv,BTC_USD,HOUR,83004.81,22.017,13/01/2018 11:00:00,13/01/2018 13:00:00,13/01/2018 13:00:00,TAKE_PROFIT_HIT,LONG,14245.0,14471.21,14471.21,14169.6,3.778,1.56,0.53,4980.47,2,3.0,4980.47
29/01/2020 02:00:00,15/06/2023 18:58:14,Gemini_BTCUSD_1h_17_12_17_to_10_03_23.csv,BTC_USD,HOUR,87985.28,12.189,29/01/2020 03:00:00,29/01/2020 05:00:00,29/01/2020 05:00:00,EXPIRED,LONG,9325.0,9355.0,9758.11,9180.63,1.292,4.44,1.57,5279.18,2,3.0,365.67
11/07/2020 00:00:00,15/06/2023 18:58:14,Gemini_BTCUSD_1h_17_12_17_to_10_03_23.csv,BTC_USD,HOUR,88350.95,17.612,11/07/2020 01:00:00,11/07/2020 03:00:00,11/07/2020 03:00:00,EXPIRED,SHORT,9285.0,9268.0,8984.0,9385.33,1.851,3.35,1.07,5301.21,2,3.0,299.4
29/11/2020 13:00:00,15/06/2023 18:58:14,Gemini_BTCUSD_1h_17_12_17_to_10_03_23.csv,BTC_USD,HOUR,88650.35,9.021,29/11/2020 15:00:00,29/11/2020 16:00:00,29/11/2020 16:00:00,EXPIRED,SHORT,18092.0,18108.0,17502.39,18288.54,1.841,3.37,1.07,5318.87,2,3.0,-144.34
24/08/2022 06:00:00,15/06/2023 18:58:14,Gemini_BTCUSD_1h_17_12_17_to_10_03_23.csv,BTC_USD,HOUR,88506.01,5.001,24/08/2022 10:00:00,24/08/2022 09:00:00,24/08/2022 09:00:00,EXPIRED,LONG,21405.0,21314.0,22466.91,21051.03,1.209,4.73,1.68,5310.61,2,3.0,-455.09
12/05/2020 10:00:00,15/06/2023 18:58:14,Gemini_BTCUSD_1h_17_12_17_to_10_03_23.csv,BTC_USD,HOUR,88050.92,24.782,12/05/2020 11:00:00,12/05/2020 13:00:00,12/05/2020 13:00:00,STOP_LOSS_HIT,LONG,8781.0,8709.94,8994.17,8709.94,2.471,2.37,0.82,5282.78,2,3.0,-1761.01
24/07/2020 20:00:00,15/06/2023 18:58:14,Gemini_BTCUSD_1h_17_12_17_to_10_03_23.csv,BTC_USD,HOUR,86289.91,36.279,24/07/2020 21:00:00,24/07/2020 23:00:00,24/07/2020 23:00:00,EXPIRED,SHORT,9632.0,9554.0,9489.3,9679.57,4.05,1.5,0.49,5177.01,2,3.0,2829.76
22/02/2023 12:00:00,15/06/2023 18:58:14,Gemini_BTCUSD_1h_17_12_17_to_10_03_23.csv,BTC_USD,HOUR,89119.67,3.782,22/02/2023 14:00:00,22/02/2023 15:00:00,22/02/2023 15:00:00,STOP_LOSS_HIT,LONG,24138.0,23666.68,25551.97,23666.68,1.024,5.53,1.99,5347.63,2,3.0,-1782.53
26/09/2019 12:00:00,15/06/2023 18:58:14,Gemini_BTCUSD_1h_17_12_17_to_10_03_23.csv,BTC_USD,HOUR,87337.14,18.867,26/09/2019 13:00:00,26/09/2019 15:00:00,26/09/2019 13:00:00,STOP_LOSS_HIT,LONG,8423.0,8330.42,8700.76,8330.42,1.82,3.19,1.11,5240.5,2,3.0,-1746.71
28/12/2019 06:00:00,15/06/2023 18:58:14,Gemini_BTCUSD_1h_17_12_17_to_10_03_23.csv,BTC_USD,HOUR,85590.43,28.122,28/12/2019 07:00:00,28/12/2019 09:00:00,28/12/2019 09:00:00,EXPIRED,LONG,7284.0,7288.0,7466.61,7223.13,2.393,2.45,0.84,5135.36,2,3.0,112.49
10/02/2019 18:00:00,15/06/2023 18:58:14,Gemini_BTCUSD_1h_17_12_17_to_10_03_23.csv,BTC_USD,HOUR,85702.92,84.729,10/02/2019 21:00:00,10/02/2019 21:00:00,10/02/2019 21:00:00,EXPIRED,LONG,3607.0,3606.0,3667.68,3586.77,3.566,1.65,0.56,5141.36,2,3.0,-84.73
23/05/2020 03:00:00,15/06/2023 18:58:14,Gemini_BTCUSD_1h_17_12_17_to_10_03_23.csv,BTC_USD,HOUR,85618.19,22.015,23/05/2020 04:00:00,23/05/2020 06:00:00,23/05/2020 06:00:00,EXPIRED,LONG,9287.0,9241.0,9520.34,9209.22,2.388,2.45,0.84,5136.98,2,3.0,-1012.69
06/04/2021 03:00:00,15/06/2023 18:58:14,Gemini_BTCUSD_1h_17_12_17_to_10_03_23.csv,BTC_USD,HOUR,84605.5,4.819,06/04/2021 07:00:00,06/04/2021 06:00:00,06/04/2021 05:00:00,STOP_LOSS_HIT,SHORT,58638.0,58989.13,57584.62,58989.13,3.34,1.83,0.6,5076.24,2,3.0,-1692.1
07/10/2019 06:00:00,15/06/2023 18:58:14,Gemini_BTCUSD_1h_17_12_17_to_10_03_23.csv,BTC_USD,HOUR,82913.4,24.191,07/10/2019 07:00:00,07/10/2019 09:00:00,07/10/2019 09:00:00,EXPIRED,LONG,7834.0,7926.0,8039.64,7765.45,2.286,2.56,0.88,4974.64,2,3.0,2225.57
28/10/2021 15:00:00,15/06/2023 18:58:14,Gemini_BTCUSD_1h_17_12_17_to_10_03_23.csv,BTC_USD,HOUR,85138.97,4.928,28/10/2021 16:00:00,28/10/2021 18:00:00,28/10/2021 18:00:00,STOP_LOSS_HIT,LONG,61184.0,60838.49,62220.53,60838.49,3.541,1.67,0.57,5108.02,2,3.0,-1702.67
12/08/2020 00:00:00,15/06/2023 18:58:14,Gemini_BTCUSD_1h_17_12_17_to_10_03_23.csv,BTC_USD,HOUR,83436.3,13.187,12/08/2020 04:00:00,12/08/2020 03:00:00,12/08/2020 03:00:00,EXPIRED,LONG,11331.0,11370.0,11710.64,11204.46,1.791,3.24,1.13,5006.31,2,3.0,514.29
27/03/2021 17:00:00,15/06/2023 18:58:14,Gemini_BTCUSD_1h_17_12_17_to_10_03_23.csv,BTC_USD,HOUR,83950.59,1.606,27/03/2021 18:00:00,27/03/2021 20:00:00,27/03/2021 20:00:00,EXPIRED,LONG,56122.0,55914.0,59257.55,55076.82,1.074,5.29,1.9,5035.69,2,3.0,-334.05
07/01/2021 05:00:00,15/06/2023 18:58:14,Gemini_BTCUSD_1h_17_12_17_to_10_03_23.csv,BTC_USD,HOUR,83616.54,3.075,07/01/2021 07:00:00,07/01/2021 08:00:00,07/01/2021 06:00:00,STOP_LOSS_HIT,LONG,37537.0,36993.17,39168.51,36993.17,1.38,4.17,1.47,5016.89,2,3.0,-1672.28
10/11/2020 12:00:00,15/06/2023 18:58:14,Gemini_BTCUSD_1h_17_12_17_to_10_03_23.csv,BTC_USD,HOUR,81944.26,18.709,10/11/2020 13:00:00,10/11/2020 15:00:00,10/11/2020 13:00:00,STOP_LOSS_HIT,LONG,15321.0,15233.4,15583.79,15233.4,3.498,1.69,0.58,4916.54,2,3.0,-1638.91
30/12/2018 09:00:00,15/06/2023 18:58:14,Gemini_BTCUSD_1h_17_12_17_to_10_03_23.csv,BTC_USD,HOUR,80305.35,31.754,30/12/2018 10:00:00,30/12/2018 12:00:00,30/12/2018 12:00:00,STOP_LOSS_HIT,LONG,3833.0,3782.42,3984.75,3782.42,1.516,3.81,1.34,4818.67,2,3.0,-1606.12
19/02/2022 04:00:00,15/06/2023 18:58:14,Gemini_BTCUSD_1h_17_12_17_to_10_03_23.csv,BTC_USD,HOUR,78699.23,4.315,19/02/2022 07:00:00,19/02/2022 07:00:00,19/02/2022 07:00:00,EXPIRED,SHORT,40241.0,40281.0,39146.74,40605.76,2.206,2.8,0.9,4721.73,2,3.0,-172.6
23/11/2018 06:00:00,15/06/2023 18:58:14,Gemini_BTCUSD_1h_17_12_17_to_10_03_23.csv,BTC_USD,HOUR,78526.63,43.361,23/11/2018 08:00:00,23/11/2018 09:00:00,23/11/2018 09:00:00,STOP_LOSS_HIT,SHORT,4260.0,4296.22,4151.33,4296.22,2.352,2.62,0.84,4712.04,2,3.0,-1570.54
26/01/2023 14:00:00,15/06/2023 18:58:14,Gemini_BTCUSD_1h_17_12_17_to_10_03_23.csv,BTC_USD,HOUR,76956.09,6.085,26/01/2023 16:00:00,26/01/2023 17:00:00,26/01/2023 17:00:00,EXPIRED,LONG,23026.0,22981.0,23784.79,22773.07,1.821,3.19,1.11,4617.24,2,3.0,-273.82
24/05/2019 16:00:00,15/06/2023 18:58:14,Gemini_BTCUSD_1h_17_12_17_to_10_03_23.csv,BTC_USD,HOUR,76682.27,23.272,24/05/2019 17:00:00,24/05/2019 19:00:00,24/05/2019 19:00:00,STOP_LOSS_HIT,LONG,8095.0,8029.1,8292.71,8029.1,2.457,2.38,0.82,4601.11,2,3.0,-1533.62
02/01/2023 22:00:00,15/06/2023 18:58:14,Gemini_BTCUSD_1h_17_12_17_to_10_03_23.csv,BTC_USD,HOUR,75148.65,6.247,02/01/2023 23:00:00,03/01/2023 01:00:00,03/01/2023 01:00:00,EXPIRED,LONG,16691.0,16666.0,17412.85,16450.39,1.387,4.15,1.46,4509.4,2,3.0,-156.18
28/04/2020 17:00:00,15/06/2023 18:58:14,Gemini_BTCUSD_1h_17_12_17_to_10_03_23.csv,BTC_USD,HOUR,74992.47,12.783,28/04/2020 20:00:00,28/04/2020 20:00:00,28/04/2020 20:00:00,EXPIRED,LONG,7740.0,7742.0,8092.0,7622.67,1.319,4.35,1.54,4499.62,2,3.0,25.57
07/10/2018 02:00:00,15/06/2023 18:58:14,Gemini_BTCUSD_1h_17_12_17_to_10_03_23.csv,BTC_USD,HOUR,75018.04,16.019,07/10/2018 03:00:00,07/10/2018 05:00:00,07/10/2018 05:00:00,EXPIRED,LONG,6558.0,6552.0,6839.0,6464.34,1.4,4.11,1.45,4501.34,2,3.0,-96.11
29/09/2021 03:00:00,15/06/2023 18:58:14,Gemini_BTCUSD_1h_17_12_17_to_10_03_23.csv,BTC_USD,HOUR,74921.93,6.717,29/09/2021 04:00:00,29/09/2021 06:00:00,29/09/2021 06:00:00,EXPIRED,LONG,42210.0,42454.0,42879.22,41986.93,3.784,1.56,0.53,4495.15,2,3.0,1638.95
17/11/2018 03:00:00,15/06/2023 18:58:14,Gemini_BTCUSD_1h_17_12_17_to_10_03_23.csv,BTC_USD,HOUR,76560.88,53.371,17/11/2018 05:00:00,17/11/2018 06:00:00,17/11/2018 06:00:00,EXPIRED,SHORT,5472.0,5477.0,5385.92,5500.69,3.815,1.6,0.52,4594.18,2,3.0,-266.85
01/02/2021 11:00:00,15/06/2023 18:58:14,Gemini_BTCUSD_1h_17_12_17_to_10_03_23.csv,BTC_USD,HOUR,76294.03,2.911,01/02/2021 12:00:00,01/02/2021 14:00:00,01/02/2021 12:00:00,STOP_LOSS_HIT,LONG,34194.0,33669.76,35766.73,33669.76,1.305,4.4,1.56,4578.22,2,3.0,-1526.06
01/12/2020 03:00:00,15/06/2023 18:58:14,Gemini_BTCUSD_1h_17_12_17_to_10_03_23.csv,BTC_USD,HOUR,74767.97,15.607,01/12/2020 06:00:00,01/12/2020 06:00:00,01/12/2020 04:00:00,STOP_LOSS_HIT,SHORT,19437.0,19532.81,19149.57,19532.81,4.057,1.5,0.49,4485.92,2,3.0,-1495.31
24/10/2020 20:00:00,15/06/2023 18:58:14,Gemini_BTCUSD_1h_17_12_17_to_10_03_23.csv,BTC_USD,HOUR,73272.66,8.04,24/10/2020 21:00:00,24/10/2020 23:00:00,24/10/2020 23:00:00,EXPIRED,LONG,13121.0,13130.0,13667.83,12938.72,1.44,4.0,1.41,4396.51,2,3.0,72.36
15/12/2020 19:00:00,15/06/2023 18:58:14,Gemini_BTCUSD_1h_17_12_17_to_10_03_23.csv,BTC_USD,HOUR,73345.02,6.092,15/12/2020 20:00:00,15/12/2020 22:00:00,15/12/2020 22:00:00,EXPIRED,LONG,19547.0,19470.0,20269.41,19306.2,1.624,3.56,1.25,4400.92,2,3.0,-469.08
09/09/2019 13:00:00,15/06/2023 18:58:14,Gemini_BTCUSD_1h_17_12_17_to_10_03_23.csv,BTC_USD,HOUR,72875.94,17.777,09/09/2019 14:00:00,09/09/2019 16:00:00,09/09/2019 16:00:00,STOP_LOSS_HIT,LONG,10341.0,10259.01,10586.98,10259.01,2.523,2.32,0.8,4372.79,2,3.0,-1457.54
06/12/2022 03:00:00,15/06/2023 18:58:14,Gemini_BTCUSD_1h_17_12_17_to_10_03_23.csv,BTC_USD,HOUR,71418.4,9.844,06/12/2022 04:00:00,06/12/2022 06:00:00,06/12/2022 06:00:00,EXPIRED,LONG,17001.0,17003.0,17436.31,16855.9,2.343,2.5,0.86,4285.19,2,3.0,19.69
15/09/2020 02:00:00,15/06/2023 18:58:14,Gemini_BTCUSD_1h_17_12_17_to_10_03_23.csv,BTC_USD,HOUR,71438.09,9.641,15/09/2020 04:00:00,15/09/2020 05:00:00,15/09/2020 05:00:00,EXPIRED,LONG,10760.0,10751.0,11204.62,10611.8,1.452,3.97,1.4,4286.58,2,3.0,-86.77
02/11/2019 01:00:00,15/06/2023 18:58:14,Gemini_BTCUSD_1h_17_12_17_to_10_03_23.csv,BTC_USD,HOUR,71351.32,12.661,02/11/2019 02:00:00,02/11/2019 04:00:00,02/11/2019 04:00:00,EXPIRED,LONG,9265.0,9223.0,9603.13,9152.29,1.644,3.52,1.23,4281.06,2,3.0,-531.76
11/03/2020 17:00:00,15/06/2023 18:58:14,Gemini_BTCUSD_1h_17_12_17_to_10_03_23.csv,BTC_USD,HOUR,70819.56,37.03,11/03/2020 18:00:00,11/03/2020 20:00:00,11/03/2020 18:00:00,STOP_LOSS_HIT,LONG,7672.0,7633.75,7786.74,7633.75,4.012,1.47,0.5,4248.82,2,3.0,-1416.4
13/08/2022 02:00:00,15/06/2023 18:58:14,Gemini_BTCUSD_1h_17_12_17_to_10_03_23.csv,BTC_USD,HOUR,69403.16,3.263,13/08/2022 03:00:00,13/08/2022 05:00:00,13/08/2022 05:00:00,EXPIRED,LONG,24690.0,24728.0,25966.18,24264.61,1.161,4.91,1.75,4164.18,2,3.0,123.99
27/04/2022 18:00:00,15/06/2023 18:58:14,Gemini_BTCUSD_1h_17_12_17_to_10_03_23.csv,BTC_USD,HOUR,69527.15,7.282,27/04/2022 22:00:00,27/04/2022 21:00:00,27/04/2022 21:00:00,TAKE_PROFIT_HIT,LONG,38790.0,39362.9,39362.9,38599.04,4.063,1.46,0.49,4171.86,2,3.0,4171.86
04/10/2022 20:00:00,15/06/2023 18:58:14,Gemini_BTCUSD_1h_17_12_17_to_10_03_23.csv,BTC_USD,HOUR,73699.01,3.78,04/10/2022 21:00:00,04/10/2022 23:00:00,04/10/2022 23:00:00,EXPIRED,LONG,20341.0,20340.0,21510.68,19951.11,1.043,5.44,1.95,4421.39,2,3.0,-3.78
05/01/2020 14:00:00,15/06/2023 18:58:14,Gemini_BTCUSD_1h_17_12_17_to_10_03_23.csv,BTC_USD,HOUR,73695.23,22.809,05/01/2020 17:00:00,05/01/2020 17:00:00,05/01/2020 17:00:00,EXPIRED,LONG,7437.0,7464.0,7630.87,7372.38,2.302,2.54,0.88,4421.98,2,3.0,615.84
22/12/2022 06:00:00,15/06/2023 18:58:14,Gemini_BTCUSD_1h_17_12_17_to_10_03_23.csv,BTC_USD,HOUR,74311.07,10.505,22/12/2022 07:00:00,22/12/2022 09:00:00,22/12/2022 09:00:00,EXPIRED,LONG,16816.0,16856.0,17240.45,16674.52,2.377,2.46,0.85,4458.85,2,3.0,420.2
25/11/2021 03:00:00,15/06/2023 18:58:14,Gemini_BTCUSD_1h_17_12_17_to_10_03_23.csv,BTC_USD,HOUR,74731.27,1.645,25/11/2021 04:00:00,25/11/2021 06:00:00,25/11/2021 06:00:00,EXPIRED,LONG,57756.0,57296.0,60481.81,56847.4,1.271,4.51,1.6,4483.96,2,3.0,-756.7
14/02/2020 14:00:00,15/06/2023 18:58:14,Gemini_BTCUSD_1h_17_12_17_to_10_03_23.csv,BTC_USD,HOUR,73974.57,12.56,14/02/2020 15:00:00,14/02/2020 17:00:00,14/02/2020 17:00:00,EXPIRED,LONG,10232.0,10296.0,10585.38,10114.21,1.737,3.34,1.16,4438.45,2,3.0,803.84
11/07/2021 23:00:00,15/06/2023 18:58:14,Gemini_BTCUSD_1h_17_12_17_to_10_03_23.csv,BTC_USD,HOUR,74778.41,9.308,12/07/2021 01:00:00,12/07/2021 02:00:00,12/07/2021 01:00:00,STOP_LOSS_HIT,LONG,34243.0,34082.32,34725.04,34082.32,4.262,1.39,0.47,4486.83,2,3.0,-1495.61
25/12/2018 11:00:00,15/06/2023 18:58:14,Gemini_BTCUSD_1h_17_12_17_to_10_03_23.csv,BTC_USD,HOUR,73282.8,80.178,25/12/2018 15:00:00,25/12/2018 14:00:00,25/12/2018 12:00:00,STOP_LOSS_HIT,LONG,3762.0,3743.72,3816.84,3743.72,4.116,1.44,0.49,4396.96,2,3.0,-1465.65
18/01/2022 07:00:00,15/06/2023 18:58:14,Gemini_BTCUSD_1h_17_12_17_to_10_03_23.csv,BTC_USD,HOUR,71817.15,1.934,18/01/2022 11:00:00,18/01/2022 10:00:00,18/01/2022 10:00:00,EXPIRED,LONG,42062.0,41945.0,44289.92,41319.36,1.133,5.03,1.8,4308.8,2,3.0,-226.28
29/08/2021 17:00:00,15/06/2023 18:58:14,Gemini_BTCUSD_1h_17_12_17_to_10_03_23.csv,BTC_USD,HOUR,71590.87,1.777,29/08/2021 18:00:00,29/08/2021 20:00:00,29/08/2021 20:00:00,EXPIRED,LONG,48797.0,48919.0,51214.9,47991.04,1.211,4.72,1.68,4296.61,2,3.0,216.79
23/08/2020 14:00:00,15/06/2023 18:58:14,Gemini_BTCUSD_1h_17_12_17_to_10_03_23.csv,BTC_USD,HOUR,71807.66,19.513,23/08/2020 16:00:00,23/08/2020 17:00:00,23/08/2020 17:00:00,EXPIRED,SHORT,11618.0,11640.0,11397.19,11691.6,3.157,1.94,0.63,4308.67,2,3.0,-429.29
12/01/2021 09:00:00,15/06/2023 18:58:14,Gemini_BTCUSD_1h_17_12_17_to_10_03_23.csv,BTC_USD,HOUR,71378.37,10.131,12/01/2021 11:00:00,12/01/2021 12:00:00,12/01/2021 10:00:00,STOP_LOSS_HIT,SHORT,35930.0,36070.91,35507.29,36070.91,5.1,1.19,0.39,4282.48,2,3.0,-1427.56
11/01/2019 17:00:00,15/06/2023 18:58:14,Gemini_BTCUSD_1h_17_12_17_to_10_03_23.csv,BTC_USD,HOUR,69950.81,25.651,11/01/2019 21:00:00,11/01/2019 20:00:00,11/01/2019 20:00:00,EXPIRED,LONG,3652.0,3655.0,3815.62,3597.46,1.339,4.29,1.52,4197.02,2,3.0,76.95
02/01/2018 17:00:00,15/06/2023 18:58:14,Gemini_BTCUSD_1h_17_12_17_to_10_03_23.csv,BTC_USD,HOUR,70027.76,18.494,02/01/2018 20:00:00,02/01/2018 20:00:00,02/01/2018 18:00:00,TAKE_PROFIT_HIT,LONG,13790.0,14017.19,14017.19,13714.27,3.642,1.62,0.55,4201.65,2,3.0,4201.65
07/05/2020 23:00:00,15/06/2023 18:58:14,Gemini_BTCUSD_1h_17_12_17_to_10_03_23.csv,BTC_USD,HOUR,74229.41,28.332,08/05/2020 03:00:00,08/05/2020 02:00:00,08/05/2020 00:00:00,STOP_LOSS_HIT,LONG,10004.0,9951.6,10161.19,9951.6,3.818,1.55,0.53,4453.51,2,3.0,-1484.6
27/06/2022 07:00:00,15/06/2023 18:58:14,Gemini_BTCUSD_1h_17_12_17_to_10_03_23.csv,BTC_USD,HOUR,72744.81,8.495,27/06/2022 11:00:00,27/06/2022 10:00:00,27/06/2022 10:00:00,EXPIRED,SHORT,21344.0,21431.0,20830.19,21515.27,2.493,2.47,0.8,4364.82,2,3.0,-739.06
08/03/2022 15:00:00,15/06/2023 18:58:14,Gemini_BTCUSD_1h_17_12_17_to_10_03_23.csv,BTC_USD,HOUR,72005.75,7.89,08/03/2022 17:00:00,08/03/2022 18:00:00,08/03/2022 16:00:00,STOP_LOSS_HIT,LONG,38647.0,38464.47,39194.6,38464.47,4.235,1.4,0.47,4320.56,2,3.0,-1440.16
12/10/2018 06:00:00,15/06/2023 18:58:14,Gemini_BTCUSD_1h_17_12_17_to_10_03_23.csv,BTC_USD,HOUR,70565.59,41.928,12/10/2018 07:00:00,12/10/2018 09:00:00,12/10/2018 09:00:00,EXPIRED,LONG,6215.0,6203.0,6315.97,6181.34,3.693,1.6,0.54,4233.47,2,3.0,-503.14
11/02/2019 16:00:00,15/06/2023 18:58:14,Gemini_BTCUSD_1h_17_12_17_to_10_03_23.csv,BTC_USD,HOUR,70062.45,18.141,11/02/2019 18:00:00,11/02/2019 19:00:00,11/02/2019 19:00:00,EXPIRED,LONG,3586.0,3601.0,3817.71,3508.76,0.929,6.07,2.2,4203.45,2,3.0,272.11
21/08/2021 13:00:00,15/06/2023 18:58:14,Gemini_BTCUSD_1h_17_12_17_to_10_03_23.csv,BTC_USD,HOUR,70334.56,2.447,21/08/2021 14:00:00,21/08/2021 16:00:00,21/08/2021 16:00:00,EXPIRED,SHORT,49176.0,49537.0,47451.26,49750.92,1.711,3.63,1.16,4220.44,2,3.0,-883.37
11/10/2019 05:00:00,15/06/2023 18:58:14,Gemini_BTCUSD_1h_17_12_17_to_10_03_23.csv,BTC_USD,HOUR,69451.19,10.392,11/10/2019 06:00:00,11/10/2019 08:00:00,11/10/2019 08:00:00,EXPIRED,SHORT,8443.0,8375.0,8042.02,8576.66,1.263,4.99,1.56,4166.98,2,3.0,706.66
21/01/2020 15:00:00,15/06/2023 18:58:14,Gemini_BTCUSD_1h_17_12_17_to_10_03_23.csv,BTC_USD,HOUR,70157.85,14.403,21/01/2020 16:00:00,21/01/2020 18:00:00,21/01/2020 18:00:00,EXPIRED,LONG,8630.0,8615.0,8922.26,8532.58,1.772,3.28,1.14,4209.42,2,3.0,-216.04
03/07/2020 20:00:00,15/06/2023 18:58:14,Gemini_BTCUSD_1h_17_12_17_to_10_03_23.csv,BTC_USD,HOUR,69941.81,15.751,03/07/2020 22:00:00,03/07/2020 23:00:00,03/07/2020 23:00:00,EXPIRED,SHORT,9093.0,9072.0,8826.56,9181.81,2.048,3.02,0.97,4196.7,2,3.0,330.77
08/12/2022 18:00:00,15/06/2023 18:58:14,Gemini_BTCUSD_1h_17_12_17_to_10_03_23.csv,BTC_USD,HOUR,70272.58,6.91,08/12/2022 19:00:00,08/12/2022 21:00:00,08/12/2022 21:00:00,EXPIRED,LONG,17257.0,17186.0,17867.16,17053.62,1.697,3.41,1.19,4216.21,2,3.0,-490.61
27/06/2021 07:00:00,15/06/2023 18:58:14,Gemini_BTCUSD_1h_17_12_17_to_10_03_23.csv,BTC_USD,HOUR,69781.97,2.648,27/06/2021 10:00:00,27/06/2021 10:00:00,27/06/2021 09:00:00,STOP_LOSS_HIT,LONG,33304.0,32777.02,34884.93,32777.02,1.264,4.53,1.61,4186.3,2,3.0,-1395.44
05/12/2021 05:00:00,15/06/2023 18:58:14,Gemini_BTCUSD_1h_17_12_17_to_10_03_23.csv,BTC_USD,HOUR,68386.53,3.017,05/12/2021 06:00:00,05/12/2021 08:00:00,05/12/2021 08:00:00,EXPIRED,LONG,49495.0,49587.0,50854.94,49041.69,2.184,2.67,0.92,4102.94,2,3.0,277.56
21/05/2022 09:00:00,15/06/2023 18:58:14,Gemini_BTCUSD_1h_17_12_17_to_10_03_23.csv,BTC_USD,HOUR,68664.09,9.479,21/05/2022 10:00:00,21/05/2022 12:00:00,21/05/2022 11:00:00,STOP_LOSS_HIT,LONG,29294.0,29149.13,29728.62,29149.13,4.044,1.46,0.5,4119.76,2,3.0,-1373.22
12/09/2021 19:00:00,15/06/2023 18:58:14,Gemini_BTCUSD_1h_17_12_17_to_10_03_23.csv,BTC_USD,HOUR,67290.87,5.7,12/09/2021 23:00:00,12/09/2021 22:00:00,12/09/2021 20:00:00,STOP_LOSS_HIT,SHORT,45918.0,46154.13,45209.63,46154.13,3.89,1.57,0.51,4037.71,2,3.0,-1345.94
08/12/2022 23:00:00,15/06/2023 18:58:14,Gemini_BTCUSD_1h_17_12_17_to_10_03_23.csv,BTC_USD,HOUR,65944.93,7.573,09/12/2022 01:00:00,09/12/2022 02:00:00,09/12/2022 02:00:00,EXPIRED,SHORT,17233.0,17217.0,16710.54,17407.15,1.979,3.13,1.0,3956.59,2,3.0,121.17
06/08/2021 12:00:00,15/06/2023 18:58:14,Gemini_BTCUSD_1h_17_12_17_to_10_03_23.csv,BTC_USD,HOUR,66066.1,3.957,06/08/2021 13:00:00,06/08/2021 15:00:00,06/08/2021 15:00:00,TAKE_PROFIT_HIT,LONG,40794.0,41795.64,41795.64,40460.12,2.443,2.4,0.83,3963.49,2,3.0,3963.49
19/04/2022 15:00:00,15/06/2023 18:58:14,Gemini_BTCUSD_1h_17_12_17_to_10_03_23.csv,BTC_USD,HOUR,70029.59,5.648,19/04/2022 17:00:00,19/04/2022 18:00:00,19/04/2022 17:00:00,STOP_LOSS_HIT,LONG,41472.0,41224.01,42215.99,41224.01,3.345,1.76,0.6,4202.06,2,3.0,-1400.65
20/11/2020 15:00:00,15/06/2023 18:58:14,Gemini_BTCUSD_1h_17_12_17_to_10_03_23.csv,BTC_USD,HOUR,68628.94,70.318,20/11/2020 16:00:00,20/11/2020 18:00:00,20/11/2020 16:00:00,STOP_LOSS_HIT,SHORT,18686.0,18705.52,18627.44,18705.52,19.146,0.31,0.1,4117.82,2,3.0,-1372.61
26/06/2022 03:00:00,15/06/2023 18:58:14,Gemini_BTCUSD_1h_17_12_17_to_10_03_23.csv,BTC_USD,HOUR,67256.33,11.502,26/06/2022 04:00:00,26/06/2022 06:00:00,26/06/2022 06:00:00,EXPIRED,LONG,21412.0,21465.0,21762.84,21295.05,3.662,1.61,0.55,4035.36,2,3.0,609.61
13/02/2020 07:00:00,15/06/2023 18:58:14,Gemini_BTCUSD_1h_17_12_17_to_10_03_23.csv,BTC_USD,HOUR,67865.94,9.884,13/02/2020 08:00:00,13/02/2020 10:00:00,13/02/2020 08:00:00,STOP_LOSS_HIT,LONG,10356.0,10218.67,10767.98,10218.67,1.508,3.83,1.34,4072.01,2,3.0,-1357.37
30/10/2018 22:00:00,15/06/2023 18:58:14,Gemini_BTCUSD_1h_17_12_17_to_10_03_23.csv,BTC_USD,HOUR,66508.57,16.969,30/10/2018 23:00:00,31/10/2018 01:00:00,31/10/2018 01:00:00,EXPIRED,LONG,6273.0,6265.0,6508.18,6194.61,1.6,3.61,1.27,3990.77,2,3.0,-135.75
14/09/2018 18:00:00,15/06/2023 18:58:14,Gemini_BTCUSD_1h_17_12_17_to_10_03_23.csv,BTC_USD,HOUR,66372.82,22.307,14/09/2018 19:00:00,14/09/2018 21:00:00,14/09/2018 21:00:00,EXPIRED,LONG,6467.0,6515.0,6645.52,6407.49,2.173,2.69,0.93,3982.25,2,3.0,1070.74
25/03/2022 08:00:00,15/06/2023 18:58:14,Gemini_BTCUSD_1h_17_12_17_to_10_03_23.csv,BTC_USD,HOUR,67443.56,6.594,25/03/2022 12:00:00,25/03/2022 11:00:00,25/03/2022 10:00:00,STOP_LOSS_HIT,SHORT,44027.0,44231.56,43413.33,44231.56,4.305,1.41,0.46,4046.54,2,3.0,-1348.87
22/12/2018 11:00:00,15/06/2023 18:58:14,Gemini_BTCUSD_1h_17_12_17_to_10_03_23.csv,BTC_USD,HOUR,66094.69,71.686,22/12/2018 15:00:00,22/12/2018 14:00:00,22/12/2018 12:00:00,TAKE_PROFIT_HIT,SHORT,3884.0,3828.67,3828.67,3902.44,4.213,1.45,0.47,3966.39,2,3.0,3966.39
27/06/2020 15:00:00,15/06/2023 18:58:14,Gemini_BTCUSD_1h_17_12_17_to_10_03_23.csv,BTC_USD,HOUR,70061.08,10.728,27/06/2020 16:00:00,27/06/2020 18:00:00,27/06/2020 18:00:00,EXPIRED,LONG,9123.0,9086.0,9514.82,8992.39,1.397,4.12,1.45,4203.44,2,3.0,-396.94
08/08/2020 05:00:00,15/06/2023 18:58:14,Gemini_BTCUSD_1h_17_12_17_to_10_03_23.csv,BTC_USD,HOUR,69664.14,21.343,08/08/2020 08:00:00,08/08/2020 08:00:00,08/08/2020 08:00:00,EXPIRED,LONG,11624.0,11597.0,11819.84,11558.72,3.561,1.66,0.56,4179.81,2,3.0,-576.26
05/06/2021 20:00:00,15/06/2023 18:58:14,Gemini_BTCUSD_1h_17_12_17_to_10_03_23.csv,BTC_USD,HOUR,69087.88,6.333,05/06/2021 22:00:00,05/06/2021 23:00:00,05/06/2021 21:00:00,TAKE_PROFIT_HIT,SHORT,35861.0,35206.47,35206.47,36079.18,3.287,1.86,0.6,4145.14,2,3.0,4145.14
08/03/2022 18:00:00,15/06/2023 18:58:14,Gemini_BTCUSD_1h_17_12_17_to_10_03_23.csv,BTC_USD,HOUR,73233.02,2.549,08/03/2022 19:00:00,08/03/2022 21:00:00,08/03/2022 21:00:00,EXPIRED,SHORT,38696.0,38505.0,36972.45,39270.52,1.347,4.66,1.46,4393.33,2,3.0,486.86
08/05/2021 08:00:00,15/06/2023 18:58:14,Gemini_BTCUSD_1h_17_12_17_to_10_03_23.csv,BTC_USD,HOUR,73719.88,5.096,08/05/2021 10:00:00,08/05/2021 11:00:00,08/05/2021 10:00:00,STOP_LOSS_HIT,LONG,58953.0,58663.68,59820.97,58663.68,4.075,1.45,0.49,4423.18,2,3.0,-1474.37
19/05/2020 08:00:00,15/06/2023 18:58:14,Gemini_BTCUSD_1h_17_12_17_to_10_03_23.csv,BTC_USD,HOUR,72245.51,22.056,19/05/2020 11:00:00,19/05/2020 11:00:00,19/05/2020 11:00:00,STOP_LOSS_HIT,LONG,9795.0,9729.49,9991.53,9729.49,2.99,1.97,0.67,4334.67,2,3.0,-1444.89
02/03/2020 12:00:00,15/06/2023 18:58:14,Gemini_BTCUSD_1h_17_12_17_to_10_03_23.csv,BTC_USD,HOUR,70800.62,8.121,02/03/2020 13:00:00,02/03/2020 15:00:00,02/03/2020 15:00:00,EXPIRED,LONG,8754.0,8824.0,9277.13,8579.63,1.004,5.64,2.03,4248.34,2,3.0,568.47
08/02/2020 20:00:00,15/06/2023 18:58:14,Gemini_BTCUSD_1h_17_12_17_to_10_03_23.csv,BTC_USD,HOUR,71369.09,20.798,08/02/2020 23:00:00,08/02/2020 23:00:00,08/02/2020 23:00:00,EXPIRED,LONG,9876.0,9913.0,10081.9,9807.37,2.878,2.04,0.7,4282.31,2,3.0,769.53
12/11/2019 03:00:00,15/06/2023 18:58:14,Gemini_BTCUSD_1h_17_12_17_to_10_03_23.csv,BTC_USD,HOUR,72138.62,9.633,12/11/2019 04:00:00,12/11/2019 06:00:00,12/11/2019 06:00:00,EXPIRED,LONG,8730.0,8759.0,9179.34,8580.22,1.166,4.9,1.75,4328.49,2,3.0,279.36
16/12/2018 05:00:00,15/06/2023 18:58:14,Gemini_BTCUSD_1h_17_12_17_to_10_03_23.csv,BTC_USD,HOUR,72417.98,501.181,16/12/2018 07:00:00,16/12/2018 08:00:00,16/12/2018 06:00:00,STOP_LOSS_HIT,SHORT,3235.0,3237.89,3226.34,3237.89,22.388,0.27,0.09,4340.23,2,3.0,-1448.41
02/11/2020 16:00:00,15/06/2023 18:58:14,Gemini_BTCUSD_1h_17_12_17_to_10_03_23.csv,BTC_USD,HOUR,70969.57,10.911,02/11/2020 18:00:00,02/11/2020 19:00:00,02/11/2020 19:00:00,EXPIRED,LONG,13537.0,13577.0,13927.26,13406.91,2.081,2.8,0.97,4258.13,2,3.0,436.44
30/05/2020 06:00:00,15/06/2023 18:58:14,Gemini_BTCUSD_1h_17_12_17_to_10_03_23.csv,BTC_USD,HOUR,71406.01,11.792,30/05/2020 07:00:00,30/05/2020 09:00:00,30/05/2020 09:00:00,EXPIRED,LONG,9544.0,9499.0,9907.34,9422.89,1.576,3.67,1.29,4284.51,2,3.0,-530.64
26/10/2019 02:00:00,15/06/2023 18:58:14,Gemini_BTCUSD_1h_17_12_17_to_10_03_23.csv,BTC_USD,HOUR,70875.37,24.31,26/10/2019 03:00:00,26/10/2019 05:00:00,26/10/2019 03:00:00,STOP_LOSS_HIT,SHORT,9666.0,9724.31,9491.08,9724.31,3.315,1.84,0.6,4252.31,2,3.0,-1417.52
18/09/2022 05:00:00,15/06/2023 18:58:14,Gemini_BTCUSD_1h_17_12_17_to_10_03_23.csv,BTC_USD,HOUR,69457.85,12.297,18/09/2022 07:00:00,18/09/2022 08:00:00,18/09/2022 08:00:00,EXPIRED,SHORT,20067.0,20047.0,19728.1,20179.97,3.553,1.72,0.56,4167.45,2,3.0,245.94
25/02/2022 10:00:00,15/06/2023 18:58:14,Gemini_BTCUSD_1h_17_12_17_to_10_03_23.csv,BTC_USD,HOUR,69703.79,4.264,25/02/2022 13:00:00,25/02/2022 13:00:00,25/02/2022 12:00:00,STOP_LOSS_HIT,SHORT,38587.0,38913.92,37606.24,38913.92,2.36,2.61,0.84,4181.96,2,3.0,-1393.99
22/03/2022 03:00:00,15/06/2023 18:58:14,Gemini_BTCUSD_1h_17_12_17_to_10_03_23.csv,BTC_USD,HOUR,68309.8,6.41,22/03/2022 05:00:00,22/03/2022 06:00:00,22/03/2022 04:00:00,TAKE_PROFIT_HIT,LONG,42240.0,42879.45,42879.45,42026.85,3.964,1.49,0.51,4098.87,2,3.0,4098.87
29/10/2018 03:00:00,15/06/2023 18:58:14,Gemini_BTCUSD_1h_17_12_17_to_10_03_23.csv,BTC_USD,HOUR,72408.67,12.815,29/10/2018 04:00:00,29/10/2018 06:00:00,29/10/2018 06:00:00,EXPIRED,LONG,6405.0,6396.0,6744.04,6291.99,1.134,5.03,1.8,4344.8,2,3.0,-115.33
11/02/2020 11:00:00,15/06/2023 18:58:14,Gemini_BTCUSD_1h_17_12_17_to_10_03_23.csv,BTC_USD,HOUR,72293.34,17.399,11/02/2020 12:00:00,11/02/2020 14:00:00,11/02/2020 14:00:00,EXPIRED,LONG,9810.0,9861.0,10059.3,9726.9,2.361,2.48,0.85,4337.57,2,3.0,887.35
24/10/2021 15:00:00,15/06/2023 18:58:15,Gemini_BTCUSD_1h_17_12_17_to_10_03_23.csv,BTC_USD,HOUR,73180.69,2.284,24/10/2021 17:00:00,24/10/2021 18:00:00,24/10/2021 18:00:00,EXPIRED,LONG,59879.0,60100.0,61801.27,59238.24,1.869,3.11,1.08,4390.46,2,3.0,504.76
18/02/2023 21:00:00,15/06/2023 18:58:15,Gemini_BTCUSD_1h_17_12_17_to_10_03_23.csv,BTC_USD,HOUR,73685.45,4.088,18/02/2023 22:00:00,19/02/2023 00:00:00,19/02/2023 00:00:00,EXPIRED,LONG,24627.0,24752.0,25708.61,24266.46,1.366,4.21,1.49,4421.62,2,3.0,511.0
23/08/2022 01:00:00,15/06/2023 18:58:15,Gemini_BTCUSD_1h_17_12_17_to_10_03_23.csv,BTC_USD,HOUR,74196.45,6.309,23/08/2022 03:00:00,23/08/2022 04:00:00,23/08/2022 04:00:00,EXPIRED,LONG,21307.0,21257.0,22012.6,21071.8,1.812,3.21,1.12,4451.63,2,3.0,-315.45
25/08/2021 03:00:00,15/06/2023 18:58:15,Gemini_BTCUSD_1h_17_12_17_to_10_03_23.csv,BTC_USD,HOUR,73881.0,2.916,25/08/2021 04:00:00,25/08/2021 06:00:00,25/08/2021 06:00:00,EXPIRED,LONG,47996.0,48343.0,49516.2,47489.27,1.894,3.07,1.07,4432.9,2,3.0,1011.85
20/03/2020 01:00:00,15/06/2023 18:58:15,Gemini_BTCUSD_1h_17_12_17_to_10_03_23.csv,BTC_USD,HOUR,74892.85,19.808,20/03/2020 02:00:00,20/03/2020 04:00:00,20/03/2020 04:00:00,EXPIRED,LONG,6188.0,6207.0,6414.85,6112.38,1.637,3.54,1.24,4493.44,2,3.0,376.35
02/08/2018 17:00:00,15/06/2023 18:58:15,Gemini_BTCUSD_1h_17_12_17_to_10_03_23.csv,BTC_USD,HOUR,75269.2,16.63,02/08/2018 21:00:00,02/08/2018 20:00:00,02/08/2018 20:00:00,EXPIRED,LONG,7503.0,7559.0,7774.56,7412.48,1.658,3.49,1.22,4516.04,2,3.0,931.28
23/05/2021 00:00:00,15/06/2023 18:58:15,Gemini_BTCUSD_1h_17_12_17_to_10_03_23.csv,BTC_USD,HOUR,76200.48,4.689,23/05/2021 01:00:00,23/05/2021 03:00:00,23/05/2021 02:00:00,STOP_LOSS_HIT,LONG,38214.0,37888.95,39189.16,37888.95,2.352,2.49,0.86,4572.53,2,3.0,-1524.16
03/04/2021 04:00:00,15/06/2023 18:58:15,Gemini_BTCUSD_1h_17_12_17_to_10_03_23.csv,BTC_USD,HOUR,74676.32,4.706,03/04/2021 07:00:00,03/04/2021 07:00:00,03/04/2021 07:00:00,EXPIRED,LONG,59419.0,59301.0,60371.03,59101.66,3.745,1.58,0.54,4480.25,2,3.0,-555.31
02/04/2019 21:00:00,15/06/2023 18:58:15,Gemini_BTCUSD_1h_17_12_17_to_10_03_23.csv,BTC_USD,HOUR,74121.01,19.503,02/04/2019 22:00:00,03/04/2019 00:00:00,03/04/2019 00:00:00,EXPIRED,LONG,4789.0,4979.0,5017.04,4712.99,1.26,4.55,1.61,4447.46,2,3.0,3705.57
29/12/2017 20:00:00,15/06/2023 18:58:15,Gemini_BTCUSD_1h_17_12_17_to_10_03_23.csv,BTC_USD,HOUR,77826.58,20.657,29/12/2017 21:00:00,29/12/2017 23:00:00,29/12/2017 21:00:00,STOP_LOSS_HIT,LONG,14416.0,14340.65,14642.06,14340.65,3.826,1.54,0.53,4669.72,2,3.0,-1556.5
04/01/2023 20:00:00,15/06/2023 18:58:15,Gemini_BTCUSD_1h_17_12_17_to_10_03_23.csv,BTC_USD,HOUR,76270.08,4.486,04/01/2023 22:00:00,04/01/2023 23:00:00,04/01/2023 23:00:00,EXPIRED,LONG,16800.0,16854.0,17820.07,16459.98,0.988,5.72,2.07,4576.03,2,3.0,242.24
04/08/2022 06:00:00,15/06/2023 18:58:15,Gemini_BTCUSD_1h_17_12_17_to_10_03_23.csv,BTC_USD,HOUR,76512.32,11.534,04/08/2022 10:00:00,04/08/2022 09:00:00,04/08/2022 08:00:00,STOP_LOSS_HIT,LONG,22914.0,22781.33,23312.01,22781.33,3.454,1.71,0.58,4590.65,2,3.0,-1530.22
04/04/2021 18:00:00,15/06/2023 18:58:15,Gemini_BTCUSD_1h_17_12_17_to_10_03_23.csv,BTC_USD,HOUR,74982.1,2.162,04/04/2021 21:00:00,04/04/2021 21:00:00,04/04/2021 21:00:00,EXPIRED,LONG,58136.0,58139.0,60216.96,57442.35,1.676,3.46,1.21,4499.04,2,3.0,6.49
01/05/2021 20:00:00,15/06/2023 18:58:15,Gemini_BTCUSD_1h_17_12_17_to_10_03_23.csv,BTC_USD,HOUR,74988.59,1.4,01/05/2021 21:00:00,01/05/2021 23:00:00,01/05/2021 23:00:00,EXPIRED,LONG,57802.0,57869.0,61015.92,56730.7,1.079,5.27,1.89,4499.49,2,3.0,93.8
14/02/2021 22:00:00,15/06/2023 18:58:15,Gemini_BTCUSD_1h_17_12_17_to_10_03_23.csv,BTC_USD,HOUR,75082.39,6.024,15/02/2021 00:00:00,15/02/2021 01:00:00,14/02/2021 23:00:00,STOP_LOSS_HIT,LONG,49118.0,48868.74,49865.79,48868.74,3.941,1.5,0.51,4504.69,2,3.0,-1501.54
04/12/2022 06:00:00,15/06/2023 18:58:15,Gemini_BTCUSD_1h_17_12_17_to_10_03_23.csv,BTC_USD,HOUR,73580.85,9.887,04/12/2022 09:00:00,04/12/2022 09:00:00,04/12/2022 09:00:00,EXPIRED,SHORT,17006.0,17014.0,16559.45,17154.85,2.285,2.7,0.87,4415.04,2,3.0,-79.1
12/09/2022 11:00:00,15/06/2023 18:58:15,Gemini_BTCUSD_1h_17_12_17_to_10_03_23.csv,BTC_USD,HOUR,73501.75,11.535,12/09/2022 13:00:00,12/09/2022 14:00:00,12/09/2022 13:00:00,STOP_LOSS_HIT,SHORT,22328.0,22455.44,21945.69,22455.44,3.504,1.74,0.57,4409.95,2,3.0,-1470.02
20/06/2019 21:00:00,15/06/2023 18:58:15,Gemini_BTCUSD_1h_17_12_17_to_10_03_23.csv,BTC_USD,HOUR,72031.73,9.143,20/06/2019 22:00:00,21/06/2019 00:00:00,21/06/2019 00:00:00,EXPIRED,LONG,9523.0,9586.0,9995.7,9365.43,1.209,4.73,1.68,4321.9,2,3.0,576.01
19/02/2018 23:00:00,15/06/2023 18:58:15,Gemini_BTCUSD_1h_17_12_17_to_10_03_23.csv,BTC_USD,HOUR,72607.74,275.015,20/02/2018 03:00:00,20/02/2018 02:00:00,20/02/2018 00:00:00,STOP_LOSS_HIT,LONG,11167.0,11161.72,11182.84,11161.72,42.297,0.14,0.05,4356.24,2,3.0,-1452.08
02/08/2022 21:00:00,15/06/2023 18:58:15,Gemini_BTCUSD_1h_17_12_17_to_10_03_23.csv,BTC_USD,HOUR,71155.66,11.379,02/08/2022 23:00:00,03/08/2022 00:00:00,03/08/2022 00:00:00,EXPIRED,SHORT,23094.0,22800.0,22718.81,23219.06,3.693,1.65,0.54,4269.29,2,3.0,3345.43
10/07/2020 20:00:00,15/06/2023 18:58:15,Gemini_BTCUSD_1h_17_12_17_to_10_03_23.csv,BTC_USD,HOUR,74501.09,16.224,10/07/2020 22:00:00,10/07/2020 23:00:00,10/07/2020 23:00:00,EXPIRED,SHORT,9235.0,9292.0,8959.47,9326.84,2.011,3.08,0.98,4470.2,2,3.0,-924.77
22/10/2020 02:00:00,15/06/2023 18:58:15,Gemini_BTCUSD_1h_17_12_17_to_10_03_23.csv,BTC_USD,HOUR,73576.32,19.859,22/10/2020 05:00:00,22/10/2020 05:00:00,22/10/2020 05:00:00,EXPIRED,SHORT,12810.0,12778.0,12587.7,12884.1,3.458,1.77,0.58,4414.66,2,3.0,635.49
18/07/2021 06:00:00,15/06/2023 18:58:15,Gemini_BTCUSD_1h_17_12_17_to_10_03_23.csv,BTC_USD,HOUR,74211.81,8.642,18/07/2021 08:00:00,18/07/2021 09:00:00,18/07/2021 07:00:00,STOP_LOSS_HIT,LONG,31894.0,31722.26,32409.21,31722.26,3.714,1.59,0.54,4452.44,2,3.0,-1484.18
22/12/2022 02:00:00,15/06/2023 18:58:15,Gemini_BTCUSD_1h_17_12_17_to_10_03_23.csv,BTC_USD,HOUR,72727.63,4.969,22/12/2022 04:00:00,22/12/2022 05:00:00,22/12/2022 05:00:00,EXPIRED,LONG,16852.0,16829.0,17730.14,16559.29,1.151,4.95,1.77,4363.48,2,3.0,-114.29
13/03/2018 21:00:00,15/06/2023 18:58:15,Gemini_BTCUSD_1h_17_12_17_to_10_03_23.csv,BTC_USD,HOUR,72613.34,10.156,14/03/2018 01:00:00,14/03/2018 00:00:00,13/03/2018 22:00:00,STOP_LOSS_HIT,SHORT,9102.0,9245.0,8673.01,9245.0,1.273,4.95,1.55,4356.82,2,3.0,-1452.31
17/07/2018 18:00:00,15/06/2023 18:58:15,Gemini_BTCUSD_1h_17_12_17_to_10_03_23.csv,BTC_USD,HOUR,71161.03,12.234,17/07/2018 19:00:00,17/07/2018 21:00:00,17/07/2018 21:00:00,EXPIRED,SHORT,7339.0,7352.0,6990.01,7455.33,1.262,4.99,1.56,4269.54,2,3.0,-159.04
16/09/2022 17:00:00,15/06/2023 18:58:15,Gemini_BTCUSD_1h_17_12_17_to_10_03_23.csv,BTC_USD,HOUR,71001.99,9.93,16/09/2022 18:00:00,16/09/2022 20:00:00,16/09/2022 20:00:00,EXPIRED,LONG,19437.0,19750.0,19866.0,19294.0,2.718,2.16,0.74,4259.97,2,3.0,3108.09
06/03/2023 10:00:00,15/06/2023 18:58:15,Gemini_BTCUSD_1h_17_12_17_to_10_03_23.csv,BTC_USD,HOUR,74110.08,11.866,06/03/2023 12:00:00,06/03/2023 13:00:00,06/03/2023 13:00:00,EXPIRED,SHORT,22402.0,22438.0,22027.28,22526.91,3.587,1.7,0.55,4446.43,2,3.0,-427.18
15/04/2020 22:00:00,15/06/2023 18:58:15,Gemini_BTCUSD_1h_17_12_17_to_10_03_23.csv,BTC_USD,HOUR,73682.9,19.67,16/04/2020 02:00:00,16/04/2020 01:00:00,15/04/2020 23:00:00,STOP_LOSS_HIT,LONG,6718.0,6643.08,6942.76,6643.08,1.793,3.24,1.13,4421.03,2,3.0,-1473.68
09/01/2021 21:00:00,15/06/2023 18:58:15,Gemini_BTCUSD_1h_17_12_17_to_10_03_23.csv,BTC_USD,HOUR,72209.22,3.492,09/01/2021 22:00:00,10/01/2021 00:00:00,09/01/2021 22:00:00,STOP_LOSS_HIT,LONG,40892.0,40478.46,42132.62,40478.46,1.978,2.94,1.02,4332.25,2,3.0,-1444.08
13/02/2018 13:00:00,15/06/2023 18:58:15,Gemini_BTCUSD_1h_17_12_17_to_10_03_23.csv,BTC_USD,HOUR,70765.14,8.281,13/02/2018 15:00:00,13/02/2018 16:00:00,13/02/2018 16:00:00,EXPIRED,LONG,8595.0,8562.0,9107.69,8424.1,1.006,5.63,2.03,4245.59,2,3.0,-273.27
12/09/2020 17:00:00,15/06/2023 18:58:15,Gemini_BTCUSD_1h_17_12_17_to_10_03_23.csv,BTC_USD,HOUR,70491.87,10.906,12/09/2020 18:00:00,12/09/2020 20:00:00,12/09/2020 20:00:00,EXPIRED,LONG,10384.0,10445.0,10771.81,10254.73,1.607,3.6,1.26,4229.46,2,3.0,665.27
06/05/2020 05:00:00,15/06/2023 18:58:15,Gemini_BTCUSD_1h_17_12_17_to_10_03_23.csv,BTC_USD,HOUR,71157.14,16.119,06/05/2020 09:00:00,06/05/2020 08:00:00,06/05/2020 08:00:00,EXPIRED,LONG,9012.0,9046.0,9276.88,8923.71,2.041,2.86,0.99,4269.6,2,3.0,548.05
04/09/2021 09:00:00,15/06/2023 18:58:15,Gemini_BTCUSD_1h_17_12_17_to_10_03_23.csv,BTC_USD,HOUR,71705.19,5.85,04/09/2021 10:00:00,04/09/2021 12:00:00,04/09/2021 10:00:00,STOP_LOSS_HIT,LONG,50429.0,50183.84,51164.49,50183.84,4.114,1.44,0.49,4302.62,2,3.0,-1434.19
28/08/2020 04:00:00,15/06/2023 18:58:15,Gemini_BTCUSD_1h_17_12_17_to_10_03_23.csv,BTC_USD,HOUR,70271.0,14.953,28/08/2020 06:00:00,28/08/2020 07:00:00,28/08/2020 07:00:00,EXPIRED,SHORT,11399.0,11382.0,11117.02,11492.99,2.426,2.54,0.82,4216.45,2,3.0,254.2
29/03/2019 13:00:00,15/06/2023 18:58:15,Gemini_BTCUSD_1h_17_12_17_to_10_03_23.csv,BTC_USD,HOUR,70525.2,35.991,29/03/2019 15:00:00,29/03/2019 16:00:00,29/03/2019 16:00:00,EXPIRED,SHORT,4081.0,4081.0,3963.42,4120.19,2.083,2.97,0.95,4231.82,2,3.0,0.0
28/11/2019 10:00:00,15/06/2023 18:58:15,Gemini_BTCUSD_1h_17_12_17_to_10_03_23.csv,BTC_USD,HOUR,70525.2,10.117,28/11/2019 11:00:00,28/11/2019 13:00:00,28/11/2019 13:00:00,EXPIRED,LONG,7488.0,7463.0,7906.27,7348.58,1.074,5.29,1.9,4231.64,2,3.0,-252.92
15/04/2022 12:00:00,15/06/2023 18:58:15,Gemini_BTCUSD_1h_17_12_17_to_10_03_23.csv,BTC_USD,HOUR,70272.28,2.609,15/04/2022 15:00:00,15/04/2022 15:00:00,15/04/2022 14:00:00,STOP_LOSS_HIT,SHORT,40149.0,40687.65,38533.05,40687.65,1.491,4.19,1.32,4216.01,2,3.0,-1405.34
31/03/2020 02:00:00,15/06/2023 18:58:15,Gemini_BTCUSD_1h_17_12_17_to_10_03_23.csv,BTC_USD,HOUR,68866.94,25.111,31/03/2020 04:00:00,31/03/2020 05:00:00,31/03/2020 04:00:00,STOP_LOSS_HIT,LONG,6467.0,6412.15,6631.54,6412.15,2.358,2.48,0.86,4131.76,2,3.0,-1377.34
06/07/2018 16:00:00,15/06/2023 18:58:15,Gemini_BTCUSD_1h_17_12_17_to_10_03_23.csv,BTC_USD,HOUR,67489.6,17.385,06/07/2018 17:00:00,06/07/2018 19:00:00,06/07/2018 19:00:00,EXPIRED,LONG,6560.0,6571.0,6792.93,6482.36,1.69,3.43,1.2,4049.49,2,3.0,191.24
19/01/2020 21:00:00,15/06/2023 18:58:15,Gemini_BTCUSD_1h_17_12_17_to_10_03_23.csv,BTC_USD,HOUR,67680.84,16.18,19/01/2020 23:00:00,20/01/2020 00:00:00,19/01/2020 22:00:00,STOP_LOSS_HIT,LONG,8721.0,8637.34,8971.99,8637.34,2.085,2.8,0.97,4061.02,2,3.0,-1353.62
05/01/2022 11:00:00,15/06/2023 18:58:15,Gemini_BTCUSD_1h_17_12_17_to_10_03_23.csv,BTC_USD,HOUR,66327.22,5.612,05/01/2022 13:00:00,05/01/2022 14:00:00,05/01/2022 12:00:00,STOP_LOSS_HIT,LONG,46275.0,46038.61,46984.18,46038.61,3.915,1.51,0.51,3979.92,2,3.0,-1326.62
06/07/2018 03:00:00,15/06/2023 18:58:15,Gemini_BTCUSD_1h_17_12_17_to_10_03_23.csv,BTC_USD,HOUR,65000.6,34.909,06/07/2018 05:00:00,06/07/2018 06:00:00,06/07/2018 06:00:00,EXPIRED,SHORT,6526.0,6466.0,6414.27,6563.24,3.505,1.74,0.57,3900.38,2,3.0,2094.54
11/12/2018 19:00:00,15/06/2023 18:58:15,Gemini_BTCUSD_1h_17_12_17_to_10_03_23.csv,BTC_USD,HOUR,67095.14,22.184,11/12/2018 20:00:00,11/12/2018 22:00:00,11/12/2018 22:00:00,EXPIRED,LONG,3332.0,3363.0,3513.47,3271.51,1.102,5.16,1.85,4025.73,2,3.0,687.7
02/03/2020 20:00:00,15/06/2023 18:58:15,Gemini_BTCUSD_1h_17_12_17_to_10_03_23.csv,BTC_USD,HOUR,67782.84,18.444,02/03/2020 21:00:00,02/03/2020 23:00:00,02/03/2020 23:00:00,EXPIRED,LONG,8892.0,8913.0,9112.5,8818.5,2.42,2.42,0.83,4066.9,2,3.0,387.32
20/12/2021 18:00:00,15/06/2023 18:58:15,Gemini_BTCUSD_1h_17_12_17_to_10_03_23.csv,BTC_USD,HOUR,68170.16,2.418,20/12/2021 22:00:00,20/12/2021 21:00:00,20/12/2021 20:00:00,STOP_LOSS_HIT,SHORT,46270.0,46833.8,44578.61,46833.8,1.641,3.79,1.2,4089.78,2,3.0,-1363.27
23/04/2022 18:00:00,15/06/2023 18:58:15,Gemini_BTCUSD_1h_17_12_17_to_10_03_23.csv,BTC_USD,HOUR,66806.89,2.291,23/04/2022 19:00:00,23/04/2022 21:00:00,23/04/2022 21:00:00,EXPIRED,LONG,39691.0,39909.0,41440.92,39107.7,1.361,4.22,1.49,4009.07,2,3.0,499.44
15/12/2021 11:00:00,15/06/2023 18:58:15,Gemini_BTCUSD_1h_17_12_17_to_10_03_23.csv,BTC_USD,HOUR,67306.33,1.553,15/12/2021 12:00:00,15/12/2021 14:00:00,15/12/2021 14:00:00,STOP_LOSS_HIT,LONG,48145.0,47278.33,50745.02,47278.33,1.111,5.12,1.83,4037.83,2,3.0,-1345.94
11/12/2018 08:00:00,15/06/2023 18:58:15,Gemini_BTCUSD_1h_17_12_17_to_10_03_23.csv,BTC_USD,HOUR,65960.39,28.924,11/12/2018 09:00:00,11/12/2018 11:00:00,11/12/2018 10:00:00,STOP_LOSS_HIT,LONG,3410.0,3364.39,3546.83,3364.39,1.495,3.86,1.36,3957.67,2,3.0,-1319.22
26/08/2021 16:00:00,15/06/2023 18:58:15,Gemini_BTCUSD_1h_17_12_17_to_10_03_23.csv,BTC_USD,HOUR,64641.17,2.676,26/08/2021 17:00:00,26/08/2021 19:00:00,26/08/2021 19:00:00,EXPIRED,LONG,46921.0,46928.0,48370.22,46437.93,1.942,3.0,1.04,3878.11,2,3.0,18.73
03/10/2021 08:00:00,15/06/2023 18:58:15,Gemini_BTCUSD_1h_17_12_17_to_10_03_23.csv,BTC_USD,HOUR,64659.9,5.025,03/10/2021 10:00:00,03/10/2021 11:00:00,03/10/2021 11:00:00,EXPIRED,LONG,47840.0,48018.0,48612.09,47582.64,3.718,1.59,0.54,3879.75,2,3.0,894.45
20/12/2019 12:00:00,15/06/2023 18:58:15,Gemini_BTCUSD_1h_17_12_17_to_10_03_23.csv,BTC_USD,HOUR,65554.35,21.976,20/12/2019 14:00:00,20/12/2019 15:00:00,20/12/2019 15:00:00,EXPIRED,LONG,7185.0,7152.0,7363.99,7125.34,2.409,2.43,0.84,3933.48,2,3.0,-725.21
20/02/2021 01:00:00,15/06/2023 18:58:15,Gemini_BTCUSD_1h_17_12_17_to_10_03_23.csv,BTC_USD,HOUR,64829.14,2.581,20/02/2021 02:00:00,20/02/2021 04:00:00,20/02/2021 03:00:00,STOP_LOSS_HIT,LONG,56259.0,55756.61,57766.19,55756.61,2.24,2.61,0.9,3890.06,2,3.0,-1296.67
04/11/2018 00:00:00,15/06/2023 18:58:15,Gemini_BTCUSD_1h_17_12_17_to_10_03_23.csv,BTC_USD,HOUR,63532.47,33.83,04/11/2018 03:00:00,04/11/2018 03:00:00,04/11/2018 03:00:00,EXPIRED,SHORT,6332.0,6332.0,6219.32,6369.56,3.372,1.81,0.59,3811.96,2,3.0,0.0
19/01/2018 13:00:00,15/06/2023 18:58:15,Gemini_BTCUSD_1h_17_12_17_to_10_03_23.csv,BTC_USD,HOUR,63532.47,10.366,19/01/2018 17:00:00,19/01/2018 16:00:00,19/01/2018 16:00:00,EXPIRED,SHORT,11729.0,11666.0,11361.26,11851.58,1.914,3.24,1.03,3811.99,2,3.0,653.06
15/08/2021 01:00:00,15/06/2023 18:58:15,Gemini_BTCUSD_1h_17_12_17_to_10_03_23.csv,BTC_USD,HOUR,64185.53,2.272,15/08/2021 02:00:00,15/08/2021 04:00:00,15/08/2021 04:00:00,STOP_LOSS_HIT,LONG,47157.0,46592.11,48851.69,46592.11,1.669,3.47,1.21,3850.34,2,3.0,-1283.43
19/09/2018 05:00:00,15/06/2023 18:58:15,Gemini_BTCUSD_1h_17_12_17_to_10_03_23.csv,BTC_USD,HOUR,62902.1,10.633,19/09/2018 06:00:00,19/09/2018 08:00:00,19/09/2018 08:00:00,EXPIRED,LONG,6339.0,6340.0,6693.93,6220.69,1.072,5.3,1.9,3773.97,2,3.0,10.63
22/10/2020 16:00:00,15/06/2023 18:58:15,Gemini_BTCUSD_1h_17_12_17_to_10_03_23.csv,BTC_USD,HOUR,62912.73,151.958,22/10/2020 19:00:00,22/10/2020 19:00:00,22/10/2020 17:00:00,STOP_LOSS_HIT,LONG,13072.0,13063.72,13096.83,13063.72,31.574,0.19,0.06,3773.12,2,3.0,-1258.21
07/04/2018 08:00:00,15/06/2023 18:58:15,Gemini_BTCUSD_1h_17_12_17_to_10_03_23.csv,BTC_USD,HOUR,61654.52,18.171,07/04/2018 12:00:00,07/04/2018 11:00:00,07/04/2018 11:00:00,EXPIRED,SHORT,6880.0,6854.0,6676.42,6947.86,2.028,3.05,0.98,3699.25,2,3.0,472.45
18/09/2020 06:00:00,15/06/2023 18:58:15,Gemini_BTCUSD_1h_17_12_17_to_10_03_23.csv,BTC_USD,HOUR,62126.97,20.858,18/09/2020 10:00:00,18/09/2020 09:00:00,18/09/2020 09:00:00,EXPIRED,LONG,10971.0,11011.0,11149.71,10911.43,3.683,1.6,0.55,3727.53,2,3.0,834.32
30/09/2022 01:00:00,15/06/2023 18:58:15,Gemini_BTCUSD_1h_17_12_17_to_10_03_23.csv,BTC_USD,HOUR,62961.29,12.963,30/09/2022 05:00:00,30/09/2022 04:00:00,30/09/2022 02:00:00,STOP_LOSS_HIT,LONG,19511.0,19413.86,19802.43,19413.86,4.017,1.47,0.5,3777.81,2,3.0,-1259.23
02/09/2018 12:00:00,15/06/2023 18:58:15,Gemini_BTCUSD_1h_17_12_17_to_10_03_23.csv,BTC_USD,HOUR,61702.06,13.123,02/09/2018 13:00:00,02/09/2018 15:00:00,02/09/2018 15:00:00,EXPIRED,LONG,7241.0,7217.0,7523.13,7146.96,1.54,3.75,1.32,3702.39,2,3.0,-314.95
01/08/2019 18:00:00,15/06/2023 18:58:15,Gemini_BTCUSD_1h_17_12_17_to_10_03_23.csv,BTC_USD,HOUR,61387.11,6.447,01/08/2019 19:00:00,01/08/2019 21:00:00,01/08/2019 21:00:00,EXPIRED,LONG,10195.0,10428.0,10766.29,10004.57,1.071,5.31,1.9,3683.11,2,3.0,1502.15
15/02/2023 10:00:00,15/06/2023 18:58:15,Gemini_BTCUSD_1h_17_12_17_to_10_03_23.csv,BTC_USD,HOUR,62889.26,3.657,15/02/2023 11:00:00,15/02/2023 13:00:00,15/02/2023 13:00:00,EXPIRED,LONG,22245.0,22699.0,23276.9,21901.03,1.294,4.43,1.57,3773.66,2,3.0,1660.28
22/01/2022 13:00:00,15/06/2023 18:58:15,Gemini_BTCUSD_1h_17_12_17_to_10_03_23.csv,BTC_USD,HOUR,64549.54,3.758,22/01/2022 14:00:00,22/01/2022 16:00:00,22/01/2022 14:00:00,STOP_LOSS_HIT,LONG,35593.0,35249.45,36623.67,35249.45,2.072,2.81,0.97,3873.26,2,3.0,-1291.06
31/03/2018 10:00:00,15/06/2023 18:58:15,Gemini_BTCUSD_1h_17_12_17_to_10_03_23.csv,BTC_USD,HOUR,63258.48,33.016,31/03/2018 14:00:00,31/03/2018 13:00:00,31/03/2018 12:00:00,TAKE_PROFIT_HIT,LONG,7077.0,7191.95,7191.95,7038.68,3.694,1.6,0.54,3795.19,2,3.0,3795.19
01/06/2020 14:00:00,15/06/2023 18:58:15,Gemini_BTCUSD_1h_17_12_17_to_10_03_23.csv,BTC_USD,HOUR,67053.67,16.791,01/06/2020 16:00:00,01/06/2020 17:00:00,01/06/2020 17:00:00,EXPIRED,LONG,9556.0,9578.0,9795.62,9476.13,2.393,2.45,0.84,4023.46,2,3.0,369.4
31/10/2019 13:00:00,15/06/2023 18:58:15,Gemini_BTCUSD_1h_17_12_17_to_10_03_23.csv,BTC_USD,HOUR,67423.07,26.681,31/10/2019 15:00:00,31/10/2019 16:00:00,31/10/2019 14:00:00,STOP_LOSS_HIT,LONG,9315.0,9264.46,9466.62,9264.46,3.686,1.6,0.55,4045.37,2,3.0,-1348.46
15/06/2022 03:00:00,15/06/2023 18:58:15,Gemini_BTCUSD_1h_17_12_17_to_10_03_23.csv,BTC_USD,HOUR,66074.61,5.391,15/06/2022 04:00:00,15/06/2022 06:00:00,15/06/2022 04:00:00,STOP_LOSS_HIT,LONG,21429.0,21183.86,22164.41,21183.86,1.748,3.32,1.16,3964.6,2,3.0,-1321.55
29/06/2021 12:00:00,15/06/2023 18:58:15,Gemini_BTCUSD_1h_17_12_17_to_10_03_23.csv,BTC_USD,HOUR,64753.06,1.779,29/06/2021 13:00:00,29/06/2021 15:00:00,29/06/2021 15:00:00,EXPIRED,LONG,35838.0,36261.0,38021.8,35110.07,0.985,5.74,2.07,3884.98,2,3.0,752.52
14/02/2021 03:00:00,15/06/2023 18:58:15,Gemini_BTCUSD_1h_17_12_17_to_10_03_23.csv,BTC_USD,HOUR,65505.58,2.393,14/02/2021 04:00:00,14/02/2021 06:00:00,14/02/2021 06:00:00,TAKE_PROFIT_HIT,LONG,47382.0,49024.37,49024.37,46834.55,1.731,3.35,1.17,3930.19,2,3.0,3930.19
11/07/2021 06:00:00,15/06/2023 18:58:15,Gemini_BTCUSD_1h_17_12_17_to_10_03_23.csv,BTC_USD,HOUR,69435.77,2.766,11/07/2021 10:00:00,11/07/2021 09:00:00,11/07/2021 09:00:00,EXPIRED,LONG,33481.0,33700.0,34987.05,32978.99,1.334,4.3,1.52,4165.73,2,3.0,605.75
12/08/2022 04:00:00,15/06/2023 18:58:15,Gemini_BTCUSD_1h_17_12_17_to_10_03_23.csv,BTC_USD,HOUR,70041.52,6.486,12/08/2022 07:00:00,12/08/2022 07:00:00,12/08/2022 07:00:00,EXPIRED,LONG,23946.0,23969.0,24593.96,23730.02,2.217,2.63,0.91,4202.67,2,3.0,149.18
29/01/2020 13:00:00,15/06/2023 18:58:15,Gemini_BTCUSD_1h_17_12_17_to_10_03_23.csv,BTC_USD,HOUR,70190.7,11.966,29/01/2020 14:00:00,29/01/2020 16:00:00,29/01/2020 16:00:00,EXPIRED,LONG,9305.0,9336.0,9656.95,9187.68,1.586,3.64,1.28,4211.43,2,3.0,370.95
12/02/2023 01:00:00,15/06/2023 18:58:15,Gemini_BTCUSD_1h_17_12_17_to_10_03_23.csv,BTC_USD,HOUR,70561.65,7.567,12/02/2023 03:00:00,12/02/2023 04:00:00,12/02/2023 04:00:00,EXPIRED,LONG,21815.0,21781.0,22374.48,21628.51,2.339,2.5,0.86,4233.59,2,3.0,-257.28
01/07/2022 16:00:00,15/06/2023 18:58:15,Gemini_BTCUSD_1h_17_12_17_to_10_03_23.csv,BTC_USD,HOUR,70304.37,6.033,01/07/2022 18:00:00,01/07/2022 19:00:00,01/07/2022 19:00:00,EXPIRED,LONG,19330.0,19376.0,20029.23,19096.92,1.659,3.49,1.22,4218.45,2,3.0,277.52
19/08/2019 05:00:00,15/06/2023 18:58:15,Gemini_BTCUSD_1h_17_12_17_to_10_03_23.csv,BTC_USD,HOUR,70581.89,7.081,19/08/2019 06:00:00,19/08/2019 08:00:00,19/08/2019 08:00:00,EXPIRED,LONG,10375.0,10698.0,10973.05,10175.65,1.041,5.45,1.96,4234.79,2,3.0,2287.16
07/10/2022 11:00:00,15/06/2023 18:58:15,Gemini_BTCUSD_1h_17_12_17_to_10_03_23.csv,BTC_USD,HOUR,72869.05,6.521,07/10/2022 12:00:00,07/10/2022 14:00:00,07/10/2022 12:00:00,STOP_LOSS_HIT,LONG,20004.0,19780.52,20674.45,19780.52,1.79,3.24,1.13,4372.0,2,3.0,-1457.31
21/07/2018 20:00:00,15/06/2023 18:58:15,Gemini_BTCUSD_1h_17_12_17_to_10_03_23.csv,BTC_USD,HOUR,71411.74,24.253,21/07/2018 21:00:00,21/07/2018 23:00:00,21/07/2018 23:00:00,EXPIRED,LONG,7415.0,7409.0,7591.67,7356.11,2.518,2.33,0.8,4284.78,2,3.0,-145.52
31/03/2021 20:00:00,15/06/2023 18:58:15,Gemini_BTCUSD_1h_17_12_17_to_10_03_23.csv,BTC_USD,HOUR,71266.22,4.938,31/03/2021 21:00:00,31/03/2021 23:00:00,31/03/2021 22:00:00,STOP_LOSS_HIT,LONG,59001.0,58712.35,59866.96,58712.35,4.088,1.45,0.49,4276.11,2,3.0,-1425.35
06/04/2018 00:00:00,15/06/2023 18:58:15,Gemini_BTCUSD_1h_17_12_17_to_10_03_23.csv,BTC_USD,HOUR,69840.87,13.316,06/04/2018 02:00:00,06/04/2018 03:00:00,06/04/2018 03:00:00,EXPIRED,LONG,6806.0,6769.0,7120.69,6701.1,1.298,4.42,1.57,4190.41,2,3.0,-492.69
23/11/2022 01:00:00,15/06/2023 18:58:15,Gemini_BTCUSD_1h_17_12_17_to_10_03_23.csv,BTC_USD,HOUR,69348.18,4.21,23/11/2022 02:00:00,23/11/2022 04:00:00,23/11/2022 04:00:00,EXPIRED,LONG,16192.0,16496.0,17180.22,15862.59,0.983,5.75,2.08,4160.41,2,3.0,1279.84
30/07/2022 19:00:00,15/06/2023 18:58:15,Gemini_BTCUSD_1h_17_12_17_to_10_03_23.csv,BTC_USD,HOUR,70628.02,7.078,30/07/2022 20:00:00,30/07/2022 22:00:00,30/07/2022 22:00:00,STOP_LOSS_HIT,LONG,23939.0,23739.44,24537.68,23739.44,2.399,2.44,0.84,4237.46,2,3.0,-1412.49
30/08/2022 05:00:00,15/06/2023 18:58:15,Gemini_BTCUSD_1h_17_12_17_to_10_03_23.csv,BTC_USD,HOUR,69215.53,13.104,30/08/2022 07:00:00,30/08/2022 08:00:00,30/08/2022 08:00:00,EXPIRED,LONG,20415.0,20399.0,20731.92,20309.36,3.865,1.53,0.52,4152.92,2,3.0,-209.66
20/12/2021 04:00:00,15/06/2023 18:58:15,Gemini_BTCUSD_1h_17_12_17_to_10_03_23.csv,BTC_USD,HOUR,69005.87,5.136,20/12/2021 08:00:00,20/12/2021 07:00:00,20/12/2021 07:00:00,TAKE_PROFIT_HIT,SHORT,46993.0,46186.94,46186.94,47261.69,3.498,1.75,0.57,4139.92,2,3.0,4139.92
21/08/2021 17:00:00,15/06/2023 18:58:15,Gemini_BTCUSD_1h_17_12_17_to_10_03_23.csv,BTC_USD,HOUR,73145.79,3.573,21/08/2021 20:00:00,21/08/2021 20:00:00,21/08/2021 19:00:00,STOP_LOSS_HIT,LONG,49705.0,49295.56,50933.34,49295.56,2.428,2.41,0.83,4388.86,2,3.0,-1462.93
24/01/2022 13:00:00,15/06/2023 18:58:15,Gemini_BTCUSD_1h_17_12_17_to_10_03_23.csv,BTC_USD,HOUR,71682.86,8.738,24/01/2022 17:00:00,24/01/2022 16:00:00,24/01/2022 14:00:00,STOP_LOSS_HIT,LONG,33328.0,33163.92,33820.23,33163.92,4.063,1.46,0.49,4301.11,2,3.0,-1433.73
22/07/2019 19:00:00,15/06/2023 18:58:15,Gemini_BTCUSD_1h_17_12_17_to_10_03_23.csv,BTC_USD,HOUR,70249.13,20.472,22/07/2019 23:00:00,22/07/2019 22:00:00,22/07/2019 20:00:00,TAKE_PROFIT_HIT,LONG,10118.0,10323.9,10323.9,10049.37,2.949,1.99,0.68,4215.18,2,3.0,4215.18
22/01/2018 04:00:00,15/06/2023 18:58:15,Gemini_BTCUSD_1h_17_12_17_to_10_03_23.csv,BTC_USD,HOUR,74464.31,23.118,22/01/2018 06:00:00,22/01/2018 07:00:00,22/01/2018 05:00:00,TAKE_PROFIT_HIT,SHORT,11601.0,11407.73,11407.73,11665.42,3.602,1.69,0.55,4468.02,2,3.0,4468.02
06/11/2018 14:00:00,15/06/2023 18:58:15,Gemini_BTCUSD_1h_17_12_17_to_10_03_23.csv,BTC_USD,HOUR,78932.33,48.648,06/11/2018 17:00:00,06/11/2018 17:00:00,06/11/2018 17:00:00,EXPIRED,SHORT,6415.0,6423.0,6317.65,6447.45,3.954,1.54,0.5,4735.88,2,3.0,-389.18
30/09/2021 16:00:00,15/06/2023 18:58:15,Gemini_BTCUSD_1h_17_12_17_to_10_03_23.csv,BTC_USD,HOUR,78543.15,3.836,30/09/2021 17:00:00,30/09/2021 19:00:00,30/09/2021 19:00:00,EXPIRED,LONG,42929.0,43552.0,44157.45,42519.52,2.097,2.78,0.96,4712.33,2,3.0,2389.83
08/02/2018 10:00:00,15/06/2023 18:58:15,Gemini_BTCUSD_1h_17_12_17_to_10_03_23.csv,BTC_USD,HOUR,80932.98,10.609,08/02/2018 14:00:00,08/02/2018 13:00:00,08/02/2018 13:00:00,EXPIRED,SHORT,8565.0,8454.0,8107.29,8717.57,1.123,5.65,1.75,4855.85,2,3.0,1177.6
05/08/2022 01:00:00,15/06/2023 18:58:15,Gemini_BTCUSD_1h_17_12_17_to_10_03_23.csv,BTC_USD,HOUR,82110.58,14.761,05/08/2022 02:00:00,05/08/2022 04:00:00,05/08/2022 04:00:00,TAKE_PROFIT_HIT,LONG,22895.0,23228.74,23228.74,22783.75,4.116,1.44,0.49,4926.34,2,3.0,4926.34
03/05/2022 08:00:00,15/06/2023 18:58:15,Gemini_BTCUSD_1h_17_12_17_to_10_03_23.csv,BTC_USD,HOUR,87036.92,3.39,03/05/2022 11:00:00,03/05/2022 11:00:00,03/05/2022 11:00:00,EXPIRED,SHORT,38532.0,38564.0,36991.45,39045.52,1.501,4.16,1.32,5222.46,2,3.0,-108.48
11/09/2020 20:00:00,15/06/2023 18:58:15,Gemini_BTCUSD_1h_17_12_17_to_10_03_23.csv,BTC_USD,HOUR,86928.44,29.068,12/09/2020 00:00:00,11/09/2020 23:00:00,11/09/2020 23:00:00,EXPIRED,LONG,10331.0,10403.0,10510.44,10271.19,3.455,1.71,0.58,5215.96,2,3.0,2092.9
15/08/2019 14:00:00,15/06/2023 18:58:15,Gemini_BTCUSD_1h_17_12_17_to_10_03_23.csv,BTC_USD,HOUR,89021.34,33.298,15/08/2019 15:00:00,15/08/2019 17:00:00,15/08/2019 17:00:00,EXPIRED,LONG,10004.0,10022.0,10164.42,9950.53,3.742,1.58,0.54,5341.67,2,3.0,599.36
16/07/2020 00:00:00,15/06/2023 18:58:15,Gemini_BTCUSD_1h_17_12_17_to_10_03_23.csv,BTC_USD,HOUR,89620.7,39.533,16/07/2020 04:00:00,16/07/2020 03:00:00,16/07/2020 03:00:00,EXPIRED,SHORT,9210.0,9198.0,9073.98,9255.34,4.063,1.5,0.49,5377.28,2,3.0,474.4
01/11/2022 02:00:00,15/06/2023 18:58:15,Gemini_BTCUSD_1h_17_12_17_to_10_03_23.csv,BTC_USD,HOUR,90095.1,5.549,01/11/2022 03:00:00,01/11/2022 05:00:00,01/11/2022 05:00:00,EXPIRED,LONG,20578.0,20533.0,21552.24,20253.25,1.267,4.52,1.6,5406.06,2,3.0,-249.7
04/07/2018 12:00:00,15/06/2023 18:58:15,Gemini_BTCUSD_1h_17_12_17_to_10_03_23.csv,BTC_USD,HOUR,89845.4,14.496,04/07/2018 13:00:00,04/07/2018 15:00:00,04/07/2018 15:00:00,EXPIRED,LONG,6535.0,6684.0,6906.89,6411.04,1.054,5.38,1.93,5390.92,2,3.0,2159.9
14/04/2019 19:00:00,15/06/2023 18:58:15,Gemini_BTCUSD_1h_17_12_17_to_10_03_23.csv,BTC_USD,HOUR,92005.3,18.557,14/04/2019 20:00:00,14/04/2019 22:00:00,14/04/2019 22:00:00,EXPIRED,LONG,5091.0,5163.0,5388.48,4991.84,1.027,5.52,1.99,5520.34,2,3.0,1336.1
13/05/2020 22:00:00,15/06/2023 18:58:15,Gemini_BTCUSD_1h_17_12_17_to_10_03_23.csv,BTC_USD,HOUR,93341.4,22.584,13/05/2020 23:00:00,14/05/2020 01:00:00,14/05/2020 01:00:00,EXPIRED,LONG,9335.0,9285.0,9582.99,9252.34,2.259,2.59,0.89,5600.61,2,3.0,-1129.2
08/02/2021 22:00:00,15/06/2023 18:58:15,Gemini_BTCUSD_1h_17_12_17_to_10_03_23.csv,BTC_USD,HOUR,92212.2,3.466,08/02/2021 23:00:00,09/02/2021 01:00:00,08/02/2021 23:00:00,TAKE_PROFIT_HIT,LONG,44663.0,46259.14,46259.14,44130.96,1.679,3.45,1.21,5532.22,2,3.0,5532.22
16/12/2020 14:00:00,15/06/2023 18:58:15,Gemini_BTCUSD_1h_17_12_17_to_10_03_23.csv,BTC_USD,HOUR,97744.42,5.834,16/12/2020 15:00:00,16/12/2020 17:00:00,16/12/2020 17:00:00,EXPIRED,LONG,20721.0,20671.0,21726.3,20385.9,1.237,4.63,1.64,5864.92,2,3.0,-291.7
13/11/2020 14:00:00,15/06/2023 18:58:15,Gemini_BTCUSD_1h_17_12_17_to_10_03_23.csv,BTC_USD,HOUR,97452.72,11.022,13/11/2020 15:00:00,13/11/2020 17:00:00,13/11/2020 16:00:00,STOP_LOSS_HIT,LONG,16237.0,16060.16,16767.51,16060.16,1.836,3.16,1.1,5847.28,2,3.0,-1949.13
11/06/2022 14:00:00,15/06/2023 18:58:15,Gemini_BTCUSD_1h_17_12_17_to_10_03_23.csv,BTC_USD,HOUR,95503.59,12.891,11/06/2022 18:00:00,11/06/2022 17:00:00,11/06/2022 15:00:00,STOP_LOSS_HIT,LONG,28385.0,28236.83,28829.53,28236.83,3.831,1.54,0.52,5730.44,2,3.0,-1910.06
02/10/2021 21:00:00,15/06/2023 18:58:15,Gemini_BTCUSD_1h_17_12_17_to_10_03_23.csv,BTC_USD,HOUR,93593.53,4.418,02/10/2021 23:00:00,03/10/2021 00:00:00,02/10/2021 23:00:00,STOP_LOSS_HIT,LONG,48153.0,47729.26,49424.24,47729.26,2.273,2.57,0.89,5616.34,2,3.0,-1872.08
08/10/2021 12:00:00,15/06/2023 18:58:15,Gemini_BTCUSD_1h_17_12_17_to_10_03_23.csv,BTC_USD,HOUR,91721.45,6.269,08/10/2021 13:00:00,08/10/2021 15:00:00,08/10/2021 13:00:00,STOP_LOSS_HIT,LONG,54881.0,54588.36,55758.93,54588.36,3.751,1.57,0.54,5503.74,2,3.0,-1834.56
18/01/2022 16:00:00,15/06/2023 18:58:15,Gemini_BTCUSD_1h_17_12_17_to_10_03_23.csv,BTC_USD,HOUR,89886.89,8.782,18/01/2022 18:00:00,18/01/2022 19:00:00,18/01/2022 19:00:00,EXPIRED,SHORT,41720.0,41708.0,41105.92,41924.7,4.076,1.49,0.49,5392.85,2,3.0,105.38
13/05/2018 04:00:00,15/06/2023 18:58:15,Gemini_BTCUSD_1h_17_12_17_to_10_03_23.csv,BTC_USD,HOUR,89992.27,23.503,13/05/2018 08:00:00,13/05/2018 07:00:00,13/05/2018 06:00:00,STOP_LOSS_HIT,SHORT,8347.0,8423.58,8117.27,8423.58,2.18,2.83,0.91,5399.34,2,3.0,-1799.86
08/03/2019 17:00:00,15/06/2023 18:58:15,Gemini_BTCUSD_1h_17_12_17_to_10_03_23.csv,BTC_USD,HOUR,88192.41,54.339,08/03/2019 21:00:00,08/03/2019 20:00:00,08/03/2019 20:00:00,EXPIRED,LONG,3893.0,3899.0,3990.38,3860.54,2.399,2.44,0.84,5291.53,2,3.0,326.03
10/03/2021 09:00:00,15/06/2023 18:58:15,Gemini_BTCUSD_1h_17_12_17_to_10_03_23.csv,BTC_USD,HOUR,88518.44,6.039,10/03/2021 12:00:00,10/03/2021 12:00:00,10/03/2021 10:00:00,STOP_LOSS_HIT,LONG,55231.0,54937.85,56110.45,54937.85,3.768,1.57,0.53,5311.0,2,3.0,-1770.33
03/05/2018 03:00:00,15/06/2023 18:58:15,Gemini_BTCUSD_1h_17_12_17_to_10_03_23.csv,BTC_USD,HOUR,86748.11,21.837,03/05/2018 05:00:00,03/05/2018 06:00:00,03/05/2018 06:00:00,STOP_LOSS_HIT,LONG,9255.0,9175.55,9493.36,9175.55,2.33,2.51,0.87,5205.07,2,3.0,-1734.95
24/06/2022 12:00:00,15/06/2023 18:58:15,Gemini_BTCUSD_1h_17_12_17_to_10_03_23.csv,BTC_USD,HOUR,85013.16,9.525,24/06/2022 13:00:00,24/06/2022 15:00:00,24/06/2022 15:00:00,STOP_LOSS_HIT,LONG,21196.0,21017.5,21731.49,21017.5,2.375,2.46,0.85,5100.54,2,3.0,-1700.21
13/06/2018 05:00:00,15/06/2023 18:58:15,Gemini_BTCUSD_1h_17_12_17_to_10_03_23.csv,BTC_USD,HOUR,83312.95,29.947,13/06/2018 06:00:00,13/06/2018 08:00:00,13/06/2018 08:00:00,STOP_LOSS_HIT,LONG,6570.0,6514.36,6736.92,6514.36,2.362,2.48,0.85,4998.75,2,3.0,-1666.25
01/03/2022 02:00:00,15/06/2023 18:58:15,Gemini_BTCUSD_1h_17_12_17_to_10_03_23.csv,BTC_USD,HOUR,81646.7,2.296,01/03/2022 03:00:00,01/03/2022 05:00:00,01/03/2022 05:00:00,EXPIRED,LONG,43178.0,43232.0,45311.9,42466.71,1.214,4.71,1.67,4899.43,2,3.0,123.98
27/07/2019 23:00:00,15/06/2023 18:58:15,Gemini_BTCUSD_1h_17_12_17_to_10_03_23.csv,BTC_USD,HOUR,81770.68,10.414,28/07/2019 01:00:00,28/07/2019 02:00:00,28/07/2019 02:00:00,EXPIRED,LONG,9478.0,9450.0,9949.14,9320.96,1.207,4.74,1.68,4906.45,2,3.0,-291.59
16/09/2018 01:00:00,15/06/2023 18:58:15,Gemini_BTCUSD_1h_17_12_17_to_10_03_23.csv,BTC_USD,HOUR,81479.09,50.972,16/09/2018 04:00:00,16/09/2018 04:00:00,16/09/2018 04:00:00,STOP_LOSS_HIT,LONG,6496.0,6464.03,6591.92,6464.03,4.064,1.46,0.49,4889.23,2,3.0,-1629.57
20/04/2018 06:00:00,15/06/2023 18:58:15,Gemini_BTCUSD_1h_17_12_17_to_10_03_23.csv,BTC_USD,HOUR,79849.52,33.009,20/04/2018 10:00:00,20/04/2018 09:00:00,20/04/2018 09:00:00,EXPIRED,SHORT,8310.0,8315.0,8164.87,8358.38,3.435,1.78,0.58,4790.6,2,3.0,-165.04
05/11/2018 22:00:00,15/06/2023 18:58:15,Gemini_BTCUSD_1h_17_12_17_to_10_03_23.csv,BTC_USD,HOUR,79684.48,19.343,06/11/2018 00:00:00,06/11/2018 01:00:00,06/11/2018 01:00:00,EXPIRED,LONG,6398.0,6408.0,6645.16,6315.61,1.553,3.72,1.3,4780.82,2,3.0,193.43
01/11/2022 04:00:00,15/06/2023 18:58:15,Gemini_BTCUSD_1h_17_12_17_to_10_03_23.csv,BTC_USD,HOUR,79877.91,5.081,01/11/2022 06:00:00,01/11/2022 07:00:00,01/11/2022 07:00:00,EXPIRED,LONG,20498.0,20594.0,21441.32,20183.56,1.304,4.4,1.56,4793.01,2,3.0,487.78
15/08/2018 06:00:00,15/06/2023 18:58:15,Gemini_BTCUSD_1h_17_12_17_to_10_03_23.csv,BTC_USD,HOUR,80365.69,44.672,15/08/2018 08:00:00,15/08/2018 09:00:00,15/08/2018 07:00:00,TAKE_PROFIT_HIT,LONG,6324.0,6431.96,6431.96,6288.02,3.515,1.68,0.57,4822.79,2,3.0,4822.79
17/10/2021 02:00:00,15/06/2023 18:58:15,Gemini_BTCUSD_1h_17_12_17_to_10_03_23.csv,BTC_USD,HOUR,85188.48,1.364,17/10/2021 03:00:00,17/10/2021 05:00:00,17/10/2021 05:00:00,EXPIRED,LONG,61102.0,60648.0,64849.6,59852.8,0.978,5.78,2.09,5111.73,2,3.0,-619.26
20/04/2021 21:00:00,15/06/2023 18:58:15,Gemini_BTCUSD_1h_17_12_17_to_10_03_23.csv,BTC_USD,HOUR,84569.22,3.379,20/04/2021 23:00:00,21/04/2021 00:00:00,20/04/2021 22:00:00,STOP_LOSS_HIT,LONG,57099.0,56598.49,58600.53,56598.49,2.281,2.56,0.88,5073.67,2,3.0,-1691.22
19/04/2022 10:00:00,15/06/2023 18:58:15,Gemini_BTCUSD_1h_17_12_17_to_10_03_23.csv,BTC_USD,HOUR,82878.0,4.026,19/04/2022 11:00:00,19/04/2022 13:00:00,19/04/2022 13:00:00,EXPIRED,LONG,40816.0,41453.0,42051.13,40404.29,1.983,2.94,1.02,4972.63,2,3.0,2564.56
23/01/2019 06:00:00,15/06/2023 18:58:15,Gemini_BTCUSD_1h_17_12_17_to_10_03_23.csv,BTC_USD,HOUR,85442.56,84.932,23/01/2019 09:00:00,23/01/2019 09:00:00,23/01/2019 08:00:00,STOP_LOSS_HIT,LONG,3582.0,3561.88,3642.35,3561.88,3.561,1.66,0.56,5125.65,2,3.0,-1708.83
13/01/2019 23:00:00,15/06/2023 18:58:15,Gemini_BTCUSD_1h_17_12_17_to_10_03_23.csv,BTC_USD,HOUR,83733.73,67.014,14/01/2019 03:00:00,14/01/2019 02:00:00,14/01/2019 02:00:00,EXPIRED,LONG,3514.0,3522.0,3588.97,3489.01,2.812,2.09,0.72,5024.04,2,3.0,536.11
30/11/2019 07:00:00,15/06/2023 18:58:15,Gemini_BTCUSD_1h_17_12_17_to_10_03_23.csv,BTC_USD,HOUR,84269.84,40.967,30/11/2019 09:00:00,30/11/2019 10:00:00,30/11/2019 09:00:00,STOP_LOSS_HIT,LONG,7762.0,7720.86,7885.43,7720.86,3.773,1.57,0.53,5056.56,2,3.0,-1685.38
19/06/2019 08:00:00,15/06/2023 18:58:15,Gemini_BTCUSD_1h_17_12_17_to_10_03_23.csv,BTC_USD,HOUR,82584.46,33.695,19/06/2019 09:00:00,19/06/2019 11:00:00,19/06/2019 09:00:00,STOP_LOSS_HIT,LONG,9170.0,9120.98,9317.05,9120.98,3.741,1.58,0.54,4954.85,2,3.0,-1651.73
22/10/2020 12:00:00,15/06/2023 18:58:15,Gemini_BTCUSD_1h_17_12_17_to_10_03_23.csv,BTC_USD,HOUR,80932.73,6.201,22/10/2020 13:00:00,22/10/2020 15:00:00,22/10/2020 15:00:00,EXPIRED,LONG,12869.0,12955.0,13652.14,12607.95,0.986,5.74,2.07,4856.25,2,3.0,533.29
22/05/2022 02:00:00,15/06/2023 18:58:15,Gemini_BTCUSD_1h_17_12_17_to_10_03_23.csv,BTC_USD,HOUR,81466.02,2.687,22/05/2022 03:00:00,22/05/2022 05:00:00,22/05/2022 05:00:00,EXPIRED,LONG,29369.0,29337.0,31188.19,28762.61,0.969,5.83,2.11,4888.16,2,3.0,-85.98
18/05/2022 21:00:00,15/06/2023 18:58:15,Gemini_BTCUSD_1h_17_12_17_to_10_03_23.csv,BTC_USD,HOUR,81380.04,18.319,18/05/2022 23:00:00,19/05/2022 00:00:00,18/05/2022 22:00:00,STOP_LOSS_HIT,LONG,29152.0,29063.15,29418.55,29063.15,6.562,0.91,0.31,4882.93,2,3.0,-1627.64
09/08/2020 04:00:00,15/06/2023 18:58:15,Gemini_BTCUSD_1h_17_12_17_to_10_03_23.csv,BTC_USD,HOUR,79752.4,9.367,09/08/2020 07:00:00,09/08/2020 07:00:00,09/08/2020 07:00:00,EXPIRED,LONG,11702.0,11712.0,12212.88,11531.71,1.374,4.18,1.48,4785.41,2,3.0,93.67
15/03/2018 15:00:00,15/06/2023 18:58:15,Gemini_BTCUSD_1h_17_12_17_to_10_03_23.csv,BTC_USD,HOUR,79846.07,34.528,15/03/2018 17:00:00,15/03/2018 18:00:00,15/03/2018 17:00:00,STOP_LOSS_HIT,SHORT,8105.0,8151.25,7966.24,8151.25,3.505,1.74,0.57,4791.11,2,3.0,-1596.92
23/04/2019 19:00:00,15/06/2023 18:58:15,Gemini_BTCUSD_1h_17_12_17_to_10_03_23.csv,BTC_USD,HOUR,78249.15,14.97,23/04/2019 21:00:00,23/04/2019 22:00:00,23/04/2019 22:00:00,EXPIRED,LONG,5587.0,5560.0,5900.62,5482.46,1.069,5.32,1.91,4694.89,2,3.0,-404.19
01/12/2021 15:00:00,15/06/2023 18:58:15,Gemini_BTCUSD_1h_17_12_17_to_10_03_23.csv,BTC_USD,HOUR,77844.96,1.658,01/12/2021 16:00:00,01/12/2021 18:00:00,01/12/2021 18:00:00,STOP_LOSS_HIT,LONG,58678.0,57738.95,61495.15,57738.95,1.25,4.58,1.63,4670.83,2,3.0,-1556.94
25/02/2022 18:00:00,15/06/2023 18:58:15,Gemini_BTCUSD_1h_17_12_17_to_10_03_23.csv,BTC_USD,HOUR,76288.02,4.343,25/02/2022 19:00:00,25/02/2022 21:00:00,25/02/2022 21:00:00,EXPIRED,LONG,38670.0,39005.0,39723.99,38318.67,2.201,2.65,0.92,4577.48,2,3.0,1454.91
20/03/2020 09:00:00,15/06/2023 18:58:15,Gemini_BTCUSD_1h_17_12_17_to_10_03_23.csv,BTC_USD,HOUR,77742.93,48.168,20/03/2020 10:00:00,20/03/2020 12:00:00,20/03/2020 10:00:00,STOP_LOSS_HIT,SHORT,6775.0,6807.28,6678.16,6807.28,4.198,1.45,0.47,4664.59,2,3.0,-1554.86
01/04/2018 18:00:00,15/06/2023 18:58:15,Gemini_BTCUSD_1h_17_12_17_to_10_03_23.csv,BTC_USD,HOUR,76188.07,45.082,01/04/2018 19:00:00,01/04/2018 21:00:00,01/04/2018 19:00:00,TAKE_PROFIT_HIT,LONG,6835.0,6936.41,6936.41,6801.2,4.044,1.46,0.5,4571.77,2,3.0,4571.77
13/04/2022 08:00:00,15/06/2023 18:58:15,Gemini_BTCUSD_1h_17_12_17_to_10_03_23.csv,BTC_USD,HOUR,80759.84,2.937,13/04/2022 11:00:00,13/04/2022 11:00:00,13/04/2022 11:00:00,EXPIRED,LONG,40154.0,39712.0,41804.08,39603.98,1.46,3.95,1.39,4846.28,2,3.0,-1298.15
20/10/2020 18:00:00,15/06/2023 18:58:15,Gemini_BTCUSD_1h_17_12_17_to_10_03_23.csv,BTC_USD,HOUR,79461.69,15.911,20/10/2020 21:00:00,20/10/2020 21:00:00,20/10/2020 20:00:00,STOP_LOSS_HIT,LONG,11977.0,11877.12,12276.64,11877.12,2.398,2.44,0.84,4767.57,2,3.0,-1589.19
18/09/2019 02:00:00,15/06/2023 18:58:15,Gemini_BTCUSD_1h_17_12_17_to_10_03_23.csv,BTC_USD,HOUR,77872.5,30.16,18/09/2019 04:00:00,18/09/2019 05:00:00,18/09/2019 05:00:00,EXPIRED,LONG,10233.0,10215.0,10387.91,10181.36,3.963,1.49,0.51,4672.09,2,3.0,-542.88
22/01/2023 11:00:00,15/06/2023 18:58:15,Gemini_BTCUSD_1h_17_12_17_to_10_03_23.csv,BTC_USD,HOUR,77329.62,13.795,22/01/2023 12:00:00,22/01/2023 14:00:00,22/01/2023 14:00:00,EXPIRED,LONG,22772.0,22997.0,23108.33,22659.89,4.062,1.46,0.49,4639.67,2,3.0,3103.88
13/04/2019 04:00:00,15/06/2023 18:58:15,Gemini_BTCUSD_1h_17_12_17_to_10_03_23.csv,BTC_USD,HOUR,80433.5,37.411,13/04/2019 05:00:00,13/04/2019 07:00:00,13/04/2019 07:00:00,EXPIRED,LONG,5116.0,5097.0,5244.99,5073.0,2.38,2.46,0.85,4825.64,2,3.0,-710.81
05/11/2019 18:00:00,15/06/2023 18:58:15,Gemini_BTCUSD_1h_17_12_17_to_10_03_23.csv,BTC_USD,HOUR,79722.69,13.771,05/11/2019 22:00:00,05/11/2019 21:00:00,05/11/2019 21:00:00,EXPIRED,LONG,9344.0,9361.0,9691.35,9228.22,1.614,3.58,1.25,4783.36,2,3.0,234.11
06/05/2020 10:00:00,15/06/2023 18:58:15,Gemini_BTCUSD_1h_17_12_17_to_10_03_23.csv,BTC_USD,HOUR,79956.8,8.398,06/05/2020 11:00:00,06/05/2020 13:00:00,06/05/2020 13:00:00,EXPIRED,LONG,9231.0,9240.0,9802.29,9040.57,0.97,5.83,2.11,4797.69,2,3.0,75.58
24/10/2021 00:00:00,15/06/2023 18:58:15,Gemini_BTCUSD_1h_17_12_17_to_10_03_23.csv,BTC_USD,HOUR,80032.38,4.755,24/10/2021 01:00:00,24/10/2021 03:00:00,24/10/2021 03:00:00,EXPIRED,SHORT,61116.0,61226.0,60106.07,61452.65,3.631,1.68,0.55,4802.22,2,3.0,-523.05
07/04/2022 12:00:00,15/06/2023 18:58:16,Gemini_BTCUSD_1h_17_12_17_to_10_03_23.csv,BTC_USD,HOUR,79509.33,3.062,07/04/2022 13:00:00,07/04/2022 15:00:00,07/04/2022 15:00:00,EXPIRED,SHORT,43547.0,43336.0,41989.03,44066.33,1.677,3.71,1.18,4770.5,2,3.0,646.08
23/09/2021 20:00:00,15/06/2023 18:58:16,Gemini_BTCUSD_1h_17_12_17_to_10_03_23.csv,BTC_USD,HOUR,80155.41,2.694,23/09/2021 21:00:00,23/09/2021 23:00:00,23/09/2021 23:00:00,EXPIRED,LONG,44717.0,44897.0,46501.95,44122.02,1.503,3.84,1.35,4808.66,2,3.0,484.92
27/04/2021 22:00:00,15/06/2023 18:58:16,Gemini_BTCUSD_1h_17_12_17_to_10_03_23.csv,BTC_USD,HOUR,80640.33,2.646,28/04/2021 00:00:00,28/04/2021 01:00:00,28/04/2021 01:00:00,EXPIRED,LONG,54966.0,55563.0,56794.8,54356.4,1.804,3.22,1.12,4839.0,2,3.0,1579.66
01/02/2020 08:00:00,15/06/2023 18:58:16,Gemini_BTCUSD_1h_17_12_17_to_10_03_23.csv,BTC_USD,HOUR,82219.99,33.093,01/02/2020 09:00:00,01/02/2020 11:00:00,01/02/2020 11:00:00,STOP_LOSS_HIT,LONG,9374.0,9324.31,9523.07,9324.31,3.773,1.57,0.53,4933.17,2,3.0,-1644.39
22/09/2021 20:00:00,15/06/2023 18:58:16,Gemini_BTCUSD_1h_17_12_17_to_10_03_23.csv,BTC_USD,HOUR,80575.6,2.349,22/09/2021 21:00:00,22/09/2021 23:00:00,22/09/2021 23:00:00,EXPIRED,LONG,43458.0,43574.0,45516.08,42771.98,1.267,4.52,1.6,4834.43,2,3.0,272.48
18/09/2022 14:00:00,15/06/2023 18:58:16,Gemini_BTCUSD_1h_17_12_17_to_10_03_23.csv,BTC_USD,HOUR,80848.08,4.674,18/09/2022 15:00:00,18/09/2022 17:00:00,18/09/2022 17:00:00,EXPIRED,LONG,19797.0,19632.0,20834.86,19451.05,1.145,4.98,1.78,4850.96,2,3.0,-771.21
09/10/2019 20:00:00,15/06/2023 18:58:16,Gemini_BTCUSD_1h_17_12_17_to_10_03_23.csv,BTC_USD,HOUR,80076.87,19.254,10/10/2019 00:00:00,09/10/2019 23:00:00,09/10/2019 23:00:00,EXPIRED,LONG,8590.0,8592.0,8839.56,8506.82,2.065,2.82,0.98,4805.03,2,3.0,38.51
11/03/2022 12:00:00,15/06/2023 18:58:16,Gemini_BTCUSD_1h_17_12_17_to_10_03_23.csv,BTC_USD,HOUR,80115.38,8.422,11/03/2022 13:00:00,11/03/2022 15:00:00,11/03/2022 13:00:00,TAKE_PROFIT_HIT,SHORT,39933.0,39362.24,39362.24,40123.26,4.198,1.45,0.47,4806.94,2,3.0,4806.94
17/06/2021 11:00:00,15/06/2023 18:58:16,Gemini_BTCUSD_1h_17_12_17_to_10_03_23.csv,BTC_USD,HOUR,84922.32,2.711,17/06/2021 13:00:00,17/06/2021 14:00:00,17/06/2021 14:00:00,STOP_LOSS_HIT,LONG,39168.0,38541.47,41047.58,38541.47,1.25,4.58,1.63,5095.54,2,3.0,-1698.52
19/12/2020 19:00:00,15/06/2023 18:58:16,Gemini_BTCUSD_1h_17_12_17_to_10_03_23.csv,BTC_USD,HOUR,83223.8,7.924,19/12/2020 20:00:00,19/12/2020 22:00:00,19/12/2020 22:00:00,EXPIRED,LONG,23840.0,23933.0,24470.16,23629.95,2.27,2.58,0.89,4993.39,2,3.0,736.93
05/09/2022 19:00:00,15/06/2023 18:58:16,Gemini_BTCUSD_1h_17_12_17_to_10_03_23.csv,BTC_USD,HOUR,83960.73,13.659,05/09/2022 20:00:00,05/09/2022 22:00:00,05/09/2022 22:00:00,EXPIRED,LONG,19708.0,19798.0,20076.84,19585.06,3.206,1.84,0.63,5037.99,2,3.0,1229.31
24/07/2018 20:00:00,15/06/2023 18:58:16,Gemini_BTCUSD_1h_17_12_17_to_10_03_23.csv,BTC_USD,HOUR,85190.04,42.895,24/07/2018 21:00:00,24/07/2018 23:00:00,24/07/2018 23:00:00,TAKE_PROFIT_HIT,LONG,8227.0,8346.15,8346.15,8187.28,4.142,1.43,0.49,5110.94,2,3.0,5110.94
05/08/2019 16:00:00,15/06/2023 18:58:16,Gemini_BTCUSD_1h_17_12_17_to_10_03_23.csv,BTC_USD,HOUR,90300.98,21.963,05/08/2019 18:00:00,05/08/2019 19:00:00,05/08/2019 19:00:00,EXPIRED,SHORT,11887.0,11765.0,11640.32,11969.23,2.891,2.12,0.69,5417.83,2,3.0,2679.49
20/04/2022 04:00:00,15/06/2023 18:58:16,Gemini_BTCUSD_1h_17_12_17_to_10_03_23.csv,BTC_USD,HOUR,92980.47,5.099,20/04/2022 06:00:00,20/04/2022 07:00:00,20/04/2022 07:00:00,EXPIRED,LONG,41349.0,41361.0,42443.13,40984.29,2.268,2.58,0.89,5578.97,2,3.0,61.19
07/11/2020 12:00:00,15/06/2023 18:58:16,Gemini_BTCUSD_1h_17_12_17_to_10_03_23.csv,BTC_USD,HOUR,93041.66,22.627,07/11/2020 16:00:00,07/11/2020 15:00:00,07/11/2020 15:00:00,TAKE_PROFIT_HIT,SHORT,15533.0,15286.28,15286.28,15615.24,3.778,1.61,0.53,5582.53,2,3.0,5582.53
15/02/2018 12:00:00,15/06/2023 18:58:16,Gemini_BTCUSD_1h_17_12_17_to_10_03_23.csv,BTC_USD,HOUR,98624.19,30.281,15/02/2018 14:00:00,15/02/2018 15:00:00,15/02/2018 14:00:00,STOP_LOSS_HIT,SHORT,9739.0,9804.14,9543.57,9804.14,2.99,2.05,0.66,5917.82,2,3.0,-1972.5
31/05/2021 20:00:00,15/06/2023 18:58:16,Gemini_BTCUSD_1h_17_12_17_to_10_03_23.csv,BTC_USD,HOUR,96651.69,10.271,31/05/2021 22:00:00,31/05/2021 23:00:00,31/05/2021 21:00:00,STOP_LOSS_HIT,SHORT,36701.0,36889.2,36136.41,36889.2,3.9,1.56,0.51,5798.9,2,3.0,-1933.0
24/05/2018 21:00:00,15/06/2023 18:58:16,Gemini_BTCUSD_1h_17_12_17_to_10_03_23.csv,BTC_USD,HOUR,94718.69,18.147,24/05/2018 23:00:00,25/05/2018 00:00:00,25/05/2018 00:00:00,EXPIRED,LONG,7531.0,7558.0,7844.17,7426.61,1.443,3.99,1.41,5683.1,2,3.0,489.97
24/12/2019 13:00:00,15/06/2023 18:58:16,Gemini_BTCUSD_1h_17_12_17_to_10_03_23.csv,BTC_USD,HOUR,95208.66,48.122,24/12/2019 17:00:00,24/12/2019 16:00:00,24/12/2019 14:00:00,STOP_LOSS_HIT,LONG,7375.0,7335.43,7493.72,7335.43,3.728,1.58,0.54,5713.04,2,3.0,-1904.19
04/10/2018 11:00:00,15/06/2023 18:58:16,Gemini_BTCUSD_1h_17_12_17_to_10_03_23.csv,BTC_USD,HOUR,93304.47,17.489,04/10/2018 12:00:00,04/10/2018 14:00:00,04/10/2018 14:00:00,EXPIRED,LONG,6522.0,6529.0,6842.09,6415.3,1.222,4.68,1.66,5598.05,2,3.0,122.42
09/01/2022 00:00:00,15/06/2023 18:58:16,Gemini_BTCUSD_1h_17_12_17_to_10_03_23.csv,BTC_USD,HOUR,93426.89,2.748,09/01/2022 01:00:00,09/01/2022 03:00:00,09/01/2022 03:00:00,EXPIRED,LONG,41754.0,41851.0,43794.24,41073.92,1.228,4.66,1.66,5606.58,2,3.0,266.56
20/12/2019 09:00:00,15/06/2023 18:58:16,Gemini_BTCUSD_1h_17_12_17_to_10_03_23.csv,BTC_USD,HOUR,93693.45,47.876,20/12/2019 12:00:00,20/12/2019 12:00:00,20/12/2019 12:00:00,EXPIRED,LONG,7129.0,7185.0,7246.42,7089.86,3.643,1.62,0.55,5621.6,2,3.0,2681.06
12/02/2023 01:00:00,15/06/2023 18:58:16,Gemini_BTCUSD_1h_17_12_17_to_10_03_23.csv,BTC_USD,HOUR,96374.51,10.336,12/02/2023 03:00:00,12/02/2023 04:00:00,12/02/2023 04:00:00,EXPIRED,LONG,21815.0,21781.0,22374.48,21628.51,2.34,2.5,0.86,5782.79,2,3.0,-351.42
17/02/2019 02:00:00,15/06/2023 18:58:16,Gemini_BTCUSD_1h_17_12_17_to_10_03_23.csv,BTC_USD,HOUR,96023.09,97.14,17/02/2019 05:00:00,17/02/2019 05:00:00,17/02/2019 05:00:00,EXPIRED,LONG,3586.0,3598.0,3645.32,3566.23,3.628,1.63,0.55,5762.34,2,3.0,1165.68
22/12/2020 03:00:00,15/06/2023 18:58:16,Gemini_BTCUSD_1h_17_12_17_to_10_03_23.csv,BTC_USD,HOUR,97188.77,14.687,22/12/2020 07:00:00,22/12/2020 06:00:00,22/12/2020 05:00:00,STOP_LOSS_HIT,LONG,22859.0,22726.65,23256.07,22726.65,3.454,1.71,0.58,5831.77,2,3.0,-1943.82
28/09/2018 00:00:00,15/06/2023 18:58:16,Gemini_BTCUSD_1h_17_12_17_to_10_03_23.csv,BTC_USD,HOUR,95244.95,52.246,28/09/2018 02:00:00,28/09/2018 03:00:00,28/09/2018 03:00:00,EXPIRED,SHORT,6698.0,6692.0,6588.63,6734.46,3.674,1.66,0.54,5714.15,2,3.0,313.48
14/08/2022 07:00:00,15/06/2023 18:58:16,Gemini_BTCUSD_1h_17_12_17_to_10_03_23.csv,BTC_USD,HOUR,95558.43,6.961,14/08/2022 10:00:00,14/08/2022 10:00:00,14/08/2022 08:00:00,STOP_LOSS_HIT,LONG,24888.0,24613.44,25711.68,24613.44,1.813,3.2,1.12,5733.64,2,3.0,-1911.21
10/05/2022 03:00:00,15/06/2023 18:58:16,Gemini_BTCUSD_1h_17_12_17_to_10_03_23.csv,BTC_USD,HOUR,93647.22,4.327,10/05/2022 04:00:00,10/05/2022 06:00:00,10/05/2022 04:00:00,STOP_LOSS_HIT,LONG,31329.0,30896.14,32627.59,30896.14,1.448,3.98,1.4,5619.0,2,3.0,-1872.99
31/05/2022 16:00:00,15/06/2023 18:58:16,Gemini_BTCUSD_1h_17_12_17_to_10_03_23.csv,BTC_USD,HOUR,91774.23,4.74,31/05/2022 17:00:00,31/05/2022 19:00:00,31/05/2022 18:00:00,STOP_LOSS_HIT,LONG,32149.0,31761.77,33310.68,31761.77,1.66,3.49,1.22,5506.36,2,3.0,-1835.47
23/12/2017 11:00:00,15/06/2023 18:58:16,Gemini_BTCUSD_1h_17_12_17_to_10_03_23.csv,BTC_USD,HOUR,89938.76,7.259,23/12/2017 12:00:00,23/12/2017 14:00:00,23/12/2017 12:00:00,STOP_LOSS_HIT,LONG,15400.0,15152.19,16143.44,15152.19,1.243,4.61,1.64,5396.63,2,3.0,-1798.85
05/10/2021 10:00:00,15/06/2023 18:58:16,Gemini_BTCUSD_1h_17_12_17_to_10_03_23.csv,BTC_USD,HOUR,88139.91,2.019,05/10/2021 11:00:00,05/10/2021 13:00:00,05/10/2021 13:00:00,EXPIRED,LONG,50026.0,50240.0,52644.96,49153.01,1.146,4.97,1.78,5287.68,2,3.0,432.07
06/02/2022 12:00:00,15/06/2023 18:58:16,Gemini_BTCUSD_1h_17_12_17_to_10_03_23.csv,BTC_USD,HOUR,88571.98,6.312,06/02/2022 14:00:00,06/02/2022 15:00:00,06/02/2022 14:00:00,STOP_LOSS_HIT,SHORT,41637.0,41917.64,40795.1,41917.64,2.967,2.06,0.67,5314.07,2,3.0,-1771.4
13/01/2022 09:00:00,15/06/2023 18:58:16,Gemini_BTCUSD_1h_17_12_17_to_10_03_23.csv,BTC_USD,HOUR,86800.58,2.869,13/01/2022 10:00:00,13/01/2022 12:00:00,13/01/2022 12:00:00,EXPIRED,LONG,43874.0,43827.0,45689.05,43268.99,1.45,3.97,1.4,5207.38,2,3.0,-134.84
01/11/2018 09:00:00,15/06/2023 18:58:16,Gemini_BTCUSD_1h_17_12_17_to_10_03_23.csv,BTC_USD,HOUR,86665.74,30.98,01/11/2018 12:00:00,01/11/2018 12:00:00,01/11/2018 12:00:00,EXPIRED,SHORT,6304.0,6302.0,6136.16,6359.95,2.253,2.74,0.88,5199.68,2,3.0,61.96
09/12/2021 09:00:00,15/06/2023 18:58:16,Gemini_BTCUSD_1h_17_12_17_to_10_03_23.csv,BTC_USD,HOUR,86727.7,6.58,09/12/2021 12:00:00,09/12/2021 12:00:00,09/12/2021 10:00:00,STOP_LOSS_HIT,LONG,49236.0,48972.4,50026.81,48972.4,3.736,1.58,0.54,5203.53,2,3.0,-1734.49
21/08/2018 09:00:00,15/06/2023 18:58:16,Gemini_BTCUSD_1h_17_12_17_to_10_03_23.csv,BTC_USD,HOUR,84993.21,15.207,21/08/2018 10:00:00,21/08/2018 12:00:00,21/08/2018 12:00:00,EXPIRED,LONG,6428.0,6435.0,6763.35,6316.22,1.15,4.96,1.77,5099.67,2,3.0,106.45
08/04/2019 03:00:00,15/06/2023 18:58:16,Gemini_BTCUSD_1h_17_12_17_to_10_03_23.csv,BTC_USD,HOUR,85099.66,18.388,08/04/2019 04:00:00,08/04/2019 06:00:00,08/04/2019 06:00:00,EXPIRED,LONG,5250.0,5272.0,5527.68,5157.44,1.134,5.02,1.79,5105.98,2,3.0,404.54
15/02/2023 21:00:00,15/06/2023 18:58:16,Gemini_BTCUSD_1h_17_12_17_to_10_03_23.csv,BTC_USD,HOUR,85504.2,14.102,15/02/2023 22:00:00,16/02/2023 00:00:00,16/02/2023 00:00:00,TAKE_PROFIT_HIT,LONG,24180.0,24543.82,24543.82,24058.73,3.988,1.48,0.5,5130.59,2,3.0,5130.59
03/12/2019 03:00:00,15/06/2023 18:58:16,Gemini_BTCUSD_1h_17_12_17_to_10_03_23.csv,BTC_USD,HOUR,90634.79,16.85,03/12/2019 04:00:00,03/12/2019 06:00:00,03/12/2019 06:00:00,EXPIRED,LONG,7360.0,7314.0,7682.75,7252.42,1.368,4.2,1.48,5438.34,2,3.0,-775.1
29/08/2020 03:00:00,15/06/2023 18:58:16,Gemini_BTCUSD_1h_17_12_17_to_10_03_23.csv,BTC_USD,HOUR,89859.69,15.007,29/08/2020 07:00:00,29/08/2020 06:00:00,29/08/2020 06:00:00,EXPIRED,SHORT,11509.0,11533.0,11149.71,11628.76,1.922,3.22,1.03,5391.87,2,3.0,-360.17
02/06/2021 17:00:00,15/06/2023 18:58:16,Gemini_BTCUSD_1h_17_12_17_to_10_03_23.csv,BTC_USD,HOUR,89499.52,2.435,02/06/2021 18:00:00,02/06/2021 20:00:00,02/06/2021 20:00:00,EXPIRED,LONG,38016.0,37750.0,40221.67,37280.78,1.034,5.48,1.97,5370.81,2,3.0,-647.71
16/06/2020 13:00:00,15/06/2023 18:58:16,Gemini_BTCUSD_1h_17_12_17_to_10_03_23.csv,BTC_USD,HOUR,88851.81,11.259,16/06/2020 14:00:00,16/06/2020 16:00:00,16/06/2020 16:00:00,EXPIRED,LONG,9539.0,9492.0,10012.5,9381.17,1.209,4.73,1.68,5331.14,2,3.0,-529.17
14/06/2019 23:00:00,15/06/2023 18:58:16,Gemini_BTCUSD_1h_17_12_17_to_10_03_23.csv,BTC_USD,HOUR,88322.64,16.311,15/06/2019 00:00:00,15/06/2019 02:00:00,15/06/2019 02:00:00,EXPIRED,LONG,8700.0,8669.0,9024.89,8591.7,1.607,3.6,1.26,5299.28,2,3.0,-505.64
19/11/2021 15:00:00,15/06/2023 18:58:16,Gemini_BTCUSD_1h_17_12_17_to_10_03_23.csv,BTC_USD,HOUR,87817.0,2.892,19/11/2021 16:00:00,19/11/2021 18:00:00,19/11/2021 18:00:00,EXPIRED,LONG,57949.0,57963.0,59771.2,57341.6,1.908,3.05,1.06,5269.8,2,3.0,40.49
03/03/2021 04:00:00,15/06/2023 18:58:16,Gemini_BTCUSD_1h_17_12_17_to_10_03_23.csv,BTC_USD,HOUR,87857.49,3.662,03/03/2021 08:00:00,03/03/2021 07:00:00,03/03/2021 07:00:00,EXPIRED,LONG,49170.0,49746.0,50609.48,48690.18,2.049,2.84,0.99,5271.38,2,3.0,2109.31
13/01/2018 10:00:00,15/06/2023 18:58:16,Gemini_BTCUSD_1h_17_12_17_to_10_03_23.csv,BTC_USD,HOUR,89966.8,23.864,13/01/2018 11:00:00,13/01/2018 13:00:00,13/01/2018 13:00:00,TAKE_PROFIT_HIT,LONG,14245.0,14471.21,14471.21,14169.6,3.779,1.56,0.53,5398.28,2,3.0,5398.28
15/05/2021 00:00:00,15/06/2023 18:58:16,Gemini_BTCUSD_1h_17_12_17_to_10_03_23.csv,BTC_USD,HOUR,95365.08,7.083,15/05/2021 04:00:00,15/05/2021 03:00:00,15/05/2021 01:00:00,STOP_LOSS_HIT,LONG,49478.0,49208.71,50285.89,49208.71,3.675,1.61,0.55,5722.28,2,3.0,-1907.38
08/07/2018 16:00:00,15/06/2023 18:58:16,Gemini_BTCUSD_1h_17_12_17_to_10_03_23.csv,BTC_USD,HOUR,93457.7,14.538,08/07/2018 17:00:00,08/07/2018 19:00:00,08/07/2018 19:00:00,EXPIRED,LONG,6747.0,6749.0,7132.72,6618.43,1.05,5.41,1.94,5607.6,2,3.0,29.08
22/02/2021 16:00:00,15/06/2023 18:58:16,Gemini_BTCUSD_1h_17_12_17_to_10_03_23.csv,BTC_USD,HOUR,93486.78,7.444,22/02/2021 18:00:00,22/02/2021 19:00:00,22/02/2021 17:00:00,TAKE_PROFIT_HIT,SHORT,53180.0,52426.48,52426.48,53431.17,4.235,1.44,0.47,5609.2,2,3.0,5609.2
11/07/2021 18:00:00,15/06/2023 18:58:16,Gemini_BTCUSD_1h_17_12_17_to_10_03_23.csv,BTC_USD,HOUR,99095.98,3.544,11/07/2021 19:00:00,11/07/2021 21:00:00,11/07/2021 21:00:00,EXPIRED,LONG,33962.0,34479.0,35639.65,33402.79,1.215,4.71,1.67,5945.59,2,3.0,1832.25
10/01/2023 13:00:00,15/06/2023 18:58:16,Gemini_BTCUSD_1h_17_12_17_to_10_03_23.csv,BTC_USD,HOUR,100928.23,23.119,10/01/2023 17:00:00,10/01/2023 16:00:00,10/01/2023 15:00:00,STOP_LOSS_HIT,SHORT,17240.0,17327.31,16978.08,17327.31,3.949,1.54,0.5,6055.33,2,3.0,-2018.52
30/05/2021 02:00:00,15/06/2023 18:58:16,Gemini_BTCUSD_1h_17_12_17_to_10_03_23.csv,BTC_USD,HOUR,98909.71,10.848,30/05/2021 03:00:00,30/05/2021 05:00:00,30/05/2021 04:00:00,TAKE_PROFIT_HIT,LONG,34553.0,35100.07,35100.07,34370.65,3.79,1.56,0.53,5934.62,2,3.0,5934.62
17/01/2018 07:00:00,15/06/2023 18:58:16,Gemini_BTCUSD_1h_17_12_17_to_10_03_23.csv,BTC_USD,HOUR,104844.33,11.632,17/01/2018 08:00:00,17/01/2018 10:00:00,17/01/2018 08:00:00,STOP_LOSS_HIT,LONG,11299.0,11118.73,11839.81,11118.73,1.254,4.57,1.62,6290.7,2,3.0,-2096.9
22/05/2020 18:00:00,15/06/2023 18:58:16,Gemini_BTCUSD_1h_17_12_17_to_10_03_23.csv,BTC_USD,HOUR,102747.43,17.857,22/05/2020 19:00:00,22/05/2020 21:00:00,22/05/2020 21:00:00,EXPIRED,LONG,9199.0,9212.0,9544.25,9083.92,1.599,3.62,1.27,6165.13,2,3.0,232.14
21/04/2019 06:00:00,15/06/2023 18:58:16,Gemini_BTCUSD_1h_17_12_17_to_10_03_23.csv,BTC_USD,HOUR,102979.57,75.693,21/04/2019 10:00:00,21/04/2019 09:00:00,21/04/2019 08:00:00,STOP_LOSS_HIT,LONG,5327.0,5299.79,5408.63,5299.79,3.916,1.51,0.51,6178.82,2,3.0,-2059.61
19/09/2021 21:00:00,15/06/2023 18:58:16,Gemini_BTCUSD_1h_17_12_17_to_10_03_23.csv,BTC_USD,HOUR,100919.96,2.608,19/09/2021 23:00:00,20/09/2021 00:00:00,20/09/2021 00:00:00,EXPIRED,LONG,47463.0,46991.0,49784.88,46689.04,1.227,4.66,1.66,6055.46,2,3.0,-1230.98
06/10/2019 02:00:00,15/06/2023 18:58:16,Gemini_BTCUSD_1h_17_12_17_to_10_03_23.csv,BTC_USD,HOUR,99688.98,17.342,06/10/2019 04:00:00,06/10/2019 05:00:00,06/10/2019 05:00:00,EXPIRED,SHORT,8076.0,8076.0,7731.09,8190.97,1.405,4.46,1.4,5981.43,2,3.0,0.0
13/01/2021 04:00:00,15/06/2023 18:58:16,Gemini_BTCUSD_1h_17_12_17_to_10_03_23.csv,BTC_USD,HOUR,99688.98,7.208,13/01/2021 08:00:00,13/01/2021 07:00:00,13/01/2021 05:00:00,STOP_LOSS_HIT,LONG,33172.0,32895.41,34001.77,32895.41,2.398,2.44,0.84,5980.98,2,3.0,-1993.66
29/04/2021 23:00:00,15/06/2023 18:58:16,Gemini_BTCUSD_1h_17_12_17_to_10_03_23.csv,BTC_USD,HOUR,97695.32,2.476,30/04/2021 00:00:00,30/04/2021 02:00:00,30/04/2021 02:00:00,EXPIRED,LONG,53610.0,53583.0,55977.2,52820.94,1.359,4.23,1.49,5861.19,2,3.0,-66.85
04/02/2018 07:00:00,15/06/2023 18:58:16,Gemini_BTCUSD_1h_17_12_17_to_10_03_23.csv,BTC_USD,HOUR,97628.47,31.306,04/02/2018 08:00:00,04/02/2018 10:00:00,04/02/2018 08:00:00,STOP_LOSS_HIT,LONG,9189.0,9126.63,9376.12,9126.63,2.947,2.0,0.68,5857.98,2,3.0,-1952.56
05/03/2023 00:00:00,15/06/2023 18:58:16,Gemini_BTCUSD_1h_17_12_17_to_10_03_23.csv,BTC_USD,HOUR,95675.91,8.104,05/03/2023 01:00:00,05/03/2023 03:00:00,05/03/2023 03:00:00,EXPIRED,LONG,22378.0,22379.0,23086.41,22141.87,1.895,3.07,1.07,5740.95,2,3.0,8.1
25/05/2020 14:00:00,15/06/2023 18:58:16,Gemini_BTCUSD_1h_17_12_17_to_10_03_23.csv,BTC_USD,HOUR,95684.01,13.108,25/05/2020 17:00:00,25/05/2020 17:00:00,25/05/2020 17:00:00,EXPIRED,LONG,8748.0,8892.0,9185.98,8602.01,1.198,4.77,1.7,5741.04,2,3.0,1887.55
01/07/2022 17:00:00,15/06/2023 18:58:16,Gemini_BTCUSD_1h_17_12_17_to_10_03_23.csv,BTC_USD,HOUR,97571.56,10.346,01/07/2022 18:00:00,01/07/2022 20:00:00,01/07/2022 19:00:00,STOP_LOSS_HIT,LONG,19460.0,19271.39,20025.82,19271.39,2.063,2.83,0.98,5853.97,2,3.0,-1951.36
22/02/2019 15:00:00,15/06/2023 18:58:16,Gemini_BTCUSD_1h_17_12_17_to_10_03_23.csv,BTC_USD,HOUR,95620.2,39.069,22/02/2019 17:00:00,22/02/2019 18:00:00,22/02/2019 18:00:00,EXPIRED,LONG,3931.0,3942.0,4077.84,3882.05,1.606,3.6,1.26,5736.89,2,3.0,429.76
19/12/2017 20:00:00,15/06/2023 18:58:16,Gemini_BTCUSD_1h_17_12_17_to_10_03_23.csv,BTC_USD,HOUR,96049.96,16.359,19/12/2017 23:00:00,19/12/2017 23:00:00,19/12/2017 21:00:00,TAKE_PROFIT_HIT,SHORT,17698.0,17345.71,17345.71,17815.43,3.014,2.03,0.66,5763.11,2,3.0,5763.11
04/01/2022 18:00:00,15/06/2023 18:58:16,Gemini_BTCUSD_1h_17_12_17_to_10_03_23.csv,BTC_USD,HOUR,101813.07,8.63,04/01/2022 22:00:00,04/01/2022 21:00:00,04/01/2022 21:00:00,EXPIRED,LONG,45736.0,46201.0,46443.83,45500.06,3.877,1.52,0.52,6108.57,2,3.0,4012.95
19/04/2018 18:00:00,15/06/2023 18:58:16,Gemini_BTCUSD_1h_17_12_17_to_10_03_23.csv,BTC_USD,HOUR,105826.02,13.756,19/04/2018 19:00:00,19/04/2018 21:00:00,19/04/2018 21:00:00,EXPIRED,LONG,8275.0,8274.0,8736.58,8121.14,1.076,5.28,1.89,6349.49,2,3.0,-13.76
22/04/2020 21:00:00,15/06/2023 18:58:16,Gemini_BTCUSD_1h_17_12_17_to_10_03_23.csv,BTC_USD,HOUR,105812.26,54.896,23/04/2020 01:00:00,23/04/2020 00:00:00,23/04/2020 00:00:00,STOP_LOSS_HIT,SHORT,7106.0,7144.55,6990.34,7144.55,3.687,1.65,0.54,6349.27,2,3.0,-2116.24
28/07/2021 19:00:00,15/06/2023 18:58:16,Gemini_BTCUSD_1h_17_12_17_to_10_03_23.csv,BTC_USD,HOUR,103696.02,4.733,28/07/2021 20:00:00,28/07/2021 22:00:00,28/07/2021 22:00:00,EXPIRED,SHORT,40412.0,39772.0,39097.38,40850.21,1.845,3.36,1.07,6222.1,2,3.0,3029.12
04/03/2019 19:00:00,15/06/2023 18:58:16,Gemini_BTCUSD_1h_17_12_17_to_10_03_23.csv,BTC_USD,HOUR,106725.14,97.422,04/03/2019 20:00:00,04/03/2019 22:00:00,04/03/2019 22:00:00,EXPIRED,LONG,3704.0,3695.0,3769.74,3682.09,3.381,1.74,0.6,6404.52,2,3.0,-876.8
25/07/2021 09:00:00,15/06/2023 18:58:16,Gemini_BTCUSD_1h_17_12_17_to_10_03_23.csv,BTC_USD,HOUR,105848.34,3.277,25/07/2021 11:00:00,25/07/2021 12:00:00,25/07/2021 12:00:00,EXPIRED,LONG,34549.0,34318.0,36487.2,33902.93,1.07,5.31,1.91,6351.48,2,3.0,-756.99
12/08/2019 05:00:00,15/06/2023 18:58:16,Gemini_BTCUSD_1h_17_12_17_to_10_03_23.csv,BTC_USD,HOUR,105091.35,28.721,12/08/2019 08:00:00,12/08/2019 08:00:00,12/08/2019 08:00:00,STOP_LOSS_HIT,LONG,11377.0,11303.82,11596.54,11303.82,3.109,1.89,0.65,6305.41,2,3.0,-2101.8
29/01/2019 01:00:00,15/06/2023 18:58:16,Gemini_BTCUSD_1h_17_12_17_to_10_03_23.csv,BTC_USD,HOUR,102989.55,42.313,29/01/2019 02:00:00,29/01/2019 04:00:00,29/01/2019 04:00:00,STOP_LOSS_HIT,LONG,3419.0,3370.32,3565.03,3370.32,1.405,4.1,1.44,6178.97,2,3.0,-2059.8
10/01/2022 00:00:00,15/06/2023 18:58:16,Gemini_BTCUSD_1h_17_12_17_to_10_03_23.csv,BTC_USD,HOUR,100929.75,8.726,10/01/2022 02:00:00,10/01/2022 03:00:00,10/01/2022 02:00:00,STOP_LOSS_HIT,SHORT,41657.0,41888.33,40963.01,41888.33,3.602,1.69,0.55,6055.76,2,3.0,-2018.59
27/02/2022 12:00:00,15/06/2023 18:58:16,Gemini_BTCUSD_1h_17_12_17_to_10_03_23.csv,BTC_USD,HOUR,98911.16,3.279,27/02/2022 13:00:00,27/02/2022 15:00:00,27/02/2022 13:00:00,STOP_LOSS_HIT,LONG,39768.0,39164.77,41577.69,39164.77,1.318,4.35,1.54,5933.97,2,3.0,-1977.99
18/07/2022 15:00:00,15/06/2023 18:58:16,Gemini_BTCUSD_1h_17_12_17_to_10_03_23.csv,BTC_USD,HOUR,96933.17,14.803,18/07/2022 16:00:00,18/07/2022 18:00:00,18/07/2022 16:00:00,STOP_LOSS_HIT,LONG,22694.0,22563.04,23086.87,22563.04,3.466,1.7,0.58,5815.65,2,3.0,-1938.6
02/04/2019 06:00:00,15/06/2023 18:58:16,Gemini_BTCUSD_1h_17_12_17_to_10_03_23.csv,BTC_USD,HOUR,94994.57,45.991,02/04/2019 09:00:00,02/04/2019 09:00:00,02/04/2019 07:00:00,STOP_LOSS_HIT,LONG,4720.0,4678.69,4843.92,4678.69,2.285,2.56,0.88,5699.2,2,3.0,-1899.89
22/02/2021 09:00:00,15/06/2023 18:58:16,Gemini_BTCUSD_1h_17_12_17_to_10_03_23.csv,BTC_USD,HOUR,93094.68,3.927,22/02/2021 10:00:00,22/02/2021 12:00:00,22/02/2021 10:00:00,STOP_LOSS_HIT,LONG,54768.0,54293.89,56190.36,54293.89,2.31,2.53,0.87,5585.61,2,3.0,-1861.83
27/07/2020 07:00:00,15/06/2023 18:58:16,Gemini_BTCUSD_1h_17_12_17_to_10_03_23.csv,BTC_USD,HOUR,91232.85,15.753,27/07/2020 09:00:00,27/07/2020 10:00:00,27/07/2020 10:00:00,STOP_LOSS_HIT,SHORT,10155.0,10270.83,9807.51,10270.83,1.753,3.54,1.13,5474.01,2,3.0,-1824.67
03/11/2021 16:00:00,15/06/2023 18:58:16,Gemini_BTCUSD_1h_17_12_17_to_10_03_23.csv,BTC_USD,HOUR,89408.18,6.078,03/11/2021 20:00:00,03/11/2021 19:00:00,03/11/2021 17:00:00,STOP_LOSS_HIT,SHORT,62162.0,62456.21,61279.4,62456.21,4.226,1.44,0.47,5364.44,2,3.0,-1788.21
14/10/2018 08:00:00,15/06/2023 18:58:16,Gemini_BTCUSD_1h_17_12_17_to_10_03_23.csv,BTC_USD,HOUR,87619.97,30.588,14/10/2018 09:00:00,14/10/2018 11:00:00,14/10/2018 11:00:00,EXPIRED,LONG,6245.0,6219.0,6416.87,6187.71,2.18,2.68,0.93,5257.16,2,3.0,-795.29
29/12/2020 02:00:00,15/06/2023 18:58:16,Gemini_BTCUSD_1h_17_12_17_to_10_03_23.csv,BTC_USD,HOUR,86824.68,129.585,29/12/2020 04:00:00,29/12/2020 05:00:00,29/12/2020 03:00:00,TAKE_PROFIT_HIT,SHORT,26833.0,26792.82,26792.82,26846.4,40.048,0.15,0.05,5206.73,2,3.0,5206.73
19/03/2018 00:00:00,15/06/2023 18:58:16,Gemini_BTCUSD_1h_17_12_17_to_10_03_23.csv,BTC_USD,HOUR,92031.41,15.633,19/03/2018 01:00:00,19/03/2018 03:00:00,19/03/2018 01:00:00,STOP_LOSS_HIT,LONG,8290.0,8172.26,8643.24,8172.26,1.408,4.09,1.44,5522.2,2,3.0,-1840.63
29/08/2018 11:00:00,15/06/2023 18:58:16,Gemini_BTCUSD_1h_17_12_17_to_10_03_23.csv,BTC_USD,HOUR,90190.78,15.179,29/08/2018 12:00:00,29/08/2018 14:00:00,29/08/2018 14:00:00,EXPIRED,LONG,7082.0,7075.0,7438.52,6963.16,1.192,4.79,1.71,5411.62,2,3.0,-106.25
20/12/2022 03:00:00,15/06/2023 18:58:16,Gemini_BTCUSD_1h_17_12_17_to_10_03_23.csv,BTC_USD,HOUR,90084.53,22.317,20/12/2022 07:00:00,20/12/2022 06:00:00,20/12/2022 06:00:00,EXPIRED,LONG,16724.0,16828.0,16966.21,16643.27,4.143,1.43,0.49,5405.4,2,3.0,2320.97
07/06/2022 18:00:00,15/06/2023 18:58:16,Gemini_BTCUSD_1h_17_12_17_to_10_03_23.csv,BTC_USD,HOUR,92405.5,10.948,07/06/2022 20:00:00,07/06/2022 21:00:00,07/06/2022 19:00:00,STOP_LOSS_HIT,SHORT,30176.0,30344.81,29669.58,30344.81,3.575,1.71,0.56,5544.29,2,3.0,-1848.13
10/03/2023 14:00:00,15/06/2023 18:58:16,Gemini_BTCUSD_1h_17_12_17_to_10_03_23.csv,BTC_USD,HOUR,90557.37,14.549,10/03/2023 15:00:00,10/03/2023 17:00:00,10/03/2023 16:00:00,TAKE_PROFIT_HIT,LONG,19805.0,20178.47,20178.47,19680.51,3.182,1.85,0.63,5433.62,2,3.0,5433.62
25/11/2022 11:00:00,15/06/2023 18:58:16,Gemini_BTCUSD_1h_17_12_17_to_10_03_23.csv,BTC_USD,HOUR,95990.99,22.347,25/11/2022 12:00:00,25/11/2022 14:00:00,25/11/2022 14:00:00,EXPIRED,LONG,16508.0,16533.0,16765.73,16422.09,3.843,1.54,0.52,5759.49,2,3.0,558.68
03/03/2018 06:00:00,15/06/2023 18:58:16,Gemini_BTCUSD_1h_17_12_17_to_10_03_23.csv,BTC_USD,HOUR,96549.67,33.448,03/03/2018 08:00:00,03/03/2018 09:00:00,03/03/2018 08:00:00,STOP_LOSS_HIT,LONG,11329.0,11271.27,11502.19,11271.27,3.925,1.51,0.51,5792.86,2,3.0,-1930.95
18/08/2022 21:00:00,15/06/2023 18:58:16,Gemini_BTCUSD_1h_17_12_17_to_10_03_23.csv,BTC_USD,HOUR,94618.72,6.256,19/08/2022 00:00:00,19/08/2022 00:00:00,19/08/2022 00:00:00,STOP_LOSS_HIT,LONG,23369.0,23066.52,24276.44,23066.52,1.545,3.74,1.31,5676.94,2,3.0,-1892.31
17/05/2020 08:00:00,15/06/2023 18:58:16,Gemini_BTCUSD_1h_17_12_17_to_10_03_23.csv,BTC_USD,HOUR,92726.41,17.723,17/05/2020 11:00:00,17/05/2020 11:00:00,17/05/2020 11:00:00,EXPIRED,LONG,9492.0,9528.0,9805.92,9387.36,1.814,3.2,1.11,5563.6,2,3.0,638.03
04/03/2020 00:00:00,15/06/2023 18:58:16,Gemini_BTCUSD_1h_17_12_17_to_10_03_23.csv,BTC_USD,HOUR,93364.44,13.159,04/03/2020 02:00:00,04/03/2020 03:00:00,04/03/2020 03:00:00,EXPIRED,LONG,8776.0,8787.0,9201.7,8634.1,1.237,4.63,1.64,5601.79,2,3.0,144.75
02/01/2021 17:00:00,15/06/2023 18:58:16,Gemini_BTCUSD_1h_17_12_17_to_10_03_23.csv,BTC_USD,HOUR,93509.19,5.518,02/01/2021 18:00:00,02/01/2021 20:00:00,02/01/2021 18:00:00,STOP_LOSS_HIT,LONG,32960.0,32621.05,33976.87,32621.05,1.945,2.99,1.04,5611.09,2,3.0,-1870.33
10/09/2022 22:00:00,15/06/2023 18:58:16,Gemini_BTCUSD_1h_17_12_17_to_10_03_23.csv,BTC_USD,HOUR,91638.86,10.229,11/09/2022 02:00:00,11/09/2022 01:00:00,11/09/2022 00:00:00,STOP_LOSS_HIT,LONG,21776.0,21596.82,22313.55,21596.82,2.431,2.41,0.83,5498.6,2,3.0,-1832.83
16/04/2019 09:00:00,15/06/2023 18:58:16,Gemini_BTCUSD_1h_17_12_17_to_10_03_23.csv,BTC_USD,HOUR,89806.03,20.511,16/04/2019 10:00:00,16/04/2019 12:00:00,16/04/2019 12:00:00,EXPIRED,LONG,5084.0,5035.0,5346.7,4996.43,1.161,4.91,1.75,5388.24,2,3.0,-1005.04
10/02/2023 08:00:00,15/06/2023 18:58:16,Gemini_BTCUSD_1h_17_12_17_to_10_03_23.csv,BTC_USD,HOUR,88800.99,4.725,10/02/2023 09:00:00,10/02/2023 11:00:00,10/02/2023 11:00:00,EXPIRED,LONG,21900.0,21739.0,23027.58,21524.14,1.165,4.9,1.75,5327.82,2,3.0,-760.72
05/03/2021 18:00:00,15/06/2023 18:58:16,Gemini_BTCUSD_1h_17_12_17_to_10_03_23.csv,BTC_USD,HOUR,88040.27,4.013,05/03/2021 19:00:00,05/03/2021 21:00:00,05/03/2021 21:00:00,EXPIRED,LONG,48486.0,49063.0,49802.4,48047.21,2.21,2.64,0.91,5282.71,2,3.0,2315.5
21/08/2022 03:00:00,15/06/2023 18:58:16,Gemini_BTCUSD_1h_17_12_17_to_10_03_23.csv,BTC_USD,HOUR,90355.77,15.798,21/08/2022 04:00:00,21/08/2022 06:00:00,21/08/2022 06:00:00,STOP_LOSS_HIT,LONG,21213.0,21098.61,21556.18,21098.61,3.709,1.59,0.54,5421.56,2,3.0,-1807.13
23/06/2018 10:00:00,15/06/2023 18:58:16,Gemini_BTCUSD_1h_17_12_17_to_10_03_23.csv,BTC_USD,HOUR,88548.64,17.279,23/06/2018 14:00:00,23/06/2018 13:00:00,23/06/2018 13:00:00,EXPIRED,SHORT,6143.0,6168.0,5835.53,6245.49,1.199,5.27,1.64,5312.77,2,3.0,-431.97
13/07/2022 12:00:00,15/06/2023 18:58:16,Gemini_BTCUSD_1h_17_12_17_to_10_03_23.csv,BTC_USD,HOUR,88116.67,19.358,13/07/2022 15:00:00,13/07/2022 15:00:00,13/07/2022 13:00:00,STOP_LOSS_HIT,LONG,19151.0,19059.96,19424.12,19059.96,4.207,1.41,0.48,5287.06,2,3.0,-1762.35
22/02/2019 17:00:00,15/06/2023 18:58:16,Gemini_BTCUSD_1h_17_12_17_to_10_03_23.csv,BTC_USD,HOUR,86354.32,87.625,22/02/2019 19:00:00,22/02/2019 20:00:00,22/02/2019 20:00:00,EXPIRED,SHORT,3941.0,3934.0,3881.87,3960.71,3.999,1.52,0.5,5181.27,2,3.0,613.38
19/01/2022 04:00:00,15/06/2023 18:58:16,Gemini_BTCUSD_1h_17_12_17_to_10_03_23.csv,BTC_USD,HOUR,86967.7,8.054,19/01/2022 08:00:00,19/01/2022 07:00:00,19/01/2022 07:00:00,EXPIRED,SHORT,41732.0,41266.0,41084.17,41947.95,3.865,1.58,0.51,5217.62,2,3.0,3753.16
16/08/2018 13:00:00,15/06/2023 18:58:16,Gemini_BTCUSD_1h_17_12_17_to_10_03_23.csv,BTC_USD,HOUR,90720.86,48.243,16/08/2018 17:00:00,16/08/2018 16:00:00,16/08/2018 15:00:00,STOP_LOSS_HIT,SHORT,6349.0,6386.61,6236.18,6386.61,3.376,1.81,0.59,5442.78,2,3.0,-1814.42
10/05/2019 11:00:00,15/06/2023 18:58:16,Gemini_BTCUSD_1h_17_12_17_to_10_03_23.csv,BTC_USD,HOUR,88906.44,59.589,10/05/2019 15:00:00,10/05/2019 14:00:00,10/05/2019 12:00:00,STOP_LOSS_HIT,LONG,6283.0,6253.16,6372.51,6253.16,4.211,1.4,0.48,5333.81,2,3.0,-1778.14
28/08/2021 03:00:00,15/06/2023 18:58:16,Gemini_BTCUSD_1h_17_12_17_to_10_03_23.csv,BTC_USD,HOUR,87128.3,6.525,28/08/2021 04:00:00,28/08/2021 06:00:00,28/08/2021 06:00:00,EXPIRED,LONG,48900.0,49024.0,49701.24,48632.92,3.662,1.61,0.55,5228.09,2,3.0,809.1
23/06/2018 09:00:00,15/06/2023 18:58:16,Gemini_BTCUSD_1h_17_12_17_to_10_03_23.csv,BTC_USD,HOUR,87937.4,25.66,23/06/2018 13:00:00,23/06/2018 12:00:00,23/06/2018 12:00:00,EXPIRED,LONG,6131.0,6146.0,6336.63,6062.46,1.789,3.25,1.13,5276.47,2,3.0,384.9
10/06/2018 14:00:00,15/06/2023 18:58:16,Gemini_BTCUSD_1h_17_12_17_to_10_03_23.csv,BTC_USD,HOUR,88322.3,26.858,10/06/2018 18:00:00,10/06/2018 17:00:00,10/06/2018 17:00:00,TAKE_PROFIT_HIT,SHORT,7241.0,7043.69,7043.69,7306.77,2.202,2.8,0.9,5299.35,2,3.0,5299.35
21/05/2021 23:00:00,15/06/2023 18:58:16,Gemini_BTCUSD_1h_17_12_17_to_10_03_23.csv,BTC_USD,HOUR,93621.65,9.876,22/05/2021 01:00:00,22/05/2021 02:00:00,22/05/2021 00:00:00,STOP_LOSS_HIT,SHORT,37334.0,37523.59,36765.23,37523.59,3.938,1.55,0.51,5617.17,2,3.0,-1872.39
17/08/2020 15:00:00,15/06/2023 18:58:16,Gemini_BTCUSD_1h_17_12_17_to_10_03_23.csv,BTC_USD,HOUR,91749.26,13.851,17/08/2020 16:00:00,17/08/2020 18:00:00,17/08/2020 18:00:00,STOP_LOSS_HIT,LONG,12439.0,12306.52,12836.45,12306.52,1.878,3.1,1.08,5505.08,2,3.0,-1834.98
05/10/2021 11:00:00,15/06/2023 18:58:16,Gemini_BTCUSD_1h_17_12_17_to_10_03_23.csv,BTC_USD,HOUR,89914.28,1.944,05/10/2021 13:00:00,05/10/2021 14:00:00,05/10/2021 14:00:00,EXPIRED,LONG,49913.0,49875.0,52688.39,48987.87,1.079,5.27,1.89,5395.36,2,3.0,-73.87
06/02/2020 00:00:00,15/06/2023 18:58:16,Gemini_BTCUSD_1h_17_12_17_to_10_03_23.csv,BTC_USD,HOUR,89840.41,34.654,06/02/2020 01:00:00,06/02/2020 03:00:00,06/02/2020 03:00:00,EXPIRED,LONG,9548.0,9635.0,9703.55,9496.15,3.683,1.6,0.55,5390.43,2,3.0,3014.9
19/01/2023 22:00:00,15/06/2023 18:58:16,Gemini_BTCUSD_1h_17_12_17_to_10_03_23.csv,BTC_USD,HOUR,92855.31,6.875,19/01/2023 23:00:00,20/01/2023 01:00:00,20/01/2023 01:00:00,EXPIRED,LONG,21078.0,21132.0,21888.37,20807.88,1.561,3.7,1.3,5571.29,2,3.0,371.25
21/07/2020 06:00:00,15/06/2023 18:58:16,Gemini_BTCUSD_1h_17_12_17_to_10_03_23.csv,BTC_USD,HOUR,93226.56,35.678,21/07/2020 10:00:00,21/07/2020 09:00:00,21/07/2020 07:00:00,TAKE_PROFIT_HIT,LONG,9201.0,9357.77,9357.77,9148.74,3.521,1.68,0.57,5593.24,2,3.0,5593.24
23/06/2020 16:00:00,15/06/2023 18:58:16,Gemini_BTCUSD_1h_17_12_17_to_10_03_23.csv,BTC_USD,HOUR,98819.8,11.045,23/06/2020 17:00:00,23/06/2020 19:00:00,23/06/2020 19:00:00,EXPIRED,LONG,9661.0,9650.0,10197.81,9482.06,1.08,5.26,1.89,5929.07,2,3.0,-121.49
18/02/2020 02:00:00,15/06/2023 18:58:16,Gemini_BTCUSD_1h_17_12_17_to_10_03_23.csv,BTC_USD,HOUR,98698.31,17.606,18/02/2020 03:00:00,18/02/2020 05:00:00,18/02/2020 05:00:00,EXPIRED,LONG,9719.0,9799.0,10055.36,9606.88,1.734,3.35,1.17,5921.95,2,3.0,1408.48
26/03/2022 08:00:00,15/06/2023 18:58:16,Gemini_BTCUSD_1h_17_12_17_to_10_03_23.csv,BTC_USD,HOUR,100106.79,9.108,26/03/2022 12:00:00,26/03/2022 11:00:00,26/03/2022 11:00:00,EXPIRED,SHORT,44514.0,44365.0,43854.51,44733.83,4.05,1.5,0.49,6006.63,2,3.0,1357.09
04/11/2021 15:00:00,15/06/2023 18:58:16,Gemini_BTCUSD_1h_17_12_17_to_10_03_23.csv,BTC_USD,HOUR,101463.88,4.087,04/11/2021 17:00:00,04/11/2021 18:00:00,04/11/2021 18:00:00,EXPIRED,LONG,61078.0,60771.0,62567.48,60581.51,2.46,2.38,0.82,6087.5,2,3.0,-1254.71
08/02/2020 00:00:00,15/06/2023 18:58:16,Gemini_BTCUSD_1h_17_12_17_to_10_03_23.csv,BTC_USD,HOUR,100209.17,24.355,08/02/2020 02:00:00,08/02/2020 03:00:00,08/02/2020 03:00:00,STOP_LOSS_HIT,LONG,9778.0,9695.71,10024.87,9695.71,2.376,2.46,0.85,6012.52,2,3.0,-2004.17
25/06/2022 07:00:00,15/06/2023 18:58:16,Gemini_BTCUSD_1h_17_12_17_to_10_03_23.csv,BTC_USD,HOUR,98205.0,15.647,25/06/2022 08:00:00,25/06/2022 10:00:00,25/06/2022 08:00:00,STOP_LOSS_HIT,LONG,21487.0,21361.47,21863.58,21361.47,3.424,1.72,0.59,5892.35,2,3.0,-1964.17
22/12/2018 09:00:00,15/06/2023 18:58:16,Gemini_BTCUSD_1h_17_12_17_to_10_03_23.csv,BTC_USD,HOUR,96240.83,25.471,22/12/2018 10:00:00,22/12/2018 12:00:00,22/12/2018 12:00:00,STOP_LOSS_HIT,LONG,3929.0,3853.43,4155.7,3853.43,1.04,5.46,1.96,5774.28,2,3.0,-1924.84
08/02/2019 19:00:00,15/06/2023 18:58:16,Gemini_BTCUSD_1h_17_12_17_to_10_03_23.csv,BTC_USD,HOUR,94315.99,40.891,08/02/2019 20:00:00,08/02/2019 22:00:00,08/02/2019 21:00:00,STOP_LOSS_HIT,LONG,3634.0,3587.87,3772.38,3587.87,1.576,3.67,1.29,5658.5,2,3.0,-1886.3
10/08/2021 11:00:00,15/06/2023 18:58:16,Gemini_BTCUSD_1h_17_12_17_to_10_03_23.csv,BTC_USD,HOUR,92429.69,8.353,10/08/2021 13:00:00,10/08/2021 14:00:00,10/08/2021 12:00:00,STOP_LOSS_HIT,SHORT,45381.0,45602.32,44717.04,45602.32,4.101,1.48,0.49,5546.06,2,3.0,-1848.69
27/09/2018 09:00:00,15/06/2023 18:58:16,Gemini_BTCUSD_1h_17_12_17_to_10_03_23.csv,BTC_USD,HOUR,90581.0,55.811,27/09/2018 11:00:00,27/09/2018 12:00:00,27/09/2018 11:00:00,STOP_LOSS_HIT,SHORT,6449.0,6481.46,6351.64,6481.46,3.974,1.53,0.5,5433.76,2,3.0,-1811.63
12/03/2021 03:00:00,15/06/2023 18:58:16,Gemini_BTCUSD_1h_17_12_17_to_10_03_23.csv,BTC_USD,HOUR,88769.37,5.395,12/03/2021 04:00:00,12/03/2021 06:00:00,12/03/2021 04:00:00,STOP_LOSS_HIT,LONG,57112.0,56782.95,58099.17,56782.95,3.471,1.7,0.58,5325.78,2,3.0,-1775.22
11/09/2022 18:00:00,15/06/2023 18:58:16,Gemini_BTCUSD_1h_17_12_17_to_10_03_23.csv,BTC_USD,HOUR,86994.15,12.466,11/09/2022 19:00:00,11/09/2022 21:00:00,11/09/2022 21:00:00,EXPIRED,LONG,21550.0,21507.0,21968.7,21410.43,3.088,1.91,0.65,5219.51,2,3.0,-536.04
02/01/2023 14:00:00,15/06/2023 18:58:16,Gemini_BTCUSD_1h_17_12_17_to_10_03_23.csv,BTC_USD,HOUR,86458.11,15.155,02/01/2023 15:00:00,02/01/2023 17:00:00,02/01/2023 17:00:00,EXPIRED,LONG,16699.0,16704.0,17041.29,16584.9,2.927,2.01,0.69,5187.4,2,3.0,75.77
20/01/2020 14:00:00,15/06/2023 18:58:16,Gemini_BTCUSD_1h_17_12_17_to_10_03_23.csv,BTC_USD,HOUR,86533.88,33.796,20/01/2020 16:00:00,20/01/2020 17:00:00,20/01/2020 17:00:00,EXPIRED,SHORT,8645.0,8635.0,8491.37,8696.21,3.376,1.81,0.59,5192.08,2,3.0,337.96
17/09/2020 20:00:00,15/06/2023 18:58:16,Gemini_BTCUSD_1h_17_12_17_to_10_03_23.csv,BTC_USD,HOUR,86871.84,19.03,17/09/2020 21:00:00,17/09/2020 23:00:00,17/09/2020 23:00:00,EXPIRED,LONG,10938.0,10951.0,11211.9,10846.7,2.396,2.44,0.84,5212.32,2,3.0,247.39
30/10/2018 22:00:00,15/06/2023 18:58:16,Gemini_BTCUSD_1h_17_12_17_to_10_03_23.csv,BTC_USD,HOUR,87119.23,22.227,30/10/2018 23:00:00,31/10/2018 01:00:00,31/10/2018 01:00:00,EXPIRED,LONG,6273.0,6265.0,6508.18,6194.61,1.6,3.61,1.27,5227.35,2,3.0,-177.82
16/03/2020 14:00:00,15/06/2023 18:58:16,Gemini_BTCUSD_1h_17_12_17_to_10_03_23.csv,BTC_USD,HOUR,86941.41,19.443,16/03/2020 16:00:00,16/03/2020 17:00:00,16/03/2020 17:00:00,EXPIRED,LONG,4937.0,5077.0,5205.29,4847.57,1.104,5.15,1.84,5216.36,2,3.0,2722.02
24/12/2018 05:00:00,15/06/2023 18:58:16,Gemini_BTCUSD_1h_17_12_17_to_10_03_23.csv,BTC_USD,HOUR,89663.43,35.865,24/12/2018 07:00:00,24/12/2018 08:00:00,24/12/2018 08:00:00,EXPIRED,SHORT,4210.0,4195.0,4060.01,4260.0,1.684,3.69,1.17,5379.39,2,3.0,537.98
17/06/2020 07:00:00,15/06/2023 18:58:16,Gemini_BTCUSD_1h_17_12_17_to_10_03_23.csv,BTC_USD,HOUR,90201.41,18.579,17/06/2020 11:00:00,17/06/2020 10:00:00,17/06/2020 10:00:00,EXPIRED,LONG,9499.0,9479.0,9790.3,9401.9,1.957,2.98,1.03,5412.06,2,3.0,-371.58
24/06/2022 14:00:00,15/06/2023 18:58:16,Gemini_BTCUSD_1h_17_12_17_to_10_03_23.csv,BTC_USD,HOUR,89829.83,4.34,24/06/2022 15:00:00,24/06/2022 17:00:00,24/06/2022 17:00:00,EXPIRED,LONG,21107.0,20953.0,22348.75,20693.08,1.02,5.56,2.0,5389.2,2,3.0,-668.36
27/04/2018 02:00:00,15/06/2023 18:58:16,Gemini_BTCUSD_1h_17_12_17_to_10_03_23.csv,BTC_USD,HOUR,89161.47,16.763,27/04/2018 06:00:00,27/04/2018 05:00:00,27/04/2018 03:00:00,STOP_LOSS_HIT,LONG,9260.0,9153.62,9579.15,9153.62,1.741,3.33,1.16,5349.91,2,3.0,-1783.25
21/12/2020 07:00:00,15/06/2023 18:58:16,Gemini_BTCUSD_1h_17_12_17_to_10_03_23.csv,BTC_USD,HOUR,87378.22,8.467,21/12/2020 09:00:00,21/12/2020 10:00:00,21/12/2020 08:00:00,STOP_LOSS_HIT,LONG,23987.0,23780.61,24606.16,23780.61,2.324,2.52,0.87,5242.43,2,3.0,-1747.5
30/09/2021 00:00:00,15/06/2023 18:58:16,Gemini_BTCUSD_1h_17_12_17_to_10_03_23.csv,BTC_USD,HOUR,85630.72,2.796,30/09/2021 01:00:00,30/09/2021 03:00:00,30/09/2021 03:00:00,EXPIRED,LONG,42335.0,43601.0,44172.31,41722.56,1.382,4.16,1.47,5137.12,2,3.0,3539.74
26/09/2020 12:00:00,15/06/2023 18:58:16,Gemini_BTCUSD_1h_17_12_17_to_10_03_23.csv,BTC_USD,HOUR,89170.46,25.365,26/09/2020 16:00:00,26/09/2020 15:00:00,26/09/2020 15:00:00,EXPIRED,SHORT,10694.0,10727.0,10483.08,10764.31,3.042,2.01,0.65,5349.99,2,3.0,-837.04
17/02/2018 02:00:00,15/06/2023 18:58:16,Gemini_BTCUSD_1h_17_12_17_to_10_03_23.csv,BTC_USD,HOUR,88333.42,12.673,17/02/2018 03:00:00,17/02/2018 05:00:00,17/02/2018 05:00:00,EXPIRED,LONG,10375.0,10572.0,10793.21,10235.6,1.488,3.87,1.36,5299.98,2,3.0,2496.58
13/10/2018 07:00:00,15/06/2023 18:58:16,Gemini_BTCUSD_1h_17_12_17_to_10_03_23.csv,BTC_USD,HOUR,90830.0,51.784,13/10/2018 09:00:00,13/10/2018 10:00:00,13/10/2018 10:00:00,EXPIRED,LONG,6196.0,6209.0,6301.24,6160.92,3.532,1.67,0.57,5449.75,2,3.0,673.19
03/05/2021 03:00:00,15/06/2023 18:58:16,Gemini_BTCUSD_1h_17_12_17_to_10_03_23.csv,BTC_USD,HOUR,91503.19,2.153,03/05/2021 05:00:00,03/05/2021 06:00:00,03/05/2021 06:00:00,EXPIRED,LONG,57971.0,57983.0,60521.42,57120.86,1.364,4.21,1.49,5491.05,2,3.0,25.84
06/02/2022 05:00:00,15/06/2023 18:58:16,Gemini_BTCUSD_1h_17_12_17_to_10_03_23.csv,BTC_USD,HOUR,91529.03,4.65,06/02/2022 08:00:00,06/02/2022 08:00:00,06/02/2022 08:00:00,EXPIRED,SHORT,41596.0,41669.0,40414.95,41989.69,2.113,2.92,0.94,5491.88,2,3.0,-339.45
04/07/2022 16:00:00,15/06/2023 18:58:16,Gemini_BTCUSD_1h_17_12_17_to_10_03_23.csv,BTC_USD,HOUR,91189.58,15.799,04/07/2022 18:00:00,04/07/2022 19:00:00,04/07/2022 17:00:00,STOP_LOSS_HIT,SHORT,19714.0,19829.44,19367.69,19829.44,3.416,1.79,0.58,5471.35,2,3.0,-1823.84
31/10/2022 11:00:00,15/06/2023 18:58:16,Gemini_BTCUSD_1h_17_12_17_to_10_03_23.csv,BTC_USD,HOUR,89365.74,18.092,31/10/2022 12:00:00,31/10/2022 14:00:00,31/10/2022 13:00:00,STOP_LOSS_HIT,LONG,20736.0,20637.21,21032.38,20637.21,4.198,1.41,0.48,5362.11,2,3.0,-1787.31
24/08/2022 18:00:00,15/06/2023 18:58:16,Gemini_BTCUSD_1h_17_12_17_to_10_03_23.csv,BTC_USD,HOUR,87578.43,10.02,24/08/2022 19:00:00,24/08/2022 21:00:00,24/08/2022 21:00:00,EXPIRED,LONG,21680.0,21589.0,22204.4,21505.2,2.48,2.36,0.81,5254.49,2,3.0,-911.82
02/06/2018 03:00:00,15/06/2023 18:58:16,Gemini_BTCUSD_1h_17_12_17_to_10_03_23.csv,BTC_USD,HOUR,86666.61,18.225,02/06/2018 05:00:00,02/06/2018 06:00:00,02/06/2018 06:00:00,STOP_LOSS_HIT,SHORT,7497.0,7592.11,7211.68,7592.11,1.577,3.96,1.25,5199.96,2,3.0,-1733.38
17/04/2019 22:00:00,15/06/2023 18:58:16,Gemini_BTCUSD_1h_17_12_17_to_10_03_23.csv,BTC_USD,HOUR,84933.23,31.422,18/04/2019 02:00:00,18/04/2019 01:00:00,18/04/2019 01:00:00,STOP_LOSS_HIT,SHORT,5223.0,5277.06,5060.81,5277.06,1.932,3.2,1.02,5096.33,2,3.0,-1698.67
10/01/2020 23:00:00,15/06/2023 18:58:16,Gemini_BTCUSD_1h_17_12_17_to_10_03_23.csv,BTC_USD,HOUR,83234.56,21.403,11/01/2020 00:00:00,11/01/2020 02:00:00,11/01/2020 02:00:00,EXPIRED,LONG,8191.0,8207.0,8424.33,8113.22,2.106,2.77,0.96,4993.96,2,3.0,342.45
22/11/2022 17:00:00,15/06/2023 18:58:16,Gemini_BTCUSD_1h_17_12_17_to_10_03_23.csv,BTC_USD,HOUR,83577.01,14.936,22/11/2022 19:00:00,22/11/2022 20:00:00,22/11/2022 19:00:00,STOP_LOSS_HIT,SHORT,16061.0,16172.91,15725.27,16172.91,2.87,2.13,0.69,5014.46,2,3.0,-1671.49
24/04/2018 11:00:00,15/06/2023 18:58:16,Gemini_BTCUSD_1h_17_12_17_to_10_03_23.csv,BTC_USD,HOUR,81905.52,12.566,24/04/2018 12:00:00,24/04/2018 14:00:00,24/04/2018 14:00:00,EXPIRED,LONG,9294.0,9294.0,9685.08,9163.64,1.426,4.04,1.42,4914.31,2,3.0,0.0
22/01/2023 07:00:00,15/06/2023 18:58:16,Gemini_BTCUSD_1h_17_12_17_to_10_03_23.csv,BTC_USD,HOUR,81905.52,4.431,22/01/2023 08:00:00,22/01/2023 10:00:00,22/01/2023 10:00:00,EXPIRED,LONG,22903.0,22882.0,24012.16,22533.28,1.239,4.62,1.64,4914.69,2,3.0,-93.05
12/08/2022 21:00:00,15/06/2023 18:58:16,Gemini_BTCUSD_1h_17_12_17_to_10_03_23.csv,BTC_USD,HOUR,81812.47,4.068,12/08/2022 22:00:00,13/08/2022 00:00:00,13/08/2022 00:00:00,EXPIRED,LONG,24126.0,24493.0,25332.55,23723.82,1.2,4.76,1.7,4908.25,2,3.0,1492.96
16/08/2021 07:00:00,15/06/2023 18:58:16,Gemini_BTCUSD_1h_17_12_17_to_10_03_23.csv,BTC_USD,HOUR,83305.43,7.15,16/08/2021 08:00:00,16/08/2021 10:00:00,16/08/2021 08:00:00,STOP_LOSS_HIT,LONG,47333.0,47099.98,48032.07,47099.98,4.063,1.46,0.49,4998.35,2,3.0,-1666.09
20/07/2022 14:00:00,15/06/2023 18:58:16,Gemini_BTCUSD_1h_17_12_17_to_10_03_23.csv,BTC_USD,HOUR,81639.34,3.495,20/07/2022 15:00:00,20/07/2022 17:00:00,20/07/2022 16:00:00,STOP_LOSS_HIT,LONG,24205.0,23737.79,25606.65,23737.79,1.036,5.47,1.97,4898.77,2,3.0,-1632.9
04/01/2020 02:00:00,15/06/2023 18:58:16,Gemini_BTCUSD_1h_17_12_17_to_10_03_23.csv,BTC_USD,HOUR,80006.44,18.229,04/01/2020 03:00:00,04/01/2020 05:00:00,04/01/2020 05:00:00,EXPIRED,LONG,7321.0,7330.0,7584.34,7233.22,1.668,3.47,1.21,4800.42,2,3.0,164.06
24/06/2020 04:00:00,15/06/2023 18:58:16,Gemini_BTCUSD_1h_17_12_17_to_10_03_23.csv,BTC_USD,HOUR,80170.5,8.99,24/06/2020 06:00:00,24/06/2020 07:00:00,24/06/2020 07:00:00,EXPIRED,LONG,9650.0,9500.0,10185.09,9471.64,1.082,5.25,1.88,4810.46,2,3.0,-1348.5
16/10/2022 05:00:00,15/06/2023 18:58:16,Gemini_BTCUSD_1h_17_12_17_to_10_03_23.csv,BTC_USD,HOUR,78822.0,131.799,16/10/2022 07:00:00,16/10/2022 08:00:00,16/10/2022 06:00:00,STOP_LOSS_HIT,LONG,19155.0,19143.04,19190.87,19143.04,32.029,0.19,0.06,4727.63,2,3.0,-1576.32
05/04/2022 03:00:00,15/06/2023 18:58:16,Gemini_BTCUSD_1h_17_12_17_to_10_03_23.csv,BTC_USD,HOUR,77245.68,5.407,05/04/2022 06:00:00,05/04/2022 06:00:00,05/04/2022 06:00:00,EXPIRED,LONG,46667.0,46616.0,47524.24,46381.26,3.267,1.8,0.62,4635.1,2,3.0,-275.76
28/09/2018 17:00:00,15/06/2023 18:58:16,Gemini_BTCUSD_1h_17_12_17_to_10_03_23.csv,BTC_USD,HOUR,76969.92,20.544,28/09/2018 18:00:00,28/09/2018 20:00:00,28/09/2018 19:00:00,STOP_LOSS_HIT,LONG,6640.0,6565.07,6864.8,6565.07,1.772,3.27,1.14,4618.29,2,3.0,-1539.36
01/07/2020 19:00:00,15/06/2023 18:58:17,Gemini_BTCUSD_1h_17_12_17_to_10_03_23.csv,BTC_USD,HOUR,75430.56,18.209,01/07/2020 22:00:00,01/07/2020 22:00:00,01/07/2020 22:00:00,EXPIRED,LONG,9248.0,9244.0,9496.55,9165.15,2.232,2.62,0.9,4525.85,2,3.0,-72.84
22/01/2018 09:00:00,15/06/2023 18:58:17,Gemini_BTCUSD_1h_17_12_17_to_10_03_23.csv,BTC_USD,HOUR,75357.72,9.734,22/01/2018 11:00:00,22/01/2018 12:00:00,22/01/2018 11:00:00,STOP_LOSS_HIT,LONG,11732.0,11577.17,12196.5,11577.17,1.515,3.81,1.34,4521.44,2,3.0,-1507.12
02/12/2020 08:00:00,15/06/2023 18:58:17,Gemini_BTCUSD_1h_17_12_17_to_10_03_23.csv,BTC_USD,HOUR,73850.6,6.263,02/12/2020 09:00:00,02/12/2020 11:00:00,02/12/2020 11:00:00,EXPIRED,LONG,19199.0,19140.0,19906.56,18963.15,1.628,3.55,1.24,4431.45,2,3.0,-369.52
03/02/2020 01:00:00,15/06/2023 18:58:17,Gemini_BTCUSD_1h_17_12_17_to_10_03_23.csv,BTC_USD,HOUR,73481.08,31.229,03/02/2020 02:00:00,03/02/2020 04:00:00,03/02/2020 02:00:00,TAKE_PROFIT_HIT,SHORT,9500.0,9358.82,9358.82,9547.06,4.037,1.51,0.49,4408.91,2,3.0,4408.91
17/08/2021 12:00:00,15/06/2023 18:58:17,Gemini_BTCUSD_1h_17_12_17_to_10_03_23.csv,BTC_USD,HOUR,77889.99,2.092,17/08/2021 13:00:00,17/08/2021 15:00:00,17/08/2021 14:00:00,STOP_LOSS_HIT,LONG,46696.0,45951.26,48930.24,45951.26,1.254,4.57,1.62,4674.03,2,3.0,-1558.0
22/03/2018 19:00:00,15/06/2023 18:58:17,Gemini_BTCUSD_1h_17_12_17_to_10_03_23.csv,BTC_USD,HOUR,76331.99,11.015,22/03/2018 20:00:00,22/03/2018 22:00:00,22/03/2018 22:00:00,EXPIRED,LONG,8607.0,8702.0,9022.81,8468.4,1.242,4.61,1.64,4580.15,2,3.0,1046.43
23/03/2021 19:00:00,15/06/2023 18:58:17,Gemini_BTCUSD_1h_17_12_17_to_10_03_23.csv,BTC_USD,HOUR,77378.42,3.228,23/03/2021 20:00:00,23/03/2021 22:00:00,23/03/2021 20:00:00,STOP_LOSS_HIT,LONG,55019.0,54539.58,56457.28,54539.58,2.295,2.55,0.88,4642.77,2,3.0,-1547.57
26/06/2021 21:00:00,15/06/2023 18:58:17,Gemini_BTCUSD_1h_17_12_17_to_10_03_23.csv,BTC_USD,HOUR,75830.85,5.963,26/06/2021 22:00:00,27/06/2021 00:00:00,26/06/2021 23:00:00,TAKE_PROFIT_HIT,LONG,31435.0,32198.03,32198.03,31180.66,2.472,2.37,0.82,4549.95,2,3.0,4549.95
22/08/2018 00:00:00,15/06/2023 18:58:17,Gemini_BTCUSD_1h_17_12_17_to_10_03_23.csv,BTC_USD,HOUR,80380.8,21.884,22/08/2018 01:00:00,22/08/2018 03:00:00,22/08/2018 01:00:00,TAKE_PROFIT_HIT,LONG,6466.0,6686.38,6686.38,6392.54,1.76,3.3,1.15,4822.8,2,3.0,4822.8
08/05/2021 04:00:00,15/06/2023 18:58:17,Gemini_BTCUSD_1h_17_12_17_to_10_03_23.csv,BTC_USD,HOUR,85203.6,5.462,08/05/2021 05:00:00,08/05/2021 07:00:00,08/05/2021 06:00:00,STOP_LOSS_HIT,LONG,58147.0,57835.01,59082.99,57835.01,3.728,1.58,0.54,5112.38,2,3.0,-1704.09
06/09/2020 12:00:00,15/06/2023 18:58:17,Gemini_BTCUSD_1h_17_12_17_to_10_03_23.csv,BTC_USD,HOUR,83499.51,28.993,06/09/2020 13:00:00,06/09/2020 15:00:00,06/09/2020 14:00:00,STOP_LOSS_HIT,LONG,10254.0,10196.4,10426.81,10196.4,3.56,1.66,0.56,5010.28,2,3.0,-1670.0
07/05/2018 21:00:00,15/06/2023 18:58:17,Gemini_BTCUSD_1h_17_12_17_to_10_03_23.csv,BTC_USD,HOUR,81829.51,33.71,07/05/2018 23:00:00,08/05/2018 00:00:00,07/05/2018 22:00:00,STOP_LOSS_HIT,LONG,9387.0,9338.45,9532.64,9338.45,3.867,1.53,0.52,4909.52,2,3.0,-1636.62
25/11/2022 21:00:00,15/06/2023 18:58:17,Gemini_BTCUSD_1h_17_12_17_to_10_03_23.csv,BTC_USD,HOUR,80192.89,8.059,26/11/2022 01:00:00,26/11/2022 00:00:00,26/11/2022 00:00:00,EXPIRED,LONG,16504.0,16561.0,17101.07,16304.98,1.659,3.49,1.22,4811.79,2,3.0,459.36
04/02/2020 16:00:00,15/06/2023 18:58:17,Gemini_BTCUSD_1h_17_12_17_to_10_03_23.csv,BTC_USD,HOUR,80652.25,21.545,04/02/2020 19:00:00,04/02/2020 19:00:00,04/02/2020 19:00:00,EXPIRED,LONG,9202.0,9154.0,9426.62,9127.13,2.458,2.38,0.82,4839.44,2,3.0,-1034.16
02/11/2019 12:00:00,15/06/2023 18:58:17,Gemini_BTCUSD_1h_17_12_17_to_10_03_23.csv,BTC_USD,HOUR,79618.09,12.183,02/11/2019 13:00:00,02/11/2019 15:00:00,02/11/2019 15:00:00,EXPIRED,LONG,9333.0,9336.0,9725.1,9202.3,1.428,4.03,1.42,4776.95,2,3.0,36.55
02/03/2019 12:00:00,15/06/2023 18:58:17,Gemini_BTCUSD_1h_17_12_17_to_10_03_23.csv,BTC_USD,HOUR,79654.64,78.827,02/03/2019 14:00:00,02/03/2019 15:00:00,02/03/2019 15:00:00,EXPIRED,LONG,3812.0,3801.0,3872.62,3791.79,3.772,1.57,0.53,4778.49,2,3.0,-867.1
26/03/2019 04:00:00,15/06/2023 18:58:17,Gemini_BTCUSD_1h_17_12_17_to_10_03_23.csv,BTC_USD,HOUR,78787.54,70.98,26/03/2019 07:00:00,26/03/2019 07:00:00,26/03/2019 07:00:00,EXPIRED,SHORT,3913.0,3894.0,3846.4,3935.2,3.525,1.73,0.56,4727.27,2,3.0,1348.62
10/05/2020 21:00:00,15/06/2023 18:58:17,Gemini_BTCUSD_1h_17_12_17_to_10_03_23.csv,BTC_USD,HOUR,80136.16,21.744,10/05/2020 22:00:00,11/05/2020 00:00:00,10/05/2020 23:00:00,STOP_LOSS_HIT,LONG,8722.0,8648.29,8943.14,8648.29,2.367,2.47,0.85,4808.47,2,3.0,-1602.75
27/07/2022 03:00:00,15/06/2023 18:58:17,Gemini_BTCUSD_1h_17_12_17_to_10_03_23.csv,BTC_USD,HOUR,78533.41,7.989,27/07/2022 05:00:00,27/07/2022 06:00:00,27/07/2022 06:00:00,EXPIRED,LONG,21077.0,21253.0,21666.82,20880.39,2.144,2.72,0.94,4712.07,2,3.0,1406.06
24/09/2020 19:00:00,15/06/2023 18:58:17,Gemini_BTCUSD_1h_17_12_17_to_10_03_23.csv,BTC_USD,HOUR,79939.47,24.753,24/09/2020 20:00:00,24/09/2020 22:00:00,24/09/2020 22:00:00,EXPIRED,LONG,10658.0,10769.0,10851.78,10593.41,3.3,1.79,0.61,4796.64,2,3.0,2747.58
07/04/2019 16:00:00,15/06/2023 18:58:17,Gemini_BTCUSD_1h_17_12_17_to_10_03_23.csv,BTC_USD,HOUR,82687.05,31.315,07/04/2019 17:00:00,07/04/2019 19:00:00,07/04/2019 19:00:00,EXPIRED,LONG,5117.0,5128.0,5275.44,5064.19,1.938,3.0,1.04,4961.55,2,3.0,344.47
28/01/2023 18:00:00,15/06/2023 18:58:17,Gemini_BTCUSD_1h_17_12_17_to_10_03_23.csv,BTC_USD,HOUR,83031.52,5.03,28/01/2023 20:00:00,28/01/2023 21:00:00,28/01/2023 21:00:00,EXPIRED,LONG,23007.0,23021.0,23997.52,22676.83,1.394,4.13,1.46,4982.32,2,3.0,70.42
15/05/2019 10:00:00,15/06/2023 18:58:17,Gemini_BTCUSD_1h_17_12_17_to_10_03_23.csv,BTC_USD,HOUR,83101.94,14.75,15/05/2019 11:00:00,15/05/2019 13:00:00,15/05/2019 13:00:00,EXPIRED,SHORT,8055.0,7989.0,7716.96,8167.68,1.43,4.38,1.38,4986.09,2,3.0,973.5
17/02/2023 16:00:00,15/06/2023 18:58:17,Gemini_BTCUSD_1h_17_12_17_to_10_03_23.csv,BTC_USD,HOUR,84075.44,4.001,17/02/2023 17:00:00,17/02/2023 19:00:00,17/02/2023 19:00:00,EXPIRED,LONG,24084.0,24538.0,25344.92,23663.69,1.146,4.98,1.78,5044.94,2,3.0,1816.45
15/12/2020 21:00:00,15/06/2023 18:58:17,Gemini_BTCUSD_1h_17_12_17_to_10_03_23.csv,BTC_USD,HOUR,85891.89,16.192,15/12/2020 22:00:00,16/12/2020 00:00:00,16/12/2020 00:00:00,STOP_LOSS_HIT,LONG,19436.0,19329.91,19754.28,19329.91,3.664,1.61,0.55,5153.59,2,3.0,-1717.81
15/11/2021 12:00:00,15/06/2023 18:58:17,Gemini_BTCUSD_1h_17_12_17_to_10_03_23.csv,BTC_USD,HOUR,84174.08,1.586,15/11/2021 13:00:00,15/11/2021 15:00:00,15/11/2021 15:00:00,STOP_LOSS_HIT,LONG,65694.0,64632.31,68879.09,64632.31,1.238,4.62,1.64,5051.55,2,3.0,-1683.84
17/05/2022 13:00:00,15/06/2023 18:58:17,Gemini_BTCUSD_1h_17_12_17_to_10_03_23.csv,BTC_USD,HOUR,82490.24,5.02,17/05/2022 17:00:00,17/05/2022 16:00:00,17/05/2022 16:00:00,EXPIRED,SHORT,30481.0,30118.0,29495.06,30809.65,1.855,3.34,1.07,4949.42,2,3.0,1822.26
14/07/2020 12:00:00,15/06/2023 18:58:17,Gemini_BTCUSD_1h_17_12_17_to_10_03_23.csv,BTC_USD,HOUR,84312.5,33.142,14/07/2020 13:00:00,14/07/2020 15:00:00,14/07/2020 15:00:00,EXPIRED,LONG,9210.0,9223.0,9362.65,9159.12,3.62,1.63,0.56,5059.13,2,3.0,430.85
14/01/2018 17:00:00,15/06/2023 18:58:17,Gemini_BTCUSD_1h_17_12_17_to_10_03_23.csv,BTC_USD,HOUR,84743.35,25.124,14/01/2018 19:00:00,14/01/2018 20:00:00,14/01/2018 18:00:00,STOP_LOSS_HIT,SHORT,13490.0,13557.46,13287.61,13557.46,3.999,1.52,0.5,5084.85,2,3.0,-1694.87
10/05/2018 13:00:00,15/06/2023 18:58:17,Gemini_BTCUSD_1h_17_12_17_to_10_03_23.csv,BTC_USD,HOUR,83048.48,23.878,10/05/2018 16:00:00,10/05/2018 16:00:00,10/05/2018 16:00:00,EXPIRED,LONG,9360.0,9344.0,9568.69,9290.44,2.691,2.18,0.75,4983.1,2,3.0,-382.05
04/10/2018 10:00:00,15/06/2023 18:58:17,Gemini_BTCUSD_1h_17_12_17_to_10_03_23.csv,BTC_USD,HOUR,82666.43,25.452,04/10/2018 12:00:00,04/10/2018 13:00:00,04/10/2018 13:00:00,EXPIRED,LONG,6526.0,6541.0,6720.89,6461.04,2.009,2.9,1.01,4960.34,2,3.0,381.78
27/10/2018 21:00:00,15/06/2023 18:58:17,Gemini_BTCUSD_1h_17_12_17_to_10_03_23.csv,BTC_USD,HOUR,83048.21,52.646,28/10/2018 00:00:00,28/10/2018 00:00:00,28/10/2018 00:00:00,EXPIRED,LONG,6409.0,6406.0,6503.66,6377.45,4.063,1.46,0.49,4983.47,2,3.0,-157.94
25/10/2018 14:00:00,15/06/2023 18:58:17,Gemini_BTCUSD_1h_17_12_17_to_10_03_23.csv,BTC_USD,HOUR,82890.27,28.499,25/10/2018 15:00:00,25/10/2018 17:00:00,25/10/2018 17:00:00,EXPIRED,LONG,6392.0,6392.0,6566.53,6333.83,2.198,2.66,0.92,4973.93,2,3.0,0.0
21/04/2018 07:00:00,15/06/2023 18:58:17,Gemini_BTCUSD_1h_17_12_17_to_10_03_23.csv,BTC_USD,HOUR,82890.27,10.344,21/04/2018 08:00:00,21/04/2018 10:00:00,21/04/2018 09:00:00,STOP_LOSS_HIT,LONG,8879.0,8718.73,9359.81,8718.73,1.108,5.14,1.84,4973.5,2,3.0,-1657.83
06/07/2019 17:00:00,15/06/2023 18:58:17,Gemini_BTCUSD_1h_17_12_17_to_10_03_23.csv,BTC_USD,HOUR,81232.44,25.817,06/07/2019 19:00:00,06/07/2019 20:00:00,06/07/2019 18:00:00,STOP_LOSS_HIT,LONG,11589.0,11526.07,11777.8,11526.07,3.683,1.6,0.55,4874.25,2,3.0,-1624.66
19/09/2022 14:00:00,15/06/2023 18:58:17,Gemini_BTCUSD_1h_17_12_17_to_10_03_23.csv,BTC_USD,HOUR,79607.78,5.181,19/09/2022 15:00:00,19/09/2022 17:00:00,19/09/2022 17:00:00,STOP_LOSS_HIT,LONG,19312.0,19004.71,20233.88,19004.71,1.257,4.56,1.62,4776.26,2,3.0,-1592.07
31/07/2020 11:00:00,15/06/2023 18:58:17,Gemini_BTCUSD_1h_17_12_17_to_10_03_23.csv,BTC_USD,HOUR,78015.71,1019.631,31/07/2020 13:00:00,31/07/2020 14:00:00,31/07/2020 12:00:00,STOP_LOSS_HIT,SHORT,11230.0,11231.53,11225.43,11231.53,146.771,0.04,0.01,4659.71,2,3.0,-1560.04
30/10/2018 03:00:00,15/06/2023 18:58:17,Gemini_BTCUSD_1h_17_12_17_to_10_03_23.csv,BTC_USD,HOUR,76455.67,813.409,30/10/2018 05:00:00,30/10/2018 06:00:00,30/10/2018 04:00:00,STOP_LOSS_HIT,LONG,6271.0,6269.12,6276.63,6269.12,66.717,0.09,0.03,4579.49,2,3.0,-1529.21
01/11/2020 18:00:00,15/06/2023 18:58:17,Gemini_BTCUSD_1h_17_12_17_to_10_03_23.csv,BTC_USD,HOUR,74926.46,10.514,01/11/2020 22:00:00,01/11/2020 21:00:00,01/11/2020 21:00:00,EXPIRED,LONG,13809.0,13819.0,14236.59,13666.47,1.938,3.0,1.04,4495.68,2,3.0,105.14
16/01/2019 13:00:00,15/06/2023 18:58:17,Gemini_BTCUSD_1h_17_12_17_to_10_03_23.csv,BTC_USD,HOUR,75031.6,88.221,16/01/2019 17:00:00,16/01/2019 16:00:00,16/01/2019 16:00:00,STOP_LOSS_HIT,LONG,3614.0,3596.99,3665.04,3596.99,4.249,1.39,0.47,4502.8,2,3.0,-1500.64
17/12/2018 08:00:00,15/06/2023 18:58:17,Gemini_BTCUSD_1h_17_12_17_to_10_03_23.csv,BTC_USD,HOUR,73530.96,30.837,17/12/2018 09:00:00,17/12/2018 11:00:00,17/12/2018 11:00:00,EXPIRED,LONG,3242.0,3240.0,3385.08,3194.31,1.36,4.23,1.49,4412.16,2,3.0,-61.67
30/06/2020 16:00:00,15/06/2023 18:58:17,Gemini_BTCUSD_1h_17_12_17_to_10_03_23.csv,BTC_USD,HOUR,73469.29,10.19,30/06/2020 17:00:00,30/06/2020 19:00:00,30/06/2020 19:00:00,EXPIRED,LONG,9176.0,9144.0,9608.59,9031.8,1.273,4.5,1.6,4408.09,2,3.0,-326.08
12/11/2022 11:00:00,15/06/2023 18:58:17,Gemini_BTCUSD_1h_17_12_17_to_10_03_23.csv,BTC_USD,HOUR,73143.21,8.173,12/11/2022 12:00:00,12/11/2022 14:00:00,12/11/2022 14:00:00,EXPIRED,LONG,16837.0,16878.0,17373.94,16658.02,1.881,3.09,1.07,4388.41,2,3.0,335.09
30/12/2020 20:00:00,15/06/2023 18:58:17,Gemini_BTCUSD_1h_17_12_17_to_10_03_23.csv,BTC_USD,HOUR,73478.3,9.877,30/12/2020 22:00:00,30/12/2020 23:00:00,30/12/2020 21:00:00,STOP_LOSS_HIT,LONG,28784.0,28635.21,29230.37,28635.21,3.869,1.53,0.52,4408.8,2,3.0,-1469.6
14/07/2021 14:00:00,15/06/2023 18:58:17,Gemini_BTCUSD_1h_17_12_17_to_10_03_23.csv,BTC_USD,HOUR,72008.7,4.974,14/07/2021 15:00:00,14/07/2021 17:00:00,14/07/2021 17:00:00,EXPIRED,LONG,32869.0,32853.0,33737.69,32579.44,2.27,2.57,0.89,4320.86,2,3.0,-79.58
27/05/2020 20:00:00,15/06/2023 18:58:17,Gemini_BTCUSD_1h_17_12_17_to_10_03_23.csv,BTC_USD,HOUR,71929.12,10.874,27/05/2020 21:00:00,27/05/2020 23:00:00,27/05/2020 23:00:00,EXPIRED,LONG,9167.0,9210.0,9563.89,9034.7,1.386,4.15,1.46,4315.78,2,3.0,467.58
30/10/2018 04:00:00,15/06/2023 18:58:17,Gemini_BTCUSD_1h_17_12_17_to_10_03_23.csv,BTC_USD,HOUR,72396.7,43.903,30/10/2018 06:00:00,30/10/2018 07:00:00,30/10/2018 07:00:00,EXPIRED,LONG,6287.0,6267.0,6385.95,6254.02,3.813,1.55,0.53,4344.2,2,3.0,-878.06
23/06/2018 06:00:00,15/06/2023 18:58:17,Gemini_BTCUSD_1h_17_12_17_to_10_03_23.csv,BTC_USD,HOUR,71518.64,29.639,23/06/2018 07:00:00,23/06/2018 09:00:00,23/06/2018 09:00:00,EXPIRED,LONG,6057.0,6131.0,6201.77,6008.74,2.51,2.33,0.8,4290.84,2,3.0,2193.29
13/11/2019 09:00:00,15/06/2023 18:58:17,Gemini_BTCUSD_1h_17_12_17_to_10_03_23.csv,BTC_USD,HOUR,73711.93,20.346,13/11/2019 12:00:00,13/11/2019 12:00:00,13/11/2019 12:00:00,EXPIRED,LONG,8766.0,8738.0,8983.38,8693.54,2.42,2.42,0.83,4422.81,2,3.0,-569.69
11/08/2018 21:00:00,15/06/2023 18:58:17,Gemini_BTCUSD_1h_17_12_17_to_10_03_23.csv,BTC_USD,HOUR,73142.24,19.463,12/08/2018 01:00:00,12/08/2018 00:00:00,12/08/2018 00:00:00,EXPIRED,SHORT,6385.0,6285.0,6159.53,6460.16,1.699,3.66,1.16,4388.32,2,3.0,1946.3
08/03/2021 03:00:00,15/06/2023 18:58:17,Gemini_BTCUSD_1h_17_12_17_to_10_03_23.csv,BTC_USD,HOUR,75088.54,3.347,08/03/2021 04:00:00,08/03/2021 06:00:00,08/03/2021 06:00:00,EXPIRED,LONG,50591.0,50341.0,51937.2,50142.27,2.255,2.59,0.89,4505.73,2,3.0,-836.75
02/08/2021 15:00:00,15/06/2023 18:58:17,Gemini_BTCUSD_1h_17_12_17_to_10_03_23.csv,BTC_USD,HOUR,74251.79,7.108,02/08/2021 19:00:00,02/08/2021 18:00:00,02/08/2021 16:00:00,STOP_LOSS_HIT,SHORT,39708.0,39916.93,39081.22,39916.93,3.801,1.6,0.52,4455.15,2,3.0,-1485.07
16/11/2020 01:00:00,15/06/2023 18:58:17,Gemini_BTCUSD_1h_17_12_17_to_10_03_23.csv,BTC_USD,HOUR,72766.72,4.942,16/11/2020 02:00:00,16/11/2020 04:00:00,16/11/2020 04:00:00,EXPIRED,LONG,15969.0,16048.0,16852.44,15674.52,1.085,5.24,1.88,4365.96,2,3.0,390.42
06/10/2018 22:00:00,15/06/2023 18:58:17,Gemini_BTCUSD_1h_17_12_17_to_10_03_23.csv,BTC_USD,HOUR,73157.14,21.202,07/10/2018 00:00:00,07/10/2018 01:00:00,07/10/2018 01:00:00,EXPIRED,LONG,6552.0,6556.0,6759.03,6482.99,1.899,3.06,1.06,4389.45,2,3.0,84.81
31/01/2021 20:00:00,15/06/2023 18:58:17,Gemini_BTCUSD_1h_17_12_17_to_10_03_23.csv,BTC_USD,HOUR,73241.95,4.993,31/01/2021 22:00:00,31/01/2021 23:00:00,31/01/2021 23:00:00,STOP_LOSS_HIT,SHORT,32924.0,33217.35,32043.97,33217.35,2.244,2.75,0.88,4393.99,2,3.0,-1464.7
29/06/2021 03:00:00,15/06/2023 18:58:17,Gemini_BTCUSD_1h_17_12_17_to_10_03_23.csv,BTC_USD,HOUR,71777.25,2.449,29/06/2021 04:00:00,29/06/2021 06:00:00,29/06/2021 06:00:00,EXPIRED,LONG,34592.0,35312.0,36350.41,34005.86,1.18,4.84,1.72,4306.35,2,3.0,1763.28
26/07/2022 07:00:00,15/06/2023 18:58:17,Gemini_BTCUSD_1h_17_12_17_to_10_03_23.csv,BTC_USD,HOUR,73540.53,10.477,26/07/2022 11:00:00,26/07/2022 10:00:00,26/07/2022 10:00:00,EXPIRED,SHORT,21063.0,21074.0,20641.85,21203.38,3.001,2.04,0.66,4412.39,2,3.0,-115.25
19/11/2022 11:00:00,15/06/2023 18:58:17,Gemini_BTCUSD_1h_17_12_17_to_10_03_23.csv,BTC_USD,HOUR,73425.28,5.458,19/11/2022 12:00:00,19/11/2022 14:00:00,19/11/2022 14:00:00,EXPIRED,LONG,16650.0,16629.0,17457.14,16380.95,1.238,4.62,1.64,4405.37,2,3.0,-114.62
16/12/2020 12:00:00,15/06/2023 18:58:17,Gemini_BTCUSD_1h_17_12_17_to_10_03_23.csv,BTC_USD,HOUR,73310.66,9.066,16/12/2020 13:00:00,16/12/2020 15:00:00,16/12/2020 13:00:00,TAKE_PROFIT_HIT,LONG,19780.0,20265.17,20265.17,19618.28,2.446,2.39,0.82,4398.55,2,3.0,4398.55
13/09/2021 02:00:00,15/06/2023 18:58:17,Gemini_BTCUSD_1h_17_12_17_to_10_03_23.csv,BTC_USD,HOUR,77709.21,4.401,13/09/2021 03:00:00,13/09/2021 05:00:00,13/09/2021 03:00:00,STOP_LOSS_HIT,LONG,44955.0,44601.87,46014.4,44601.87,2.546,2.3,0.79,4662.42,2,3.0,-1554.13
19/10/2018 15:00:00,15/06/2023 18:58:17,Gemini_BTCUSD_1h_17_12_17_to_10_03_23.csv,BTC_USD,HOUR,76155.08,47.881,19/10/2018 16:00:00,19/10/2018 18:00:00,19/10/2018 18:00:00,EXPIRED,LONG,6381.0,6394.0,6476.43,6349.19,4.012,1.47,0.5,4569.28,2,3.0,622.45
20/08/2021 06:00:00,15/06/2023 18:58:17,Gemini_BTCUSD_1h_17_12_17_to_10_03_23.csv,BTC_USD,HOUR,76777.53,2.907,20/08/2021 08:00:00,20/08/2021 09:00:00,20/08/2021 09:00:00,EXPIRED,LONG,47160.0,47183.0,48744.68,46631.78,1.786,3.25,1.13,4606.66,2,3.0,66.86
12/09/2020 18:00:00,15/06/2023 18:58:17,Gemini_BTCUSD_1h_17_12_17_to_10_03_23.csv,BTC_USD,HOUR,76844.39,13.309,12/09/2020 20:00:00,12/09/2020 21:00:00,12/09/2020 21:00:00,EXPIRED,SHORT,10463.0,10456.0,10116.57,10578.48,1.812,3.42,1.09,4610.64,2,3.0,93.16
16/08/2020 15:00:00,15/06/2023 18:58:17,Gemini_BTCUSD_1h_17_12_17_to_10_03_23.csv,BTC_USD,HOUR,76937.55,24.305,16/08/2020 16:00:00,16/08/2020 18:00:00,16/08/2020 18:00:00,EXPIRED,LONG,11873.0,11841.0,12062.93,11809.69,3.751,1.57,0.54,4616.25,2,3.0,-777.76
28/08/2018 13:00:00,15/06/2023 18:58:17,Gemini_BTCUSD_1h_17_12_17_to_10_03_23.csv,BTC_USD,HOUR,76159.79,37.508,28/08/2018 15:00:00,28/08/2018 16:00:00,28/08/2018 14:00:00,STOP_LOSS_HIT,LONG,7076.0,7035.39,7197.85,7035.39,3.485,1.69,0.58,4570.35,2,3.0,-1523.2
03/04/2018 11:00:00,15/06/2023 18:58:17,Gemini_BTCUSD_1h_17_12_17_to_10_03_23.csv,BTC_USD,HOUR,74636.59,37.225,03/04/2018 14:00:00,03/04/2018 14:00:00,03/04/2018 13:00:00,TAKE_PROFIT_HIT,LONG,7302.0,7422.3,7422.3,7261.9,3.642,1.62,0.55,4478.17,2,3.0,4478.17
02/10/2018 07:00:00,15/06/2023 18:58:17,Gemini_BTCUSD_1h_17_12_17_to_10_03_23.csv,BTC_USD,HOUR,79114.76,44.559,02/10/2018 10:00:00,02/10/2018 10:00:00,02/10/2018 10:00:00,EXPIRED,LONG,6560.0,6552.0,6666.53,6524.49,3.695,1.6,0.54,4746.87,2,3.0,-356.47
17/03/2022 22:00:00,15/06/2023 18:58:17,Gemini_BTCUSD_1h_17_12_17_to_10_03_23.csv,BTC_USD,HOUR,78758.29,7.496,17/03/2022 23:00:00,18/03/2022 01:00:00,18/03/2022 00:00:00,TAKE_PROFIT_HIT,SHORT,41018.0,40387.59,40387.59,41228.14,3.904,1.56,0.51,4725.55,2,3.0,4725.55
20/01/2020 00:00:00,15/06/2023 18:58:17,Gemini_BTCUSD_1h_17_12_17_to_10_03_23.csv,BTC_USD,HOUR,83483.84,35.647,20/01/2020 04:00:00,20/01/2020 03:00:00,20/01/2020 03:00:00,EXPIRED,SHORT,8659.0,8648.0,8518.49,8705.84,3.697,1.65,0.54,5008.76,2,3.0,392.12
04/11/2019 13:00:00,15/06/2023 18:58:17,Gemini_BTCUSD_1h_17_12_17_to_10_03_23.csv,BTC_USD,HOUR,83875.96,23.17,04/11/2019 15:00:00,04/11/2019 16:00:00,04/11/2019 16:00:00,EXPIRED,LONG,9252.0,9307.0,9469.19,9179.6,2.556,2.29,0.79,5032.29,2,3.0,1274.35
27/04/2019 17:00:00,15/06/2023 18:58:17,Gemini_BTCUSD_1h_17_12_17_to_10_03_23.csv,BTC_USD,HOUR,85150.31,17.225,27/04/2019 19:00:00,27/04/2019 20:00:00,27/04/2019 20:00:00,EXPIRED,LONG,5182.0,5204.0,5478.61,5083.13,1.048,5.41,1.95,5109.11,2,3.0,378.95
06/06/2018 15:00:00,15/06/2023 18:58:17,Gemini_BTCUSD_1h_17_12_17_to_10_03_23.csv,BTC_USD,HOUR,85529.26,16.284,06/06/2018 16:00:00,06/06/2018 18:00:00,06/06/2018 16:00:00,STOP_LOSS_HIT,LONG,7655.0,7549.95,7970.17,7549.95,1.457,3.95,1.39,5132.23,2,3.0,-1710.63
10/04/2022 21:00:00,15/06/2023 18:58:17,Gemini_BTCUSD_1h_17_12_17_to_10_03_23.csv,BTC_USD,HOUR,83818.63,7.545,10/04/2022 22:00:00,11/04/2022 00:00:00,10/04/2022 22:00:00,STOP_LOSS_HIT,LONG,42727.0,42504.82,43393.55,42504.82,3.846,1.54,0.52,5029.12,2,3.0,-1676.35
05/12/2019 23:00:00,15/06/2023 18:58:17,Gemini_BTCUSD_1h_17_12_17_to_10_03_23.csv,BTC_USD,HOUR,82142.28,26.114,06/12/2019 03:00:00,06/12/2019 02:00:00,06/12/2019 02:00:00,EXPIRED,LONG,7393.0,7373.0,7581.74,7330.09,2.35,2.49,0.86,4928.76,2,3.0,-522.28
10/12/2018 18:00:00,15/06/2023 18:58:17,Gemini_BTCUSD_1h_17_12_17_to_10_03_23.csv,BTC_USD,HOUR,81620.0,33.987,10/12/2018 20:00:00,10/12/2018 21:00:00,10/12/2018 21:00:00,EXPIRED,LONG,3403.0,3402.0,3547.1,3354.97,1.417,4.06,1.43,4897.53,2,3.0,-33.99
19/07/2020 18:00:00,15/06/2023 18:58:17,Gemini_BTCUSD_1h_17_12_17_to_10_03_23.csv,BTC_USD,HOUR,81586.01,9.656,19/07/2020 19:00:00,19/07/2020 21:00:00,19/07/2020 21:00:00,EXPIRED,LONG,9165.0,9181.0,9671.95,8996.02,1.085,5.24,1.88,4895.11,2,3.0,154.5
06/03/2020 10:00:00,15/06/2023 18:58:17,Gemini_BTCUSD_1h_17_12_17_to_10_03_23.csv,BTC_USD,HOUR,81740.51,14.125,06/03/2020 11:00:00,06/03/2020 13:00:00,06/03/2020 13:00:00,EXPIRED,LONG,9156.0,9068.0,9503.23,9040.26,1.582,3.65,1.28,4904.62,2,3.0,-1243.0
09/05/2020 00:00:00,15/06/2023 18:58:17,Gemini_BTCUSD_1h_17_12_17_to_10_03_23.csv,BTC_USD,HOUR,80497.51,19.346,09/05/2020 02:00:00,09/05/2020 03:00:00,09/05/2020 03:00:00,EXPIRED,LONG,9887.0,9874.0,10136.66,9803.78,2.376,2.46,0.85,4829.92,2,3.0,-251.5
17/10/2021 15:00:00,15/06/2023 18:58:17,Gemini_BTCUSD_1h_17_12_17_to_10_03_23.csv,BTC_USD,HOUR,80246.01,2.864,17/10/2021 18:00:00,17/10/2021 18:00:00,17/10/2021 18:00:00,EXPIRED,LONG,60759.0,60984.0,62440.23,60198.6,2.169,2.69,0.93,4815.04,2,3.0,644.4
26/09/2019 02:00:00,15/06/2023 18:58:17,Gemini_BTCUSD_1h_17_12_17_to_10_03_23.csv,BTC_USD,HOUR,80890.41,37.959,26/09/2019 04:00:00,26/09/2019 05:00:00,26/09/2019 05:00:00,EXPIRED,LONG,8370.0,8394.0,8497.87,8327.38,3.928,1.5,0.51,4853.82,2,3.0,911.02
17/01/2018 22:00:00,15/06/2023 18:58:17,Gemini_BTCUSD_1h_17_12_17_to_10_03_23.csv,BTC_USD,HOUR,81801.43,25.463,17/01/2018 23:00:00,18/01/2018 01:00:00,17/01/2018 23:00:00,STOP_LOSS_HIT,LONG,11168.0,11103.75,11360.75,11103.75,3.476,1.7,0.58,4907.99,2,3.0,-1636.0
09/06/2018 00:00:00,15/06/2023 18:58:17,Gemini_BTCUSD_1h_17_12_17_to_10_03_23.csv,BTC_USD,HOUR,80165.43,32.377,09/06/2018 01:00:00,09/06/2018 03:00:00,09/06/2018 03:00:00,EXPIRED,LONG,7640.0,7665.0,7788.56,7590.48,3.086,1.91,0.65,4809.93,2,3.0,809.43
14/01/2022 23:00:00,15/06/2023 18:58:17,Gemini_BTCUSD_1h_17_12_17_to_10_03_23.csv,BTC_USD,HOUR,80974.86,1.9,15/01/2022 00:00:00,15/01/2022 02:00:00,15/01/2022 02:00:00,EXPIRED,LONG,43084.0,43119.0,45641.14,42231.62,1.011,5.6,2.02,4858.57,2,3.0,66.5
02/10/2021 20:00:00,15/06/2023 18:58:17,Gemini_BTCUSD_1h_17_12_17_to_10_03_23.csv,BTC_USD,HOUR,81041.36,63.368,02/10/2021 21:00:00,02/10/2021 23:00:00,02/10/2021 21:00:00,STOP_LOSS_HIT,SHORT,48014.0,48039.58,47937.27,48039.58,37.543,0.16,0.05,4862.23,2,3.0,-1620.95
05/12/2020 06:00:00,15/06/2023 18:58:17,Gemini_BTCUSD_1h_17_12_17_to_10_03_23.csv,BTC_USD,HOUR,79420.41,5.22,05/12/2020 07:00:00,05/12/2020 09:00:00,05/12/2020 09:00:00,EXPIRED,LONG,18985.0,19128.0,19897.87,18680.71,1.248,4.59,1.63,4765.18,2,3.0,746.46
04/04/2020 16:00:00,15/06/2023 18:58:17,Gemini_BTCUSD_1h_17_12_17_to_10_03_23.csv,BTC_USD,HOUR,80166.87,48.062,04/04/2020 18:00:00,04/04/2020 19:00:00,04/04/2020 19:00:00,EXPIRED,SHORT,6798.0,6758.0,6697.91,6831.36,4.076,1.49,0.49,4810.53,2,3.0,1922.48
09/08/2021 11:00:00,15/06/2023 18:58:17,Gemini_BTCUSD_1h_17_12_17_to_10_03_23.csv,BTC_USD,HOUR,82089.35,2.939,09/08/2021 12:00:00,09/08/2021 14:00:00,09/08/2021 13:00:00,STOP_LOSS_HIT,LONG,45992.0,45433.43,47667.71,45433.43,1.647,3.52,1.23,4924.91,2,3.0,-1641.64
05/08/2018 00:00:00,15/06/2023 18:58:17,Gemini_BTCUSD_1h_17_12_17_to_10_03_23.csv,BTC_USD,HOUR,80447.71,11.93,05/08/2018 01:00:00,05/08/2018 03:00:00,05/08/2018 03:00:00,EXPIRED,LONG,6923.0,7000.0,7327.6,6788.13,1.027,5.52,1.99,4826.88,2,3.0,918.61
11/03/2021 18:00:00,15/06/2023 18:58:17,Gemini_BTCUSD_1h_17_12_17_to_10_03_23.csv,BTC_USD,HOUR,81366.32,4.272,11/03/2021 19:00:00,11/03/2021 21:00:00,11/03/2021 19:00:00,STOP_LOSS_HIT,LONG,57536.0,57155.07,58678.79,57155.07,3.021,1.95,0.67,4882.0,2,3.0,-1627.33
25/02/2018 02:00:00,15/06/2023 18:58:17,Gemini_BTCUSD_1h_17_12_17_to_10_03_23.csv,BTC_USD,HOUR,79738.99,12.327,25/02/2018 03:00:00,25/02/2018 05:00:00,25/02/2018 05:00:00,EXPIRED,LONG,9612.0,9735.0,10000.11,9482.63,1.486,3.88,1.36,4784.23,2,3.0,1516.22
25/12/2017 12:00:00,15/06/2023 18:58:17,Gemini_BTCUSD_1h_17_12_17_to_10_03_23.csv,BTC_USD,HOUR,81255.21,19.639,25/12/2017 14:00:00,25/12/2017 15:00:00,25/12/2017 13:00:00,STOP_LOSS_HIT,LONG,14560.0,14477.25,14808.26,14477.25,3.519,1.68,0.57,4875.58,2,3.0,-1625.13
29/06/2020 16:00:00,15/06/2023 18:58:17,Gemini_BTCUSD_1h_17_12_17_to_10_03_23.csv,BTC_USD,HOUR,79630.08,12.781,29/06/2020 18:00:00,29/06/2020 19:00:00,29/06/2020 19:00:00,EXPIRED,LONG,9115.0,9157.0,9488.84,8990.39,1.463,3.94,1.39,4778.05,2,3.0,536.8
09/06/2021 16:00:00,15/06/2023 18:58:17,Gemini_BTCUSD_1h_17_12_17_to_10_03_23.csv,BTC_USD,HOUR,80166.88,5.722,09/06/2021 17:00:00,09/06/2021 19:00:00,09/06/2021 17:00:00,STOP_LOSS_HIT,SHORT,36541.0,36821.2,35700.42,36821.2,2.608,2.35,0.76,4809.8,2,3.0,-1603.3
01/03/2018 12:00:00,15/06/2023 18:58:17,Gemini_BTCUSD_1h_17_12_17_to_10_03_23.csv,BTC_USD,HOUR,78563.58,24.555,01/03/2018 14:00:00,01/03/2018 15:00:00,01/03/2018 15:00:00,EXPIRED,LONG,10629.0,10705.0,10820.97,10565.01,3.322,1.77,0.61,4713.82,2,3.0,1866.18
25/11/2018 17:00:00,15/06/2023 18:58:17,Gemini_BTCUSD_1h_17_12_17_to_10_03_23.csv,BTC_USD,HOUR,80429.76,63.859,25/11/2018 21:00:00,25/11/2018 20:00:00,25/11/2018 19:00:00,TAKE_PROFIT_HIT,LONG,3678.0,3753.56,3753.56,3652.81,2.92,2.01,0.69,4825.19,2,3.0,4825.19
10/11/2022 20:00:00,15/06/2023 18:58:17,Gemini_BTCUSD_1h_17_12_17_to_10_03_23.csv,BTC_USD,HOUR,85254.95,16.787,10/11/2022 23:00:00,10/11/2022 23:00:00,10/11/2022 21:00:00,STOP_LOSS_HIT,LONG,18086.0,17984.43,18390.71,17984.43,3.561,1.66,0.56,5115.17,2,3.0,-1705.06
07/07/2022 00:00:00,15/06/2023 18:58:17,Gemini_BTCUSD_1h_17_12_17_to_10_03_23.csv,BTC_USD,HOUR,83549.89,4.937,07/07/2022 01:00:00,07/07/2022 03:00:00,07/07/2022 03:00:00,EXPIRED,LONG,20517.0,20461.0,21532.42,20178.53,1.212,4.72,1.68,5013.13,2,3.0,-276.47
23/03/2022 13:00:00,15/06/2023 18:58:17,Gemini_BTCUSD_1h_17_12_17_to_10_03_23.csv,BTC_USD,HOUR,83273.42,6.761,23/03/2022 14:00:00,23/03/2022 16:00:00,23/03/2022 16:00:00,TAKE_PROFIT_HIT,LONG,42035.0,42774.0,42774.0,41788.67,3.413,1.73,0.59,4996.38,2,3.0,4996.38
12/11/2020 06:00:00,15/06/2023 18:58:17,Gemini_BTCUSD_1h_17_12_17_to_10_03_23.csv,BTC_USD,HOUR,88269.8,19.546,12/11/2020 07:00:00,12/11/2020 09:00:00,12/11/2020 09:00:00,TAKE_PROFIT_HIT,LONG,15816.0,16086.97,16086.97,15725.68,3.502,1.68,0.57,5296.38,2,3.0,5296.38
23/06/2019 21:00:00,15/06/2023 18:58:17,Gemini_BTCUSD_1h_17_12_17_to_10_03_23.csv,BTC_USD,HOUR,93566.18,9.289,23/06/2019 22:00:00,24/06/2019 00:00:00,24/06/2019 00:00:00,STOP_LOSS_HIT,LONG,10888.0,10686.54,11492.38,10686.54,1.081,5.26,1.89,5614.09,2,3.0,-1871.36
17/07/2019 08:00:00,15/06/2023 18:58:17,Gemini_BTCUSD_1h_17_12_17_to_10_03_23.csv,BTC_USD,HOUR,91694.82,23.545,17/07/2019 12:00:00,17/07/2019 11:00:00,17/07/2019 10:00:00,TAKE_PROFIT_HIT,SHORT,9526.0,9292.32,9292.32,9603.89,2.446,2.51,0.81,5502.0,2,3.0,5502.0
19/10/2021 15:00:00,15/06/2023 18:58:17,Gemini_BTCUSD_1h_17_12_17_to_10_03_23.csv,BTC_USD,HOUR,97196.82,3.619,19/10/2021 16:00:00,19/10/2021 18:00:00,19/10/2021 18:00:00,EXPIRED,LONG,62409.0,63450.0,64020.64,61871.79,2.324,2.52,0.87,5832.53,2,3.0,3767.38
11/01/2021 20:00:00,15/06/2023 18:58:17,Gemini_BTCUSD_1h_17_12_17_to_10_03_23.csv,BTC_USD,HOUR,100964.2,7.399,11/01/2021 21:00:00,11/01/2021 23:00:00,11/01/2021 21:00:00,STOP_LOSS_HIT,LONG,33373.0,33100.1,34191.71,33100.1,2.446,2.39,0.82,6057.64,2,3.0,-2019.19
14/01/2023 15:00:00,15/06/2023 18:58:17,Gemini_BTCUSD_1h_17_12_17_to_10_03_23.csv,BTC_USD,HOUR,98945.01,20.021,14/01/2023 16:00:00,14/01/2023 18:00:00,14/01/2023 18:00:00,STOP_LOSS_HIT,LONG,20792.0,20693.16,21088.53,20693.16,4.207,1.41,0.48,5936.83,2,3.0,-1978.88
30/11/2022 19:00:00,15/06/2023 18:58:17,Gemini_BTCUSD_1h_17_12_17_to_10_03_23.csv,BTC_USD,HOUR,96966.13,7.383,30/11/2022 20:00:00,30/11/2022 22:00:00,30/11/2022 22:00:00,EXPIRED,SHORT,17056.0,17165.0,16267.99,17318.67,1.299,4.84,1.52,5817.88,2,3.0,-804.75
09/09/2021 05:00:00,15/06/2023 18:58:17,Gemini_BTCUSD_1h_17_12_17_to_10_03_23.csv,BTC_USD,HOUR,96161.38,4.043,09/09/2021 08:00:00,09/09/2021 08:00:00,09/09/2021 08:00:00,EXPIRED,LONG,46300.0,46257.0,47727.23,45824.26,1.947,2.99,1.04,5770.29,2,3.0,-173.85
04/09/2020 08:00:00,15/06/2023 18:58:17,Gemini_BTCUSD_1h_17_12_17_to_10_03_23.csv,BTC_USD,HOUR,95987.53,23.437,04/09/2020 12:00:00,04/09/2020 11:00:00,04/09/2020 11:00:00,EXPIRED,LONG,10432.0,10441.0,10677.74,10350.09,2.547,2.3,0.79,5759.41,2,3.0,210.93
09/07/2019 10:00:00,15/06/2023 18:58:17,Gemini_BTCUSD_1h_17_12_17_to_10_03_23.csv,BTC_USD,HOUR,96198.46,11.966,09/07/2019 13:00:00,09/07/2019 13:00:00,09/07/2019 13:00:00,EXPIRED,LONG,12301.0,12410.0,12783.34,12140.22,1.53,3.77,1.32,5771.68,2,3.0,1304.29
23/02/2022 03:00:00,15/06/2023 18:58:17,Gemini_BTCUSD_1h_17_12_17_to_10_03_23.csv,BTC_USD,HOUR,97502.75,9.448,23/02/2022 04:00:00,23/02/2022 06:00:00,23/02/2022 06:00:00,EXPIRED,LONG,37784.0,37996.0,38403.2,37577.6,3.661,1.61,0.55,5850.2,2,3.0,2002.98
20/12/2018 02:00:00,15/06/2023 18:58:17,Gemini_BTCUSD_1h_17_12_17_to_10_03_23.csv,BTC_USD,HOUR,99505.73,107.866,20/12/2018 05:00:00,20/12/2018 05:00:00,20/12/2018 03:00:00,STOP_LOSS_HIT,LONG,3731.0,3712.55,3786.35,3712.55,4.044,1.46,0.5,5970.38,2,3.0,-1990.13
05/01/2021 02:00:00,15/06/2023 18:58:17,Gemini_BTCUSD_1h_17_12_17_to_10_03_23.csv,BTC_USD,HOUR,97515.6,3.7,05/01/2021 03:00:00,05/01/2021 05:00:00,05/01/2021 03:00:00,STOP_LOSS_HIT,LONG,32360.0,31832.91,33941.29,31832.91,1.228,4.66,1.66,5850.77,2,3.0,-1950.23
10/06/2021 01:00:00,15/06/2023 18:58:17,Gemini_BTCUSD_1h_17_12_17_to_10_03_23.csv,BTC_USD,HOUR,95565.37,3.033,10/06/2021 02:00:00,10/06/2021 04:00:00,10/06/2021 04:00:00,EXPIRED,LONG,36902.0,36809.0,38792.34,36271.89,1.171,4.87,1.74,5733.4,2,3.0,-282.07
28/08/2021 20:00:00,15/06/2023 18:58:17,Gemini_BTCUSD_1h_17_12_17_to_10_03_23.csv,BTC_USD,HOUR,95283.3,6.086,29/08/2021 00:00:00,28/08/2021 23:00:00,28/08/2021 23:00:00,EXPIRED,LONG,48750.0,48926.0,49689.44,48436.85,3.114,1.89,0.65,5717.43,2,3.0,1071.14
26/03/2020 01:00:00,15/06/2023 18:58:17,Gemini_BTCUSD_1h_17_12_17_to_10_03_23.csv,BTC_USD,HOUR,96354.44,18.473,26/03/2020 02:00:00,26/03/2020 04:00:00,26/03/2020 04:00:00,EXPIRED,LONG,6714.0,6709.0,7026.97,6609.68,1.287,4.45,1.58,5781.49,2,3.0,-92.36
19/04/2018 22:00:00,15/06/2023 18:58:17,Gemini_BTCUSD_1h_17_12_17_to_10_03_23.csv,BTC_USD,HOUR,96262.08,49.709,20/04/2018 01:00:00,20/04/2018 01:00:00,20/04/2018 00:00:00,TAKE_PROFIT_HIT,LONG,8253.0,8369.18,8369.18,8214.27,4.262,1.39,0.47,5775.19,2,3.0,5775.19
11/01/2021 11:00:00,15/06/2023 18:58:17,Gemini_BTCUSD_1h_17_12_17_to_10_03_23.csv,BTC_USD,HOUR,102037.27,12.002,11/01/2021 13:00:00,11/01/2021 14:00:00,11/01/2021 12:00:00,STOP_LOSS_HIT,LONG,34112.0,33941.97,34622.11,33941.97,4.012,1.47,0.5,6122.34,2,3.0,-2040.7
24/04/2018 17:00:00,15/06/2023 18:58:17,Gemini_BTCUSD_1h_17_12_17_to_10_03_23.csv,BTC_USD,HOUR,99996.57,15.176,24/04/2018 18:00:00,24/04/2018 20:00:00,24/04/2018 20:00:00,EXPIRED,LONG,9400.0,9459.0,9795.33,9268.22,1.427,4.04,1.42,5999.53,2,3.0,895.38
24/03/2018 02:00:00,15/06/2023 18:58:17,Gemini_BTCUSD_1h_17_12_17_to_10_03_23.csv,BTC_USD,HOUR,100891.95,25.516,24/03/2018 05:00:00,24/03/2018 05:00:00,24/03/2018 05:00:00,EXPIRED,SHORT,8910.0,8853.0,8672.77,8989.08,2.253,2.74,0.88,6053.16,2,3.0,1454.41
10/04/2020 19:00:00,15/06/2023 18:58:17,Gemini_BTCUSD_1h_17_12_17_to_10_03_23.csv,BTC_USD,HOUR,102346.36,21.979,10/04/2020 20:00:00,10/04/2020 22:00:00,10/04/2020 22:00:00,EXPIRED,LONG,6919.0,6870.0,7198.39,6825.87,1.486,3.88,1.36,6140.71,2,3.0,-1076.97
16/08/2020 10:00:00,15/06/2023 18:58:17,Gemini_BTCUSD_1h_17_12_17_to_10_03_23.csv,BTC_USD,HOUR,101269.39,34.103,16/08/2020 12:00:00,16/08/2020 13:00:00,16/08/2020 13:00:00,EXPIRED,SHORT,11801.0,11818.0,11622.83,11860.39,3.974,1.53,0.5,6076.13,2,3.0,-579.75
22/07/2020 22:00:00,15/06/2023 18:58:17,Gemini_BTCUSD_1h_17_12_17_to_10_03_23.csv,BTC_USD,HOUR,100689.64,34.272,23/07/2020 00:00:00,23/07/2020 01:00:00,23/07/2020 01:00:00,EXPIRED,SHORT,9514.0,9545.0,9337.73,9572.76,3.238,1.89,0.61,6041.13,2,3.0,-1062.43
24/12/2021 04:00:00,15/06/2023 18:58:17,Gemini_BTCUSD_1h_17_12_17_to_10_03_23.csv,BTC_USD,HOUR,99627.21,3.261,24/12/2021 05:00:00,24/12/2021 07:00:00,24/12/2021 07:00:00,EXPIRED,LONG,50972.0,51016.0,52805.33,50360.89,1.668,3.47,1.21,5978.49,2,3.0,143.48
18/10/2022 01:00:00,15/06/2023 18:58:17,Gemini_BTCUSD_1h_17_12_17_to_10_03_23.csv,BTC_USD,HOUR,99770.69,4.948,18/10/2022 02:00:00,18/10/2022 04:00:00,18/10/2022 04:00:00,EXPIRED,LONG,19538.0,19590.0,20747.78,19134.74,0.969,5.83,2.11,5985.99,2,3.0,257.3
15/09/2021 12:00:00,15/06/2023 18:58:17,Gemini_BTCUSD_1h_17_12_17_to_10_03_23.csv,BTC_USD,HOUR,100027.99,2.525,15/09/2021 14:00:00,15/09/2021 15:00:00,15/09/2021 15:00:00,EXPIRED,LONG,47534.0,48313.0,49911.37,46741.55,1.2,4.76,1.7,6002.86,2,3.0,1966.98
15/01/2023 17:00:00,15/06/2023 18:58:17,Gemini_BTCUSD_1h_17_12_17_to_10_03_23.csv,BTC_USD,HOUR,101994.97,6.092,15/01/2023 18:00:00,15/01/2023 20:00:00,15/01/2023 20:00:00,EXPIRED,LONG,20934.0,20909.0,21938.56,20599.15,1.25,4.58,1.63,6119.78,2,3.0,-152.3
14/12/2022 08:00:00,15/06/2023 18:58:17,Gemini_BTCUSD_1h_17_12_17_to_10_03_23.csv,BTC_USD,HOUR,101842.67,12.558,14/12/2022 10:00:00,14/12/2022 11:00:00,14/12/2022 11:00:00,EXPIRED,SHORT,17830.0,17823.0,17343.39,17992.2,2.199,2.81,0.9,6110.85,2,3.0,87.91
03/02/2019 03:00:00,15/06/2023 18:58:17,Gemini_BTCUSD_1h_17_12_17_to_10_03_23.csv,BTC_USD,HOUR,101930.58,62.727,03/02/2019 04:00:00,03/02/2019 06:00:00,03/02/2019 06:00:00,EXPIRED,LONG,3445.0,3434.0,3542.5,3412.5,2.12,2.75,0.95,6115.88,2,3.0,-690.0
25/02/2020 23:00:00,15/06/2023 18:58:17,Gemini_BTCUSD_1h_17_12_17_to_10_03_23.csv,BTC_USD,HOUR,101240.58,20.704,26/02/2020 02:00:00,26/02/2020 02:00:00,26/02/2020 01:00:00,STOP_LOSS_HIT,LONG,9311.0,9213.2,9604.41,9213.2,1.904,3.05,1.06,6074.76,2,3.0,-2024.85
24/10/2020 16:00:00,15/06/2023 18:58:17,Gemini_BTCUSD_1h_17_12_17_to_10_03_23.csv,BTC_USD,HOUR,99215.73,30.327,24/10/2020 19:00:00,24/10/2020 19:00:00,24/10/2020 19:00:00,EXPIRED,LONG,13086.0,13133.0,13282.29,13020.57,4.0,1.48,0.5,5952.89,2,3.0,1425.37
11/12/2022 19:00:00,15/06/2023 18:58:17,Gemini_BTCUSD_1h_17_12_17_to_10_03_23.csv,BTC_USD,HOUR,100641.1,8.208,11/12/2022 20:00:00,11/12/2022 22:00:00,11/12/2022 22:00:00,EXPIRED,LONG,17183.0,17114.0,17918.66,16937.78,1.401,4.11,1.45,6038.3,2,3.0,-566.35
24/10/2020 01:00:00,15/06/2023 18:58:17,Gemini_BTCUSD_1h_17_12_17_to_10_03_23.csv,BTC_USD,HOUR,100074.75,31.234,24/10/2020 02:00:00,24/10/2020 04:00:00,24/10/2020 04:00:00,EXPIRED,LONG,12977.0,12984.0,13169.24,12912.92,4.05,1.46,0.5,6004.42,2,3.0,218.64
15/04/2021 16:00:00,15/06/2023 18:58:17,Gemini_BTCUSD_1h_17_12_17_to_10_03_23.csv,BTC_USD,HOUR,100293.39,3.684,15/04/2021 18:00:00,15/04/2021 19:00:00,15/04/2021 19:00:00,EXPIRED,LONG,62722.0,63458.0,64355.34,62177.56,2.304,2.54,0.88,6017.22,2,3.0,2711.42
29/07/2020 18:00:00,15/06/2023 18:58:17,Gemini_BTCUSD_1h_17_12_17_to_10_03_23.csv,BTC_USD,HOUR,103004.81,10.115,29/07/2020 19:00:00,29/07/2020 21:00:00,29/07/2020 21:00:00,EXPIRED,LONG,11218.0,11300.0,11829.03,11014.33,1.102,5.17,1.85,6180.57,2,3.0,829.43
27/02/2019 07:00:00,15/06/2023 18:58:17,Gemini_BTCUSD_1h_17_12_17_to_10_03_23.csv,BTC_USD,HOUR,103834.24,112.803,27/02/2019 09:00:00,27/02/2019 10:00:00,27/02/2019 10:00:00,EXPIRED,LONG,3812.0,3806.0,3867.24,3793.59,4.141,1.43,0.49,6231.24,2,3.0,-676.82
22/07/2020 23:00:00,15/06/2023 18:58:17,Gemini_BTCUSD_1h_17_12_17_to_10_03_23.csv,BTC_USD,HOUR,103157.42,21.36,23/07/2020 00:00:00,23/07/2020 02:00:00,23/07/2020 02:00:00,EXPIRED,SHORT,9538.0,9519.0,9248.24,9634.59,1.975,3.13,1.0,6189.27,2,3.0,405.84
09/12/2018 07:00:00,15/06/2023 18:58:17,Gemini_BTCUSD_1h_17_12_17_to_10_03_23.csv,BTC_USD,HOUR,103563.26,115.391,09/12/2018 09:00:00,09/12/2018 10:00:00,09/12/2018 09:00:00,STOP_LOSS_HIT,SHORT,3401.0,3418.95,3347.16,3418.95,3.789,1.61,0.53,6212.65,2,3.0,-2071.27
18/02/2019 16:00:00,15/06/2023 18:58:17,Gemini_BTCUSD_1h_17_12_17_to_10_03_23.csv,BTC_USD,HOUR,101491.99,29.529,18/02/2019 17:00:00,18/02/2019 19:00:00,18/02/2019 19:00:00,EXPIRED,LONG,3859.0,3870.0,4065.21,3790.26,1.123,5.07,1.81,6089.18,2,3.0,324.82
09/03/2022 01:00:00,15/06/2023 18:58:17,Gemini_BTCUSD_1h_17_12_17_to_10_03_23.csv,BTC_USD,HOUR,101816.81,3.27,09/03/2022 05:00:00,09/03/2022 04:00:00,09/03/2022 03:00:00,TAKE_PROFIT_HIT,LONG,39233.0,41101.31,41101.31,38610.23,1.26,4.55,1.61,6109.37,2,3.0,6109.37
16/04/2020 09:00:00,15/06/2023 18:58:17,Gemini_BTCUSD_1h_17_12_17_to_10_03_23.csv,BTC_USD,HOUR,107926.18,48.517,16/04/2020 10:00:00,16/04/2020 12:00:00,16/04/2020 10:00:00,STOP_LOSS_HIT,LONG,7040.0,6995.51,7173.46,6995.51,3.165,1.86,0.64,6475.08,2,3.0,-2158.52
08/05/2021 12:00:00,15/06/2023 18:58:17,Gemini_BTCUSD_1h_17_12_17_to_10_03_23.csv,BTC_USD,HOUR,105767.66,5.782,08/05/2021 13:00:00,08/05/2021 15:00:00,08/05/2021 15:00:00,STOP_LOSS_HIT,LONG,58963.0,58597.15,60060.57,58597.15,3.223,1.83,0.62,6346.15,2,3.0,-2115.34
23/06/2022 14:00:00,15/06/2023 18:58:17,Gemini_BTCUSD_1h_17_12_17_to_10_03_23.csv,BTC_USD,HOUR,103652.32,18.389,23/06/2022 16:00:00,23/06/2022 17:00:00,23/06/2022 15:00:00,STOP_LOSS_HIT,LONG,20590.0,20477.27,20928.2,20477.27,3.653,1.62,0.55,6219.16,2,3.0,-2072.99
13/01/2021 10:00:00,15/06/2023 18:58:17,Gemini_BTCUSD_1h_17_12_17_to_10_03_23.csv,BTC_USD,HOUR,101579.33,5.087,13/01/2021 11:00:00,13/01/2021 13:00:00,13/01/2021 11:00:00,STOP_LOSS_HIT,LONG,34915.0,34515.66,36113.04,34515.66,1.749,3.32,1.16,6094.43,2,3.0,-2031.44
19/05/2022 09:00:00,15/06/2023 18:58:17,Gemini_BTCUSD_1h_17_12_17_to_10_03_23.csv,BTC_USD,HOUR,99547.89,8.199,19/05/2022 10:00:00,19/05/2022 12:00:00,19/05/2022 12:00:00,EXPIRED,LONG,28971.0,29452.0,29699.51,28728.17,2.386,2.45,0.85,5973.05,2,3.0,3943.72
15/07/2022 19:00:00,15/06/2023 18:58:17,Gemini_BTCUSD_1h_17_12_17_to_10_03_23.csv,BTC_USD,HOUR,103491.61,5.511,15/07/2022 21:00:00,15/07/2022 22:00:00,15/07/2022 22:00:00,EXPIRED,LONG,21156.0,20902.0,22282.83,20780.39,1.127,5.06,1.81,6209.96,2,3.0,-1399.79
10/01/2022 23:00:00,15/06/2023 18:58:17,Gemini_BTCUSD_1h_17_12_17_to_10_03_23.csv,BTC_USD,HOUR,102091.82,10.399,11/01/2022 02:00:00,11/01/2022 02:00:00,11/01/2022 01:00:00,STOP_LOSS_HIT,SHORT,41844.0,42040.35,41254.97,42040.35,4.262,1.43,0.47,6125.32,2,3.0,-2041.84
20/11/2021 06:00:00,15/06/2023 18:58:17,Gemini_BTCUSD_1h_17_12_17_to_10_03_23.csv,BTC_USD,HOUR,100049.98,6.527,20/11/2021 08:00:00,20/11/2021 09:00:00,20/11/2021 09:00:00,EXPIRED,LONG,58711.0,58560.0,59630.75,58404.42,3.83,1.54,0.52,6003.21,2,3.0,-985.58
23/07/2022 02:00:00,15/06/2023 18:58:17,Gemini_BTCUSD_1h_17_12_17_to_10_03_23.csv,BTC_USD,HOUR,99064.4,16.489,23/07/2022 06:00:00,23/07/2022 05:00:00,23/07/2022 04:00:00,STOP_LOSS_HIT,SHORT,22838.0,22958.16,22477.51,22958.16,3.801,1.6,0.52,5944.12,2,3.0,-1981.32
25/08/2019 13:00:00,15/06/2023 18:58:17,Gemini_BTCUSD_1h_17_12_17_to_10_03_23.csv,BTC_USD,HOUR,97083.08,28.222,25/08/2019 14:00:00,25/08/2019 16:00:00,25/08/2019 14:00:00,TAKE_PROFIT_HIT,SHORT,10257.0,10050.61,10050.61,10325.8,2.982,2.05,0.67,5824.74,2,3.0,5824.74
16/03/2022 04:00:00,15/06/2023 18:58:17,Gemini_BTCUSD_1h_17_12_17_to_10_03_23.csv,BTC_USD,HOUR,102907.82,9.922,16/03/2022 06:00:00,16/03/2022 07:00:00,16/03/2022 07:00:00,EXPIRED,LONG,39135.0,39586.0,39757.34,38927.56,3.773,1.57,0.53,6174.86,2,3.0,4474.82
04/02/2021 01:00:00,15/06/2023 18:58:17,Gemini_BTCUSD_1h_17_12_17_to_10_03_23.csv,BTC_USD,HOUR,107382.64,2.934,04/02/2021 02:00:00,04/02/2021 04:00:00,04/02/2021 03:00:00,STOP_LOSS_HIT,LONG,38242.0,37509.96,40438.12,37509.96,1.045,5.43,1.95,6443.42,2,3.0,-2147.81
10/07/2021 13:00:00,15/06/2023 18:58:17,Gemini_BTCUSD_1h_17_12_17_to_10_03_23.csv,BTC_USD,HOUR,105234.83,4.325,10/07/2021 14:00:00,10/07/2021 16:00:00,10/07/2021 16:00:00,EXPIRED,LONG,33715.0,34037.0,35174.78,33228.41,1.386,4.15,1.46,6313.55,2,3.0,1392.65
20/04/2018 21:00:00,15/06/2023 18:58:17,Gemini_BTCUSD_1h_17_12_17_to_10_03_23.csv,BTC_USD,HOUR,106627.48,12.435,20/04/2018 23:00:00,21/04/2018 00:00:00,21/04/2018 00:00:00,EXPIRED,LONG,8520.0,8847.0,9034.49,8348.5,0.994,5.69,2.05,6397.68,2,3.0,4066.25
21/03/2020 21:00:00,15/06/2023 18:58:17,Gemini_BTCUSD_1h_17_12_17_to_10_03_23.csv,BTC_USD,HOUR,110693.73,19.972,21/03/2020 22:00:00,22/03/2020 00:00:00,22/03/2020 00:00:00,EXPIRED,LONG,6181.0,6207.0,6513.55,6070.15,1.115,5.11,1.83,6641.69,2,3.0,519.27
29/03/2019 12:00:00,15/06/2023 18:58:18,Gemini_BTCUSD_1h_17_12_17_to_10_03_23.csv,BTC_USD,HOUR,111213.0,50.141,29/03/2019 13:00:00,29/03/2019 15:00:00,29/03/2019 15:00:00,EXPIRED,LONG,4083.0,4080.0,4216.09,4038.64,1.841,3.16,1.1,6673.27,2,3.0,-150.42
13/02/2022 12:00:00,15/06/2023 18:58:18,Gemini_BTCUSD_1h_17_12_17_to_10_03_23.csv,BTC_USD,HOUR,111062.58,10.14,13/02/2022 14:00:00,13/02/2022 15:00:00,13/02/2022 14:00:00,STOP_LOSS_HIT,LONG,42503.0,42283.95,43160.16,42283.95,3.881,1.52,0.52,6663.6,2,3.0,-2221.17
19/06/2022 15:00:00,15/06/2023 18:58:18,Gemini_BTCUSD_1h_17_12_17_to_10_03_23.csv,BTC_USD,HOUR,108841.41,18.767,19/06/2022 17:00:00,19/06/2022 18:00:00,19/06/2022 16:00:00,TAKE_PROFIT_HIT,SHORT,19808.0,19460.04,19460.04,19923.99,3.415,1.79,0.58,6530.17,2,3.0,6530.17
15/12/2018 21:00:00,15/06/2023 18:58:18,Gemini_BTCUSD_1h_17_12_17_to_10_03_23.csv,BTC_USD,HOUR,115371.58,51.027,15/12/2018 22:00:00,16/12/2018 00:00:00,16/12/2018 00:00:00,EXPIRED,LONG,3204.0,3184.0,3339.67,3158.78,1.417,4.06,1.43,6922.83,2,3.0,-1020.54
07/01/2018 02:00:00,15/06/2023 18:58:18,Gemini_BTCUSD_1h_17_12_17_to_10_03_23.csv,BTC_USD,HOUR,114351.04,9.744,07/01/2018 06:00:00,07/01/2018 05:00:00,07/01/2018 04:00:00,STOP_LOSS_HIT,LONG,16801.0,16566.29,17505.13,16566.29,1.432,4.02,1.42,6861.04,2,3.0,-2287.01
22/11/2021 23:00:00,15/06/2023 18:58:18,Gemini_BTCUSD_1h_17_12_17_to_10_03_23.csv,BTC_USD,HOUR,112064.03,8.403,23/11/2021 03:00:00,23/11/2021 02:00:00,23/11/2021 00:00:00,STOP_LOSS_HIT,SHORT,56353.0,56619.71,55552.88,56619.71,4.226,1.44,0.47,6723.41,2,3.0,-2241.16
01/07/2018 03:00:00,15/06/2023 18:58:18,Gemini_BTCUSD_1h_17_12_17_to_10_03_23.csv,BTC_USD,HOUR,109822.87,38.841,01/07/2018 04:00:00,01/07/2018 06:00:00,01/07/2018 06:00:00,EXPIRED,LONG,6350.0,6359.0,6519.64,6293.45,2.246,2.6,0.9,6588.99,2,3.0,349.57
08/04/2019 04:00:00,15/06/2023 18:58:18,Gemini_BTCUSD_1h_17_12_17_to_10_03_23.csv,BTC_USD,HOUR,110172.44,26.006,08/04/2019 05:00:00,08/04/2019 07:00:00,08/04/2019 07:00:00,STOP_LOSS_HIT,LONG,5318.0,5233.27,5572.19,5233.27,1.255,4.56,1.62,6610.47,2,3.0,-2203.49
15/12/2020 01:00:00,15/06/2023 18:58:18,Gemini_BTCUSD_1h_17_12_17_to_10_03_23.csv,BTC_USD,HOUR,107968.95,7.808,15/12/2020 02:00:00,15/12/2020 04:00:00,15/12/2020 04:00:00,STOP_LOSS_HIT,LONG,19460.0,19183.44,20289.68,19183.44,1.407,4.09,1.44,6478.14,2,3.0,-2159.38
25/03/2020 23:00:00,15/06/2023 18:58:18,Gemini_BTCUSD_1h_17_12_17_to_10_03_23.csv,BTC_USD,HOUR,105809.57,61.091,26/03/2020 01:00:00,26/03/2020 02:00:00,26/03/2020 02:00:00,EXPIRED,LONG,6695.0,6707.0,6798.93,6660.36,3.865,1.53,0.52,6349.19,2,3.0,733.09
03/01/2021 07:00:00,15/06/2023 18:58:18,Gemini_BTCUSD_1h_17_12_17_to_10_03_23.csv,BTC_USD,HOUR,106542.66,4.057,03/01/2021 09:00:00,03/01/2021 10:00:00,03/01/2021 08:00:00,STOP_LOSS_HIT,LONG,34524.0,33998.77,36099.71,33998.77,1.315,4.36,1.54,6392.66,2,3.0,-2130.86
26/08/2018 14:00:00,15/06/2023 18:58:18,Gemini_BTCUSD_1h_17_12_17_to_10_03_23.csv,BTC_USD,HOUR,104411.8,62.522,26/08/2018 15:00:00,26/08/2018 17:00:00,26/08/2018 16:00:00,STOP_LOSS_HIT,LONG,6700.0,6666.6,6800.19,6666.6,4.012,1.47,0.5,6264.08,2,3.0,-2088.23
29/10/2022 03:00:00,15/06/2023 18:58:18,Gemini_BTCUSD_1h_17_12_17_to_10_03_23.csv,BTC_USD,HOUR,102323.57,20.02,29/10/2022 06:00:00,29/10/2022 06:00:00,29/10/2022 05:00:00,STOP_LOSS_HIT,LONG,20767.0,20664.78,21073.66,20664.78,4.063,1.46,0.49,6139.33,2,3.0,-2046.44
09/02/2022 20:00:00,15/06/2023 18:58:18,Gemini_BTCUSD_1h_17_12_17_to_10_03_23.csv,BTC_USD,HOUR,100277.13,2.578,09/02/2022 21:00:00,09/02/2022 23:00:00,09/02/2022 23:00:00,EXPIRED,LONG,44814.0,44419.0,47148.25,44035.92,1.152,4.95,1.77,6017.7,2,3.0,-1018.31
19/02/2022 18:00:00,15/06/2023 18:58:18,Gemini_BTCUSD_1h_17_12_17_to_10_03_23.csv,BTC_USD,HOUR,99258.82,8.075,19/02/2022 19:00:00,19/02/2022 21:00:00,19/02/2022 21:00:00,STOP_LOSS_HIT,LONG,40149.0,39903.15,40886.54,39903.15,3.266,1.8,0.62,5955.64,2,3.0,-1985.24
26/08/2020 03:00:00,15/06/2023 18:58:18,Gemini_BTCUSD_1h_17_12_17_to_10_03_23.csv,BTC_USD,HOUR,97273.58,19.643,26/08/2020 05:00:00,26/08/2020 06:00:00,26/08/2020 06:00:00,EXPIRED,SHORT,11368.0,11333.0,11070.87,11467.04,2.296,2.68,0.86,5836.52,2,3.0,687.51
09/04/2018 00:00:00,15/06/2023 18:58:18,Gemini_BTCUSD_1h_17_12_17_to_10_03_23.csv,BTC_USD,HOUR,97961.09,48.364,09/04/2018 02:00:00,09/04/2018 03:00:00,09/04/2018 03:00:00,EXPIRED,LONG,7060.0,7128.0,7181.52,7019.49,3.486,1.69,0.58,5877.19,2,3.0,3288.75
27/07/2022 10:00:00,15/06/2023 18:58:18,Gemini_BTCUSD_1h_17_12_17_to_10_03_23.csv,BTC_USD,HOUR,101249.84,6.339,27/07/2022 12:00:00,27/07/2022 13:00:00,27/07/2022 13:00:00,EXPIRED,LONG,21285.0,21460.0,22243.33,20965.56,1.333,4.31,1.52,6074.85,2,3.0,1109.33
17/06/2020 08:00:00,15/06/2023 18:58:18,Gemini_BTCUSD_1h_17_12_17_to_10_03_23.csv,BTC_USD,HOUR,102359.17,15.738,17/06/2020 11:00:00,17/06/2020 11:00:00,17/06/2020 11:00:00,EXPIRED,LONG,9490.0,9473.0,9880.26,9359.92,1.459,3.95,1.39,6141.91,2,3.0,-267.55
14/10/2021 01:00:00,15/06/2023 18:58:18,Gemini_BTCUSD_1h_17_12_17_to_10_03_23.csv,BTC_USD,HOUR,102091.62,6.624,14/10/2021 03:00:00,14/10/2021 04:00:00,14/10/2021 04:00:00,EXPIRED,SHORT,58327.0,57970.0,57402.23,58635.26,3.784,1.61,0.53,6125.68,2,3.0,2364.77
14/10/2018 07:00:00,15/06/2023 18:58:18,Gemini_BTCUSD_1h_17_12_17_to_10_03_23.csv,BTC_USD,HOUR,104456.39,19.452,14/10/2018 08:00:00,14/10/2018 10:00:00,14/10/2018 10:00:00,EXPIRED,LONG,6245.0,6224.0,6567.19,6137.6,1.163,4.91,1.75,6267.24,2,3.0,-408.49
04/04/2021 04:00:00,15/06/2023 18:58:18,Gemini_BTCUSD_1h_17_12_17_to_10_03_23.csv,BTC_USD,HOUR,104047.9,4.263,04/04/2021 08:00:00,04/04/2021 07:00:00,04/04/2021 07:00:00,EXPIRED,SHORT,57589.0,57628.0,56124.68,58077.11,2.36,2.61,0.84,6242.4,2,3.0,-166.26
10/12/2021 14:00:00,15/06/2023 18:58:18,Gemini_BTCUSD_1h_17_12_17_to_10_03_23.csv,BTC_USD,HOUR,103881.64,2.402,10/12/2021 16:00:00,10/12/2021 17:00:00,10/12/2021 17:00:00,EXPIRED,LONG,49094.0,49094.0,51688.54,48229.15,1.135,5.02,1.79,6232.09,2,3.0,0.0
23/06/2018 15:00:00,15/06/2023 18:58:18,Gemini_BTCUSD_1h_17_12_17_to_10_03_23.csv,BTC_USD,HOUR,103881.64,40.001,23/06/2018 19:00:00,23/06/2018 18:00:00,23/06/2018 18:00:00,EXPIRED,SHORT,6114.0,6138.0,5958.19,6165.94,2.354,2.62,0.84,6232.56,2,3.0,-960.02
14/06/2022 19:00:00,15/06/2023 18:58:18,Gemini_BTCUSD_1h_17_12_17_to_10_03_23.csv,BTC_USD,HOUR,102921.62,9.438,14/06/2022 21:00:00,14/06/2022 22:00:00,14/06/2022 20:00:00,STOP_LOSS_HIT,LONG,22162.0,21943.91,22816.28,21943.91,2.032,2.87,0.99,6175.09,2,3.0,-2058.33
11/10/2018 19:00:00,15/06/2023 18:58:18,Gemini_BTCUSD_1h_17_12_17_to_10_03_23.csv,BTC_USD,HOUR,100863.29,51.831,11/10/2018 22:00:00,11/10/2018 22:00:00,11/10/2018 20:00:00,STOP_LOSS_HIT,LONG,6199.0,6160.08,6315.77,6160.08,3.186,1.85,0.63,6052.31,2,3.0,-2017.26
11/11/2020 05:00:00,15/06/2023 18:58:18,Gemini_BTCUSD_1h_17_12_17_to_10_03_23.csv,BTC_USD,HOUR,98846.03,9.514,11/11/2020 07:00:00,11/11/2020 08:00:00,11/11/2020 08:00:00,EXPIRED,SHORT,15392.0,15414.0,14768.63,15599.79,1.481,4.22,1.33,5930.74,2,3.0,-209.31
14/09/2020 18:00:00,15/06/2023 18:58:18,Gemini_BTCUSD_1h_17_12_17_to_10_03_23.csv,BTC_USD,HOUR,98636.72,38.834,14/09/2020 20:00:00,14/09/2020 21:00:00,14/09/2020 21:00:00,EXPIRED,SHORT,10685.0,10725.0,10532.62,10735.8,4.207,1.45,0.47,5917.52,2,3.0,-1553.36
13/01/2021 23:00:00,15/06/2023 18:58:18,Gemini_BTCUSD_1h_17_12_17_to_10_03_23.csv,BTC_USD,HOUR,97083.36,4.609,14/01/2021 01:00:00,14/01/2021 02:00:00,14/01/2021 02:00:00,EXPIRED,LONG,37420.0,37455.0,38683.79,36998.74,1.777,3.27,1.14,5824.81,2,3.0,161.32
24/07/2022 18:00:00,15/06/2023 18:58:18,Gemini_BTCUSD_1h_17_12_17_to_10_03_23.csv,BTC_USD,HOUR,97244.68,9.75,24/07/2022 21:00:00,24/07/2022 21:00:00,24/07/2022 21:00:00,EXPIRED,LONG,22720.0,22822.0,23318.42,22520.53,2.278,2.57,0.89,5834.59,2,3.0,994.5
20/11/2021 13:00:00,15/06/2023 18:58:18,Gemini_BTCUSD_1h_17_12_17_to_10_03_23.csv,BTC_USD,HOUR,98239.18,219.261,20/11/2021 16:00:00,20/11/2021 16:00:00,20/11/2021 14:00:00,STOP_LOSS_HIT,SHORT,58533.0,58541.96,58506.12,58541.96,130.64,0.05,0.02,5893.74,2,3.0,-1964.58
16/02/2022 02:00:00,15/06/2023 18:58:18,Gemini_BTCUSD_1h_17_12_17_to_10_03_23.csv,BTC_USD,HOUR,96274.6,2.266,16/02/2022 03:00:00,16/02/2022 05:00:00,16/02/2022 05:00:00,EXPIRED,LONG,44100.0,44093.0,46649.6,43250.14,1.038,5.47,1.96,5777.39,2,3.0,-15.86
19/12/2019 23:00:00,15/06/2023 18:58:18,Gemini_BTCUSD_1h_17_12_17_to_10_03_23.csv,BTC_USD,HOUR,96258.74,48.359,20/12/2019 03:00:00,20/12/2019 02:00:00,20/12/2019 01:00:00,STOP_LOSS_HIT,LONG,7155.0,7115.19,7274.42,7115.19,3.595,1.64,0.56,5775.03,2,3.0,-1925.17
22/03/2021 07:00:00,15/06/2023 18:58:18,Gemini_BTCUSD_1h_17_12_17_to_10_03_23.csv,BTC_USD,HOUR,94333.57,6.142,22/03/2021 08:00:00,22/03/2021 10:00:00,22/03/2021 08:00:00,STOP_LOSS_HIT,LONG,57609.0,57301.81,58530.57,57301.81,3.751,1.57,0.54,5660.28,2,3.0,-1886.76
14/03/2020 02:00:00,15/06/2023 18:58:18,Gemini_BTCUSD_1h_17_12_17_to_10_03_23.csv,BTC_USD,HOUR,92446.81,62.996,14/03/2020 05:00:00,14/03/2020 05:00:00,14/03/2020 03:00:00,STOP_LOSS_HIT,LONG,5604.0,5574.65,5692.06,5574.65,3.819,1.55,0.53,5547.43,2,3.0,-1848.93
01/03/2022 01:00:00,15/06/2023 18:58:18,Gemini_BTCUSD_1h_17_12_17_to_10_03_23.csv,BTC_USD,HOUR,90597.88,2.434,01/03/2022 02:00:00,01/03/2022 04:00:00,01/03/2022 04:00:00,EXPIRED,LONG,43297.0,43370.0,45530.08,42552.64,1.163,4.9,1.75,5435.32,2,3.0,177.68
05/11/2020 04:00:00,15/06/2023 18:58:18,Gemini_BTCUSD_1h_17_12_17_to_10_03_23.csv,BTC_USD,HOUR,90775.56,8.0,05/11/2020 05:00:00,05/11/2020 07:00:00,05/11/2020 07:00:00,EXPIRED,LONG,14306.0,14498.0,14986.84,14079.05,1.261,4.54,1.61,5446.72,2,3.0,1536.0
31/12/2020 02:00:00,15/06/2023 18:58:18,Gemini_BTCUSD_1h_17_12_17_to_10_03_23.csv,BTC_USD,HOUR,92311.56,6.101,31/12/2020 04:00:00,31/12/2020 05:00:00,31/12/2020 05:00:00,EXPIRED,LONG,28729.0,28987.0,29636.78,28426.41,1.899,3.06,1.06,5538.37,2,3.0,1574.06
17/10/2022 09:00:00,15/06/2023 18:58:18,Gemini_BTCUSD_1h_17_12_17_to_10_03_23.csv,BTC_USD,HOUR,93885.62,6.65,17/10/2022 11:00:00,17/10/2022 12:00:00,17/10/2022 12:00:00,EXPIRED,LONG,19338.0,19520.0,20185.05,19055.65,1.37,4.2,1.48,5632.88,2,3.0,1210.3
12/06/2019 05:00:00,15/06/2023 18:58:18,Gemini_BTCUSD_1h_17_12_17_to_10_03_23.csv,BTC_USD,HOUR,95095.92,41.319,12/06/2019 06:00:00,12/06/2019 08:00:00,12/06/2019 08:00:00,EXPIRED,LONG,7978.0,7986.0,8116.08,7931.97,3.466,1.7,0.58,5705.33,2,3.0,330.55
07/08/2019 23:00:00,15/06/2023 18:58:18,Gemini_BTCUSD_1h_17_12_17_to_10_03_23.csv,BTC_USD,HOUR,95426.47,8.285,08/08/2019 00:00:00,08/08/2019 02:00:00,08/08/2019 02:00:00,EXPIRED,LONG,11973.0,11922.0,12664.12,11742.63,1.04,5.46,1.96,5725.93,2,3.0,-422.53
26/01/2018 18:00:00,15/06/2023 18:58:18,Gemini_BTCUSD_1h_17_12_17_to_10_03_23.csv,BTC_USD,HOUR,95003.94,9.767,26/01/2018 19:00:00,26/01/2018 21:00:00,26/01/2018 21:00:00,STOP_LOSS_HIT,LONG,11016.0,10821.46,11599.63,10821.46,1.133,5.03,1.8,5700.31,2,3.0,-1900.07
05/05/2018 14:00:00,15/06/2023 18:58:18,Gemini_BTCUSD_1h_17_12_17_to_10_03_23.csv,BTC_USD,HOUR,93103.87,15.265,05/05/2018 15:00:00,05/05/2018 17:00:00,05/05/2018 17:00:00,EXPIRED,LONG,9919.0,9854.0,10284.93,9797.02,1.626,3.56,1.25,5585.92,2,3.0,-992.22
21/09/2018 07:00:00,15/06/2023 18:58:18,Gemini_BTCUSD_1h_17_12_17_to_10_03_23.csv,BTC_USD,HOUR,92111.65,22.474,21/09/2018 11:00:00,21/09/2018 10:00:00,21/09/2018 08:00:00,STOP_LOSS_HIT,SHORT,6640.0,6721.97,6394.09,6721.97,1.62,3.85,1.22,5526.58,2,3.0,-1842.19
10/03/2018 06:00:00,15/06/2023 18:58:18,Gemini_BTCUSD_1h_17_12_17_to_10_03_23.csv,BTC_USD,HOUR,90269.46,21.307,10/03/2018 08:00:00,10/03/2018 09:00:00,10/03/2018 08:00:00,STOP_LOSS_HIT,LONG,9439.0,9354.27,9693.18,9354.27,2.228,2.62,0.91,5415.81,2,3.0,-1805.34
24/03/2018 08:00:00,15/06/2023 18:58:18,Gemini_BTCUSD_1h_17_12_17_to_10_03_23.csv,BTC_USD,HOUR,88464.12,37.789,24/03/2018 10:00:00,24/03/2018 11:00:00,24/03/2018 10:00:00,STOP_LOSS_HIT,LONG,8886.0,8839.18,9026.45,8839.18,3.796,1.56,0.53,5307.47,2,3.0,-1769.28
17/04/2019 02:00:00,15/06/2023 18:58:18,Gemini_BTCUSD_1h_17_12_17_to_10_03_23.csv,BTC_USD,HOUR,86694.84,24.612,17/04/2019 04:00:00,17/04/2019 05:00:00,17/04/2019 05:00:00,EXPIRED,LONG,5224.0,5230.0,5435.35,5153.55,1.483,3.89,1.37,5201.75,2,3.0,147.67
21/04/2022 06:00:00,15/06/2023 18:58:18,Gemini_BTCUSD_1h_17_12_17_to_10_03_23.csv,BTC_USD,HOUR,86842.51,7.92,21/04/2022 08:00:00,21/04/2022 09:00:00,21/04/2022 07:00:00,STOP_LOSS_HIT,SHORT,41560.0,41779.31,40902.08,41779.31,3.79,1.61,0.52,5210.73,2,3.0,-1736.94
10/08/2021 22:00:00,15/06/2023 18:58:18,Gemini_BTCUSD_1h_17_12_17_to_10_03_23.csv,BTC_USD,HOUR,85105.57,2.396,10/08/2021 23:00:00,11/08/2021 01:00:00,11/08/2021 01:00:00,EXPIRED,LONG,45451.0,45783.0,47582.36,44740.55,1.28,4.48,1.59,5106.74,2,3.0,795.47
29/08/2022 23:00:00,15/06/2023 18:58:18,Gemini_BTCUSD_1h_17_12_17_to_10_03_23.csv,BTC_USD,HOUR,85901.04,15.556,30/08/2022 03:00:00,30/08/2022 02:00:00,30/08/2022 01:00:00,STOP_LOSS_HIT,LONG,20292.0,20181.56,20623.33,20181.56,3.675,1.61,0.55,5154.17,2,3.0,-1718.0
19/03/2022 22:00:00,15/06/2023 18:58:18,Gemini_BTCUSD_1h_17_12_17_to_10_03_23.csv,BTC_USD,HOUR,84183.04,2.953,19/03/2022 23:00:00,20/03/2022 01:00:00,20/03/2022 01:00:00,EXPIRED,LONG,41979.0,41984.0,43689.19,41408.94,1.473,3.91,1.38,5050.19,2,3.0,14.76
28/04/2018 02:00:00,15/06/2023 18:58:18,Gemini_BTCUSD_1h_17_12_17_to_10_03_23.csv,BTC_USD,HOUR,84197.8,35.959,28/04/2018 06:00:00,28/04/2018 05:00:00,28/04/2018 05:00:00,EXPIRED,LONG,9055.0,9139.0,9195.49,9008.17,3.867,1.53,0.52,5051.88,2,3.0,3020.56
22/04/2020 18:00:00,15/06/2023 18:58:18,Gemini_BTCUSD_1h_17_12_17_to_10_03_23.csv,BTC_USD,HOUR,87218.36,44.935,22/04/2020 20:00:00,22/04/2020 21:00:00,22/04/2020 21:00:00,EXPIRED,LONG,7105.0,7106.0,7221.46,7066.18,3.661,1.61,0.55,5233.13,2,3.0,44.94
10/09/2020 05:00:00,15/06/2023 18:58:18,Gemini_BTCUSD_1h_17_12_17_to_10_03_23.csv,BTC_USD,HOUR,87263.3,26.423,10/09/2020 08:00:00,10/09/2020 08:00:00,10/09/2020 08:00:00,EXPIRED,SHORT,10385.0,10281.0,10186.85,10451.05,3.145,1.95,0.63,5235.72,2,3.0,2747.99
05/04/2019 07:00:00,15/06/2023 18:58:18,Gemini_BTCUSD_1h_17_12_17_to_10_03_23.csv,BTC_USD,HOUR,90011.29,23.706,05/04/2019 09:00:00,05/04/2019 10:00:00,05/04/2019 10:00:00,EXPIRED,LONG,4940.0,4965.0,5167.83,4864.06,1.301,4.41,1.56,5400.94,2,3.0,592.65
29/12/2017 01:00:00,15/06/2023 18:58:18,Gemini_BTCUSD_1h_17_12_17_to_10_03_23.csv,BTC_USD,HOUR,90603.94,11.287,29/12/2017 03:00:00,29/12/2017 04:00:00,29/12/2017 02:00:00,TAKE_PROFIT_HIT,LONG,14384.0,14865.65,14865.65,14223.45,1.792,3.24,1.13,5436.38,2,3.0,5436.38
06/06/2022 07:00:00,15/06/2023 18:58:18,Gemini_BTCUSD_1h_17_12_17_to_10_03_23.csv,BTC_USD,HOUR,96040.32,11.195,06/06/2022 10:00:00,06/06/2022 10:00:00,06/06/2022 10:00:00,EXPIRED,LONG,31244.0,31462.0,31758.75,31072.42,3.642,1.62,0.55,5762.63,2,3.0,2440.51
09/08/2019 01:00:00,15/06/2023 18:58:18,Gemini_BTCUSD_1h_17_12_17_to_10_03_23.csv,BTC_USD,HOUR,98480.83,34.207,09/08/2019 05:00:00,09/08/2019 04:00:00,09/08/2019 04:00:00,EXPIRED,LONG,11844.0,11886.0,12016.74,11786.42,4.114,1.44,0.49,5908.92,2,3.0,1436.69
01/01/2020 04:00:00,15/06/2023 18:58:18,Gemini_BTCUSD_1h_17_12_17_to_10_03_23.csv,BTC_USD,HOUR,99917.52,23.855,01/01/2020 06:00:00,01/01/2020 07:00:00,01/01/2020 07:00:00,EXPIRED,LONG,7189.0,7189.0,7440.31,7105.23,1.716,3.38,1.18,5995.0,2,3.0,0.0
28/03/2018 10:00:00,15/06/2023 18:58:18,Gemini_BTCUSD_1h_17_12_17_to_10_03_23.csv,BTC_USD,HOUR,99917.52,14.562,28/03/2018 11:00:00,28/03/2018 13:00:00,28/03/2018 13:00:00,EXPIRED,LONG,8044.0,8034.0,8455.69,7906.77,1.172,4.87,1.74,5995.03,2,3.0,-145.62
14/04/2019 22:00:00,15/06/2023 18:58:18,Gemini_BTCUSD_1h_17_12_17_to_10_03_23.csv,BTC_USD,HOUR,99771.9,27.123,14/04/2019 23:00:00,15/04/2019 01:00:00,15/04/2019 01:00:00,EXPIRED,LONG,5163.0,5165.0,5383.71,5089.43,1.404,4.1,1.45,5986.32,2,3.0,54.25
30/07/2021 15:00:00,15/06/2023 18:58:18,Gemini_BTCUSD_1h_17_12_17_to_10_03_23.csv,BTC_USD,HOUR,99826.15,9.78,30/07/2021 18:00:00,30/07/2021 18:00:00,30/07/2021 18:00:00,EXPIRED,LONG,39093.0,39104.0,39705.42,38888.86,3.83,1.54,0.52,5989.47,2,3.0,107.58
02/12/2021 13:00:00,15/06/2023 18:58:18,Gemini_BTCUSD_1h_17_12_17_to_10_03_23.csv,BTC_USD,HOUR,99933.73,3.373,02/12/2021 17:00:00,02/12/2021 16:00:00,02/12/2021 16:00:00,EXPIRED,SHORT,56486.0,56378.0,54708.2,57078.6,1.907,3.25,1.04,5996.52,2,3.0,364.28
12/07/2020 02:00:00,15/06/2023 18:58:18,Gemini_BTCUSD_1h_17_12_17_to_10_03_23.csv,BTC_USD,HOUR,100298.01,11.887,12/07/2020 03:00:00,12/07/2020 05:00:00,12/07/2020 05:00:00,EXPIRED,LONG,9272.0,9274.0,9778.24,9103.25,1.099,5.18,1.85,6017.67,2,3.0,23.77
25/01/2021 12:00:00,15/06/2023 18:58:18,Gemini_BTCUSD_1h_17_12_17_to_10_03_23.csv,BTC_USD,HOUR,100321.78,4.837,25/01/2021 16:00:00,25/01/2021 15:00:00,25/01/2021 15:00:00,EXPIRED,LONG,34188.0,34450.0,35432.33,33773.23,1.648,3.51,1.23,6018.82,2,3.0,1267.29
14/01/2021 08:00:00,15/06/2023 18:58:18,Gemini_BTCUSD_1h_17_12_17_to_10_03_23.csv,BTC_USD,HOUR,101589.07,2.594,14/01/2021 09:00:00,14/01/2021 11:00:00,14/01/2021 11:00:00,EXPIRED,LONG,38435.0,38397.0,40784.57,37651.81,0.981,5.76,2.08,6094.78,2,3.0,-98.57
19/04/2021 19:00:00,15/06/2023 18:58:18,Gemini_BTCUSD_1h_17_12_17_to_10_03_23.csv,BTC_USD,HOUR,101490.5,6.837,19/04/2021 22:00:00,19/04/2021 22:00:00,19/04/2021 20:00:00,STOP_LOSS_HIT,LONG,56008.0,55711.12,56898.66,55711.12,3.773,1.57,0.53,6089.44,2,3.0,-2029.77
29/04/2021 16:00:00,15/06/2023 18:58:18,Gemini_BTCUSD_1h_17_12_17_to_10_03_23.csv,BTC_USD,HOUR,99460.73,7.648,29/04/2021 18:00:00,29/04/2021 19:00:00,29/04/2021 19:00:00,EXPIRED,SHORT,52998.0,52900.0,52217.71,53258.1,4.075,1.49,0.49,5967.66,2,3.0,749.5
06/12/2021 13:00:00,15/06/2023 18:58:18,Gemini_BTCUSD_1h_17_12_17_to_10_03_23.csv,BTC_USD,HOUR,100210.23,7.626,06/12/2021 17:00:00,06/12/2021 16:00:00,06/12/2021 14:00:00,STOP_LOSS_HIT,LONG,48352.0,48089.19,49140.42,48089.19,3.68,1.6,0.55,6012.49,2,3.0,-2004.19
08/08/2020 14:00:00,15/06/2023 18:58:18,Gemini_BTCUSD_1h_17_12_17_to_10_03_23.csv,BTC_USD,HOUR,98206.04,30.858,08/08/2020 16:00:00,08/08/2020 17:00:00,08/08/2020 17:00:00,EXPIRED,SHORT,11754.0,11727.0,11563.04,11817.65,3.693,1.65,0.54,5892.64,2,3.0,833.17
30/03/2020 17:00:00,15/06/2023 18:58:18,Gemini_BTCUSD_1h_17_12_17_to_10_03_23.csv,BTC_USD,HOUR,99039.21,16.16,30/03/2020 19:00:00,30/03/2020 20:00:00,30/03/2020 20:00:00,EXPIRED,LONG,6370.0,6481.0,6737.7,6247.43,1.039,5.46,1.96,5942.03,2,3.0,1793.76
25/04/2021 08:00:00,15/06/2023 18:58:18,Gemini_BTCUSD_1h_17_12_17_to_10_03_23.csv,BTC_USD,HOUR,100832.97,7.084,25/04/2021 12:00:00,25/04/2021 11:00:00,25/04/2021 09:00:00,TAKE_PROFIT_HIT,SHORT,50147.0,49292.96,49292.96,50431.68,3.523,1.73,0.56,6050.02,2,3.0,6050.02
26/10/2022 12:00:00,15/06/2023 18:58:18,Gemini_BTCUSD_1h_17_12_17_to_10_03_23.csv,BTC_USD,HOUR,106882.99,18.983,26/10/2022 14:00:00,26/10/2022 15:00:00,26/10/2022 14:00:00,STOP_LOSS_HIT,SHORT,20552.0,20664.61,20214.19,20664.61,3.65,1.67,0.54,6412.65,2,3.0,-2137.68
11/01/2019 08:00:00,15/06/2023 18:58:18,Gemini_BTCUSD_1h_17_12_17_to_10_03_23.csv,BTC_USD,HOUR,104745.31,61.291,11/01/2019 09:00:00,11/01/2019 11:00:00,11/01/2019 11:00:00,EXPIRED,LONG,3642.0,3640.0,3744.54,3607.82,2.131,2.74,0.95,6284.78,2,3.0,-122.58
01/12/2021 13:00:00,15/06/2023 18:58:18,Gemini_BTCUSD_1h_17_12_17_to_10_03_23.csv,BTC_USD,HOUR,104622.73,7.804,01/12/2021 15:00:00,01/12/2021 16:00:00,01/12/2021 14:00:00,STOP_LOSS_HIT,SHORT,57709.0,57977.13,56904.63,57977.13,4.305,1.41,0.46,6277.3,2,3.0,-2092.49
17/02/2020 19:00:00,15/06/2023 18:58:18,Gemini_BTCUSD_1h_17_12_17_to_10_03_23.csv,BTC_USD,HOUR,102530.24,36.776,17/02/2020 20:00:00,17/02/2020 22:00:00,17/02/2020 22:00:00,EXPIRED,SHORT,9687.0,9630.0,9519.71,9742.76,3.475,1.76,0.57,6152.26,2,3.0,2096.23
27/10/2020 17:00:00,15/06/2023 18:58:18,Gemini_BTCUSD_1h_17_12_17_to_10_03_23.csv,BTC_USD,HOUR,104626.47,16.727,27/10/2020 20:00:00,27/10/2020 20:00:00,27/10/2020 18:00:00,STOP_LOSS_HIT,LONG,13706.0,13580.9,14081.32,13580.9,2.191,2.67,0.92,6277.98,2,3.0,-2092.55
24/02/2022 10:00:00,15/06/2023 18:58:18,Gemini_BTCUSD_1h_17_12_17_to_10_03_23.csv,BTC_USD,HOUR,102533.92,9.735,24/02/2022 13:00:00,24/02/2022 13:00:00,24/02/2022 11:00:00,STOP_LOSS_HIT,LONG,35201.0,34990.34,35832.99,34990.34,3.342,1.76,0.6,6152.42,2,3.0,-2050.78
30/10/2020 17:00:00,15/06/2023 18:58:18,Gemini_BTCUSD_1h_17_12_17_to_10_03_23.csv,BTC_USD,HOUR,100483.14,28.021,30/10/2020 19:00:00,30/10/2020 20:00:00,30/10/2020 20:00:00,EXPIRED,LONG,13548.0,13664.0,13763.17,13476.28,3.778,1.56,0.53,6029.28,2,3.0,3250.44
10/11/2021 18:00:00,15/06/2023 18:58:18,Gemini_BTCUSD_1h_17_12_17_to_10_03_23.csv,BTC_USD,HOUR,103733.58,6.161,10/11/2021 20:00:00,10/11/2021 21:00:00,10/11/2021 19:00:00,STOP_LOSS_HIT,LONG,67763.0,67426.28,68773.19,67426.28,4.025,1.47,0.5,6223.78,2,3.0,-2074.53
01/12/2020 00:00:00,15/06/2023 18:58:18,Gemini_BTCUSD_1h_17_12_17_to_10_03_23.csv,BTC_USD,HOUR,101659.05,6.652,01/12/2020 01:00:00,01/12/2020 03:00:00,01/12/2020 03:00:00,EXPIRED,LONG,19596.0,19437.0,20512.99,19290.34,1.282,4.47,1.58,6099.82,2,3.0,-1057.67
04/05/2022 10:00:00,15/06/2023 18:58:18,Gemini_BTCUSD_1h_17_12_17_to_10_03_23.csv,BTC_USD,HOUR,100601.38,3.859,04/05/2022 12:00:00,04/05/2022 13:00:00,04/05/2022 13:00:00,EXPIRED,LONG,38975.0,38699.0,40539.18,38453.61,1.495,3.86,1.36,6036.17,2,3.0,-1065.08
12/01/2021 07:00:00,15/06/2023 18:58:18,Gemini_BTCUSD_1h_17_12_17_to_10_03_23.csv,BTC_USD,HOUR,99536.3,3.047,12/01/2021 08:00:00,12/01/2021 10:00:00,12/01/2021 08:00:00,STOP_LOSS_HIT,LONG,36441.0,35787.66,38401.04,35787.66,1.116,5.1,1.83,5972.24,2,3.0,-1990.73
12/05/2019 01:00:00,15/06/2023 18:58:18,Gemini_BTCUSD_1h_17_12_17_to_10_03_23.csv,BTC_USD,HOUR,97545.57,51.68,12/05/2019 02:00:00,12/05/2019 04:00:00,12/05/2019 03:00:00,STOP_LOSS_HIT,LONG,7196.0,7158.25,7309.25,7158.25,3.812,1.55,0.53,5852.76,2,3.0,-1950.92
23/09/2018 06:00:00,15/06/2023 18:58:18,Gemini_BTCUSD_1h_17_12_17_to_10_03_23.csv,BTC_USD,HOUR,95594.65,17.729,23/09/2018 07:00:00,23/09/2018 09:00:00,23/09/2018 09:00:00,EXPIRED,LONG,6692.0,6760.0,7015.51,6584.16,1.241,4.61,1.64,5735.51,2,3.0,1205.57
13/10/2019 16:00:00,15/06/2023 18:58:18,Gemini_BTCUSD_1h_17_12_17_to_10_03_23.csv,BTC_USD,HOUR,96800.22,27.066,13/10/2019 20:00:00,13/10/2019 19:00:00,13/10/2019 19:00:00,EXPIRED,LONG,8438.0,8445.0,8652.58,8366.47,2.359,2.48,0.85,5807.82,2,3.0,189.46
15/07/2018 09:00:00,15/06/2023 18:58:18,Gemini_BTCUSD_1h_17_12_17_to_10_03_23.csv,BTC_USD,HOUR,96989.68,59.87,15/07/2018 13:00:00,15/07/2018 12:00:00,15/07/2018 12:00:00,EXPIRED,LONG,6305.0,6334.0,6402.19,6272.6,3.892,1.52,0.52,5818.77,2,3.0,1736.23
22/12/2017 19:00:00,15/06/2023 18:58:18,Gemini_BTCUSD_1h_17_12_17_to_10_03_23.csv,BTC_USD,HOUR,98725.91,22.233,22/12/2017 21:00:00,22/12/2017 22:00:00,22/12/2017 20:00:00,STOP_LOSS_HIT,LONG,13309.0,13220.19,13575.44,13220.19,2.997,1.96,0.67,5923.76,2,3.0,-1974.51
17/08/2020 14:00:00,15/06/2023 18:58:18,Gemini_BTCUSD_1h_17_12_17_to_10_03_23.csv,BTC_USD,HOUR,96751.4,12.94,17/08/2020 15:00:00,17/08/2020 17:00:00,17/08/2020 15:00:00,STOP_LOSS_HIT,SHORT,12178.0,12327.54,11729.39,12327.54,1.629,3.82,1.21,5805.01,2,3.0,-1935.05
28/06/2019 04:00:00,15/06/2023 18:58:18,Gemini_BTCUSD_1h_17_12_17_to_10_03_23.csv,BTC_USD,HOUR,94816.35,30.625,28/06/2019 07:00:00,28/06/2019 07:00:00,28/06/2019 05:00:00,STOP_LOSS_HIT,LONG,11026.0,10964.08,11211.76,10964.08,3.561,1.66,0.56,5688.9,2,3.0,-1896.3
31/08/2019 19:00:00,15/06/2023 18:58:18,Gemini_BTCUSD_1h_17_12_17_to_10_03_23.csv,BTC_USD,HOUR,92920.05,33.814,31/08/2019 22:00:00,31/08/2019 22:00:00,31/08/2019 20:00:00,STOP_LOSS_HIT,LONG,9584.0,9529.04,9748.87,9529.04,3.488,1.69,0.58,5574.91,2,3.0,-1858.42
30/10/2019 23:00:00,15/06/2023 18:58:18,Gemini_BTCUSD_1h_17_12_17_to_10_03_23.csv,BTC_USD,HOUR,91061.63,38.141,31/10/2019 00:00:00,31/10/2019 02:00:00,31/10/2019 02:00:00,EXPIRED,SHORT,9171.0,9101.0,9027.76,9218.75,3.841,1.59,0.52,5463.32,2,3.0,2669.87
29/12/2018 00:00:00,15/06/2023 18:58:18,Gemini_BTCUSD_1h_17_12_17_to_10_03_23.csv,BTC_USD,HOUR,93731.5,37.239,29/12/2018 02:00:00,29/12/2018 03:00:00,29/12/2018 03:00:00,EXPIRED,SHORT,3894.0,3884.0,3742.97,3944.34,1.547,4.04,1.28,5624.21,2,3.0,372.39
18/03/2020 17:00:00,15/06/2023 18:58:18,Gemini_BTCUSD_1h_17_12_17_to_10_03_23.csv,BTC_USD,HOUR,94103.89,34.176,18/03/2020 21:00:00,18/03/2020 20:00:00,18/03/2020 18:00:00,STOP_LOSS_HIT,SHORT,5244.0,5299.07,5078.8,5299.07,1.904,3.25,1.04,5645.88,2,3.0,-1882.07
18/05/2021 02:00:00,15/06/2023 18:58:18,Gemini_BTCUSD_1h_17_12_17_to_10_03_23.csv,BTC_USD,HOUR,92221.82,2.282,18/05/2021 03:00:00,18/05/2021 05:00:00,18/05/2021 05:00:00,EXPIRED,LONG,45034.0,45402.0,47458.85,44225.72,1.114,5.11,1.83,5533.51,2,3.0,839.78
01/03/2023 16:00:00,15/06/2023 18:58:18,Gemini_BTCUSD_1h_17_12_17_to_10_03_23.csv,BTC_USD,HOUR,93061.6,6.011,01/03/2023 20:00:00,01/03/2023 19:00:00,01/03/2023 19:00:00,EXPIRED,SHORT,23691.0,23360.0,22762.14,24000.62,1.53,4.08,1.29,5583.38,2,3.0,1989.64
10/07/2019 12:00:00,15/06/2023 18:58:18,Gemini_BTCUSD_1h_17_12_17_to_10_03_23.csv,BTC_USD,HOUR,95051.24,8.285,10/07/2019 13:00:00,10/07/2019 15:00:00,10/07/2019 14:00:00,STOP_LOSS_HIT,LONG,13058.0,12828.56,13746.33,12828.56,1.138,5.01,1.79,5702.81,2,3.0,-1900.91
11/05/2019 11:00:00,15/06/2023 18:58:18,Gemini_BTCUSD_1h_17_12_17_to_10_03_23.csv,BTC_USD,HOUR,93150.33,55.745,11/05/2019 14:00:00,11/05/2019 14:00:00,11/05/2019 13:00:00,STOP_LOSS_HIT,SHORT,6779.0,6812.42,6678.75,6812.42,4.057,1.5,0.49,5588.44,2,3.0,-1863.0
27/01/2020 13:00:00,15/06/2023 18:58:18,Gemini_BTCUSD_1h_17_12_17_to_10_03_23.csv,BTC_USD,HOUR,91287.33,14.062,27/01/2020 14:00:00,27/01/2020 16:00:00,27/01/2020 16:00:00,EXPIRED,LONG,8713.0,8767.0,9102.53,8583.16,1.342,4.28,1.51,5477.57,2,3.0,759.35
22/06/2021 20:00:00,15/06/2023 18:58:18,Gemini_BTCUSD_1h_17_12_17_to_10_03_23.csv,BTC_USD,HOUR,92046.68,9.74,23/06/2021 00:00:00,22/06/2021 23:00:00,22/06/2021 21:00:00,STOP_LOSS_HIT,LONG,32913.0,32724.0,33480.01,32724.0,3.483,1.69,0.58,5522.68,2,3.0,-1840.86
03/07/2019 05:00:00,15/06/2023 18:58:18,Gemini_BTCUSD_1h_17_12_17_to_10_03_23.csv,BTC_USD,HOUR,90205.82,26.975,03/07/2019 09:00:00,03/07/2019 08:00:00,03/07/2019 06:00:00,STOP_LOSS_HIT,LONG,11484.0,11417.12,11684.63,11417.12,3.434,1.72,0.59,5411.99,2,3.0,-1804.09
31/12/2019 00:00:00,15/06/2023 18:58:18,Gemini_BTCUSD_1h_17_12_17_to_10_03_23.csv,BTC_USD,HOUR,88401.73,46.102,31/12/2019 01:00:00,31/12/2019 03:00:00,31/12/2019 03:00:00,EXPIRED,LONG,7225.0,7211.0,7340.04,7186.65,3.768,1.57,0.53,5303.57,2,3.0,-645.43
24/01/2023 17:00:00,15/06/2023 18:58:18,Gemini_BTCUSD_1h_17_12_17_to_10_03_23.csv,BTC_USD,HOUR,87756.3,5.316,24/01/2023 18:00:00,24/01/2023 20:00:00,24/01/2023 20:00:00,EXPIRED,LONG,22913.0,23030.0,23903.5,22582.84,1.388,4.14,1.46,5265.5,2,3.0,621.97
22/06/2020 15:00:00,15/06/2023 18:58:18,Gemini_BTCUSD_1h_17_12_17_to_10_03_23.csv,BTC_USD,HOUR,88378.27,14.042,22/06/2020 16:00:00,22/06/2020 18:00:00,22/06/2020 18:00:00,EXPIRED,LONG,9498.0,9582.0,9875.65,9372.12,1.509,3.82,1.34,5302.96,2,3.0,1179.53
12/08/2018 12:00:00,15/06/2023 18:58:18,Gemini_BTCUSD_1h_17_12_17_to_10_03_23.csv,BTC_USD,HOUR,89557.8,15.684,12/08/2018 13:00:00,12/08/2018 15:00:00,12/08/2018 15:00:00,EXPIRED,LONG,6261.0,6323.0,6603.61,6146.8,1.096,5.19,1.86,5373.5,2,3.0,972.41
02/02/2019 14:00:00,15/06/2023 18:58:18,Gemini_BTCUSD_1h_17_12_17_to_10_03_23.csv,BTC_USD,HOUR,90530.21,85.933,02/02/2019 18:00:00,02/02/2019 17:00:00,02/02/2019 17:00:00,EXPIRED,LONG,3440.0,3433.0,3503.22,3418.93,3.265,1.8,0.62,5432.68,2,3.0,-601.53
23/08/2019 08:00:00,15/06/2023 18:58:18,Gemini_BTCUSD_1h_17_12_17_to_10_03_23.csv,BTC_USD,HOUR,89928.68,14.231,23/08/2019 10:00:00,23/08/2019 11:00:00,23/08/2019 11:00:00,EXPIRED,LONG,10177.0,10145.0,10556.14,10050.62,1.61,3.59,1.26,5395.54,2,3.0,-455.39
23/01/2018 04:00:00,15/06/2023 18:58:18,Gemini_BTCUSD_1h_17_12_17_to_10_03_23.csv,BTC_USD,HOUR,89473.29,31.538,23/01/2018 08:00:00,23/01/2018 07:00:00,23/01/2018 05:00:00,TAKE_PROFIT_HIT,SHORT,10590.0,10419.78,10419.78,10646.74,3.733,1.63,0.53,5368.4,2,3.0,5368.4
03/01/2020 05:00:00,15/06/2023 18:58:18,Gemini_BTCUSD_1h_17_12_17_to_10_03_23.csv,BTC_USD,HOUR,94841.69,19.098,03/01/2020 06:00:00,03/01/2020 08:00:00,03/01/2020 08:00:00,EXPIRED,SHORT,7193.0,7242.0,6895.05,7292.32,1.448,4.32,1.36,5690.25,2,3.0,-935.8
03/09/2020 01:00:00,15/06/2023 18:58:18,Gemini_BTCUSD_1h_17_12_17_to_10_03_23.csv,BTC_USD,HOUR,93905.89,18.418,03/09/2020 05:00:00,03/09/2020 04:00:00,03/09/2020 04:00:00,EXPIRED,SHORT,11441.0,11295.0,11135.1,11542.97,2.244,2.75,0.88,5634.07,2,3.0,2689.03
10/08/2021 12:00:00,15/06/2023 18:58:18,Gemini_BTCUSD_1h_17_12_17_to_10_03_23.csv,BTC_USD,HOUR,96594.92,7.591,10/08/2021 14:00:00,10/08/2021 15:00:00,10/08/2021 13:00:00,STOP_LOSS_HIT,LONG,45952.0,45697.5,46715.51,45697.5,3.611,1.63,0.56,5795.8,2,3.0,-1931.91
15/11/2022 14:00:00,15/06/2023 18:58:18,Gemini_BTCUSD_1h_17_12_17_to_10_03_23.csv,BTC_USD,HOUR,94663.01,16.127,15/11/2022 16:00:00,15/11/2022 17:00:00,15/11/2022 17:00:00,EXPIRED,LONG,16920.0,16992.0,17272.2,16802.6,2.883,2.04,0.7,5679.93,2,3.0,1161.14
06/10/2019 01:00:00,15/06/2023 18:58:18,Gemini_BTCUSD_1h_17_12_17_to_10_03_23.csv,BTC_USD,HOUR,95824.15,26.548,06/10/2019 02:00:00,06/10/2019 04:00:00,06/10/2019 04:00:00,EXPIRED,LONG,8075.0,8095.0,8291.56,8002.81,2.237,2.61,0.9,5749.23,2,3.0,530.96
04/10/2018 18:00:00,15/06/2023 18:58:18,Gemini_BTCUSD_1h_17_12_17_to_10_03_23.csv,BTC_USD,HOUR,96355.11,24.773,04/10/2018 19:00:00,04/10/2018 21:00:00,04/10/2018 21:00:00,EXPIRED,LONG,6558.0,6545.0,6791.37,6480.21,1.686,3.44,1.2,5781.28,2,3.0,-322.05
07/07/2020 00:00:00,15/06/2023 18:58:18,Gemini_BTCUSD_1h_17_12_17_to_10_03_23.csv,BTC_USD,HOUR,96033.06,24.618,07/07/2020 01:00:00,07/07/2020 03:00:00,07/07/2020 03:00:00,EXPIRED,SHORT,9335.0,9301.0,9100.93,9413.02,2.393,2.57,0.83,5762.34,2,3.0,837.01
23/01/2023 19:00:00,15/06/2023 18:58:18,Gemini_BTCUSD_1h_17_12_17_to_10_03_23.csv,BTC_USD,HOUR,96870.07,5.346,23/01/2023 20:00:00,23/01/2023 22:00:00,23/01/2023 22:00:00,EXPIRED,LONG,22799.0,22927.0,23886.26,22436.58,1.258,4.55,1.62,5812.49,2,3.0,684.29
18/12/2017 00:00:00,15/06/2023 18:58:18,Gemini_BTCUSD_1h_17_12_17_to_10_03_23.csv,BTC_USD,HOUR,97554.36,11.55,18/12/2017 04:00:00,18/12/2017 03:00:00,18/12/2017 01:00:00,STOP_LOSS_HIT,SHORT,18230.0,18398.93,17723.21,18398.93,2.158,2.86,0.92,5853.42,2,3.0,-1951.14
11/08/2019 23:00:00,15/06/2023 18:58:18,Gemini_BTCUSD_1h_17_12_17_to_10_03_23.csv,BTC_USD,HOUR,95603.22,13.977,12/08/2019 00:00:00,12/08/2019 02:00:00,12/08/2019 02:00:00,EXPIRED,LONG,11527.0,11436.0,11937.4,11390.2,1.685,3.44,1.2,5736.16,2,3.0,-1271.91
14/01/2019 18:00:00,15/06/2023 18:58:18,Gemini_BTCUSD_1h_17_12_17_to_10_03_23.csv,BTC_USD,HOUR,94331.31,88.992,14/01/2019 19:00:00,14/01/2019 21:00:00,14/01/2019 21:00:00,STOP_LOSS_HIT,LONG,3675.0,3653.8,3738.61,3653.8,3.467,1.7,0.58,5660.78,2,3.0,-1886.63
16/03/2019 00:00:00,15/06/2023 18:58:18,Gemini_BTCUSD_1h_17_12_17_to_10_03_23.csv,BTC_USD,HOUR,92444.68,35.487,16/03/2019 02:00:00,16/03/2019 03:00:00,16/03/2019 03:00:00,EXPIRED,LONG,3917.0,3955.0,4073.29,3864.9,1.504,3.84,1.35,5546.26,2,3.0,1348.51
05/10/2020 23:00:00,15/06/2023 18:58:18,Gemini_BTCUSD_1h_17_12_17_to_10_03_23.csv,BTC_USD,HOUR,93793.19,32.601,06/10/2020 02:00:00,06/10/2020 02:00:00,06/10/2020 02:00:00,EXPIRED,LONG,10796.0,10768.0,10968.61,10738.46,3.753,1.57,0.54,5627.26,2,3.0,-912.83
28/11/2021 20:00:00,15/06/2023 18:58:18,Gemini_BTCUSD_1h_17_12_17_to_10_03_23.csv,BTC_USD,HOUR,92880.36,2.832,28/11/2021 21:00:00,28/11/2021 23:00:00,28/11/2021 23:00:00,TAKE_PROFIT_HIT,LONG,54962.0,56929.86,56929.86,54306.05,1.676,3.46,1.21,5572.98,2,3.0,5572.98
25/10/2020 14:00:00,15/06/2023 18:58:18,Gemini_BTCUSD_1h_17_12_17_to_10_03_23.csv,BTC_USD,HOUR,98453.34,25.645,25/10/2020 15:00:00,25/10/2020 17:00:00,25/10/2020 16:00:00,STOP_LOSS_HIT,LONG,13006.0,12929.22,13236.34,12929.22,3.388,1.74,0.59,5907.07,2,3.0,-1969.02
05/07/2022 02:00:00,15/06/2023 18:58:18,Gemini_BTCUSD_1h_17_12_17_to_10_03_23.csv,BTC_USD,HOUR,96484.32,5.746,05/07/2022 04:00:00,05/07/2022 05:00:00,05/07/2022 05:00:00,EXPIRED,LONG,20160.0,20271.0,21167.51,19824.16,1.201,4.76,1.69,5789.15,2,3.0,637.81
12/09/2018 14:00:00,15/06/2023 18:58:18,Gemini_BTCUSD_1h_17_12_17_to_10_03_23.csv,BTC_USD,HOUR,97122.13,22.271,12/09/2018 15:00:00,12/09/2018 17:00:00,12/09/2018 17:00:00,EXPIRED,LONG,6269.0,6273.0,6530.66,6181.78,1.438,4.01,1.41,5827.43,2,3.0,89.08
14/06/2021 07:00:00,15/06/2023 18:58:18,Gemini_BTCUSD_1h_17_12_17_to_10_03_23.csv,BTC_USD,HOUR,97211.21,2.458,14/06/2021 08:00:00,14/06/2021 10:00:00,14/06/2021 10:00:00,EXPIRED,LONG,39567.0,39345.0,41939.99,38776.01,1.0,5.66,2.04,5832.81,2,3.0,-545.68
24/12/2017 08:00:00,15/06/2023 18:58:18,Gemini_BTCUSD_1h_17_12_17_to_10_03_23.csv,BTC_USD,HOUR,96665.53,23.304,24/12/2017 09:00:00,24/12/2017 11:00:00,24/12/2017 09:00:00,STOP_LOSS_HIT,LONG,14526.0,14443.04,14774.87,14443.04,3.502,1.68,0.57,5799.67,2,3.0,-1933.3
31/05/2022 00:00:00,15/06/2023 18:58:18,Gemini_BTCUSD_1h_17_12_17_to_10_03_23.csv,BTC_USD,HOUR,94732.23,3.355,31/05/2022 01:00:00,31/05/2022 03:00:00,31/05/2022 03:00:00,EXPIRED,LONG,31554.0,31764.0,33248.13,30989.29,1.118,5.1,1.82,5683.81,2,3.0,704.55
31/05/2019 08:00:00,15/06/2023 18:58:18,Gemini_BTCUSD_1h_17_12_17_to_10_03_23.csv,BTC_USD,HOUR,95436.78,42.248,31/05/2019 10:00:00,31/05/2019 11:00:00,31/05/2019 11:00:00,STOP_LOSS_HIT,LONG,8273.0,8227.82,8408.56,8227.82,3.662,1.61,0.55,5727.14,2,3.0,-1908.76
31/07/2022 13:00:00,15/06/2023 18:58:18,Gemini_BTCUSD_1h_17_12_17_to_10_03_23.csv,BTC_USD,HOUR,93528.02,8.608,31/07/2022 14:00:00,31/07/2022 16:00:00,31/07/2022 16:00:00,EXPIRED,LONG,23727.0,23777.0,24378.89,23509.7,2.184,2.67,0.92,5611.47,2,3.0,430.4
02/11/2021 08:00:00,15/06/2023 18:58:18,Gemini_BTCUSD_1h_17_12_17_to_10_03_23.csv,BTC_USD,HOUR,93958.42,5.583,02/11/2021 09:00:00,02/11/2021 11:00:00,02/11/2021 09:00:00,TAKE_PROFIT_HIT,LONG,61611.0,62620.67,62620.67,61274.44,3.661,1.61,0.55,5636.99,2,3.0,5636.99
07/07/2021 11:00:00,15/06/2023 18:58:18,Gemini_BTCUSD_1h_17_12_17_to_10_03_23.csv,BTC_USD,HOUR,99595.41,10.053,07/07/2021 12:00:00,07/07/2021 14:00:00,07/07/2021 14:00:00,STOP_LOSS_HIT,LONG,34826.0,34627.86,35420.43,34627.86,3.515,1.68,0.57,5975.8,2,3.0,-1991.9
27/11/2021 06:00:00,15/06/2023 18:58:18,Gemini_BTCUSD_1h_17_12_17_to_10_03_23.csv,BTC_USD,HOUR,97603.51,2.633,27/11/2021 10:00:00,27/11/2021 09:00:00,27/11/2021 09:00:00,EXPIRED,LONG,54282.0,54634.0,56506.36,53540.55,1.464,3.94,1.38,5856.74,2,3.0,926.82
29/01/2023 06:00:00,15/06/2023 18:58:18,Gemini_BTCUSD_1h_17_12_17_to_10_03_23.csv,BTC_USD,HOUR,98530.33,8.41,29/01/2023 09:00:00,29/01/2023 09:00:00,29/01/2023 09:00:00,EXPIRED,SHORT,23206.0,23283.0,22503.04,23440.32,1.981,3.12,1.0,5911.89,2,3.0,-647.57
03/02/2018 15:00:00,15/06/2023 18:58:18,Gemini_BTCUSD_1h_17_12_17_to_10_03_23.csv,BTC_USD,HOUR,97882.76,16.804,03/02/2018 16:00:00,03/02/2018 18:00:00,03/02/2018 16:00:00,STOP_LOSS_HIT,LONG,9207.0,9090.5,9556.49,9090.5,1.581,3.66,1.28,5872.83,2,3.0,-1957.67
14/11/2020 21:00:00,15/06/2023 18:58:18,Gemini_BTCUSD_1h_17_12_17_to_10_03_23.csv,BTC_USD,HOUR,95925.09,14.201,14/11/2020 22:00:00,15/11/2020 00:00:00,15/11/2020 00:00:00,EXPIRED,LONG,16012.0,16063.0,16417.32,15876.9,2.37,2.47,0.85,5755.95,2,3.0,724.25
17/10/2018 03:00:00,15/06/2023 18:58:18,Gemini_BTCUSD_1h_17_12_17_to_10_03_23.csv,BTC_USD,HOUR,96649.34,27.403,17/10/2018 04:00:00,17/10/2018 06:00:00,17/10/2018 06:00:00,EXPIRED,LONG,6444.0,6435.0,6655.62,6373.46,1.827,3.18,1.11,5799.02,2,3.0,-246.63
16/07/2022 10:00:00,15/06/2023 18:58:18,Gemini_BTCUSD_1h_17_12_17_to_10_03_23.csv,BTC_USD,HOUR,96402.71,16.384,16/07/2022 12:00:00,16/07/2022 13:00:00,16/07/2022 13:00:00,EXPIRED,LONG,20628.0,20837.0,20981.05,20510.32,3.506,1.68,0.57,5784.37,2,3.0,3424.26
22/04/2020 09:00:00,15/06/2023 18:58:18,Gemini_BTCUSD_1h_17_12_17_to_10_03_23.csv,BTC_USD,HOUR,99826.97,22.999,22/04/2020 10:00:00,22/04/2020 12:00:00,22/04/2020 12:00:00,EXPIRED,LONG,6966.0,6975.0,7226.44,6879.19,1.605,3.6,1.26,5989.86,2,3.0,206.99
23/11/2019 15:00:00,15/06/2023 18:58:18,Gemini_BTCUSD_1h_17_12_17_to_10_03_23.csv,BTC_USD,HOUR,100033.96,54.102,23/11/2019 16:00:00,23/11/2019 18:00:00,23/11/2019 16:00:00,STOP_LOSS_HIT,LONG,7305.0,7268.02,7415.93,7268.02,3.951,1.5,0.51,6001.53,2,3.0,-2000.69
27/09/2018 12:00:00,15/06/2023 18:58:18,Gemini_BTCUSD_1h_17_12_17_to_10_03_23.csv,BTC_USD,HOUR,98033.27,27.783,27/09/2018 13:00:00,27/09/2018 15:00:00,27/09/2018 15:00:00,EXPIRED,LONG,6491.0,6481.0,6702.7,6420.43,1.84,3.16,1.1,5881.66,2,3.0,-277.83
22/05/2018 09:00:00,15/06/2023 18:58:18,Gemini_BTCUSD_1h_17_12_17_to_10_03_23.csv,BTC_USD,HOUR,97755.44,18.424,22/05/2018 11:00:00,22/05/2018 12:00:00,22/05/2018 12:00:00,EXPIRED,LONG,8230.0,8168.0,8548.36,8123.88,1.551,3.72,1.31,5865.46,2,3.0,-1142.29
12/03/2018 08:00:00,15/06/2023 18:58:18,Gemini_BTCUSD_1h_17_12_17_to_10_03_23.csv,BTC_USD,HOUR,96613.15,9.363,12/03/2018 09:00:00,12/03/2018 11:00:00,12/03/2018 11:00:00,EXPIRED,LONG,9530.0,9839.0,10149.11,9323.63,0.924,6.1,2.21,5796.73,2,3.0,2893.17
17/02/2023 19:00:00,15/06/2023 18:58:18,Gemini_BTCUSD_1h_17_12_17_to_10_03_23.csv,BTC_USD,HOUR,99506.32,4.041,17/02/2023 20:00:00,17/02/2023 22:00:00,17/02/2023 22:00:00,EXPIRED,LONG,24538.0,24701.0,26015.35,24045.55,0.997,5.68,2.05,5969.97,2,3.0,658.68
02/04/2020 10:00:00,15/06/2023 18:58:18,Gemini_BTCUSD_1h_17_12_17_to_10_03_23.csv,BTC_USD,HOUR,100165.0,16.46,02/04/2020 11:00:00,02/04/2020 13:00:00,02/04/2020 13:00:00,EXPIRED,LONG,6665.0,6653.0,7030.12,6543.29,1.095,5.19,1.86,6009.88,2,3.0,-197.52
06/01/2018 20:00:00,15/06/2023 18:58:18,Gemini_BTCUSD_1h_17_12_17_to_10_03_23.csv,BTC_USD,HOUR,99967.48,20.312,06/01/2018 21:00:00,06/01/2018 23:00:00,06/01/2018 21:00:00,STOP_LOSS_HIT,LONG,16849.0,16750.57,17144.3,16750.57,3.423,1.72,0.59,5998.13,2,3.0,-1999.31
08/03/2022 10:00:00,15/06/2023 18:58:18,Gemini_BTCUSD_1h_17_12_17_to_10_03_23.csv,BTC_USD,HOUR,97968.17,2.638,08/03/2022 11:00:00,08/03/2022 13:00:00,08/03/2022 13:00:00,EXPIRED,LONG,39068.0,38872.0,41296.38,38325.21,1.052,5.4,1.94,5878.47,2,3.0,-517.05
24/09/2020 07:00:00,15/06/2023 18:58:18,Gemini_BTCUSD_1h_17_12_17_to_10_03_23.csv,BTC_USD,HOUR,97451.12,36.899,24/09/2020 08:00:00,24/09/2020 10:00:00,24/09/2020 10:00:00,EXPIRED,LONG,10343.0,10381.0,10501.47,10290.18,3.916,1.51,0.51,5847.38,2,3.0,1402.16
17/02/2019 06:00:00,15/06/2023 18:58:18,Gemini_BTCUSD_1h_17_12_17_to_10_03_23.csv,BTC_USD,HOUR,98853.28,36.837,17/02/2019 08:00:00,17/02/2019 09:00:00,17/02/2019 09:00:00,EXPIRED,LONG,3596.0,3600.0,3757.02,3542.33,1.34,4.29,1.52,5931.49,2,3.0,147.35
12/04/2020 00:00:00,15/06/2023 18:58:19,Gemini_BTCUSD_1h_17_12_17_to_10_03_23.csv,BTC_USD,HOUR,99000.63,18.857,12/04/2020 01:00:00,12/04/2020 03:00:00,12/04/2020 03:00:00,EXPIRED,LONG,6878.0,6819.0,7193.01,6773.0,1.31,4.38,1.55,5940.14,2,3.0,-1112.56
20/11/2021 03:00:00,15/06/2023 18:58:19,Gemini_BTCUSD_1h_17_12_17_to_10_03_23.csv,BTC_USD,HOUR,97888.07,1.742,20/11/2021 04:00:00,20/11/2021 06:00:00,20/11/2021 06:00:00,EXPIRED,LONG,58597.0,58711.0,61968.64,57473.12,1.043,5.44,1.96,5873.4,2,3.0,198.59
21/12/2019 21:00:00,15/06/2023 18:58:19,Gemini_BTCUSD_1h_17_12_17_to_10_03_23.csv,BTC_USD,HOUR,98086.66,25.025,22/12/2019 00:00:00,22/12/2019 00:00:00,22/12/2019 00:00:00,EXPIRED,LONG,7136.0,7139.0,7371.16,7057.61,1.821,3.19,1.11,5884.88,2,3.0,75.07
22/04/2020 20:00:00,15/06/2023 18:58:19,Gemini_BTCUSD_1h_17_12_17_to_10_03_23.csv,BTC_USD,HOUR,98161.73,29.773,22/04/2020 21:00:00,22/04/2020 23:00:00,22/04/2020 23:00:00,EXPIRED,LONG,7122.0,7137.0,7319.82,7056.06,2.16,2.7,0.93,5889.69,2,3.0,446.6
15/06/2020 10:00:00,15/06/2023 18:58:19,Gemini_BTCUSD_1h_17_12_17_to_10_03_23.csv,BTC_USD,HOUR,98608.33,44.863,15/06/2020 11:00:00,15/06/2020 13:00:00,15/06/2020 13:00:00,EXPIRED,LONG,9076.0,9179.0,9207.87,9032.04,4.129,1.43,0.49,5916.08,2,3.0,4620.89
08/04/2022 19:00:00,15/06/2023 18:58:19,Gemini_BTCUSD_1h_17_12_17_to_10_03_23.csv,BTC_USD,HOUR,103229.22,8.919,08/04/2022 21:00:00,08/04/2022 22:00:00,08/04/2022 22:00:00,EXPIRED,SHORT,42742.0,42327.0,42047.61,42973.47,3.693,1.65,0.54,6193.26,2,3.0,3701.39
11/12/2022 19:00:00,15/06/2023 18:58:19,Gemini_BTCUSD_1h_17_12_17_to_10_03_23.csv,BTC_USD,HOUR,106930.61,8.721,11/12/2022 20:00:00,11/12/2022 22:00:00,11/12/2022 22:00:00,EXPIRED,LONG,17183.0,17114.0,17918.66,16937.78,1.401,4.11,1.45,6415.69,2,3.0,-601.75
02/03/2021 12:00:00,15/06/2023 18:58:19,Gemini_BTCUSD_1h_17_12_17_to_10_03_23.csv,BTC_USD,HOUR,106328.86,3.605,02/03/2021 13:00:00,02/03/2021 15:00:00,02/03/2021 15:00:00,EXPIRED,LONG,48869.0,48710.0,50638.74,48279.09,1.657,3.49,1.22,6379.91,2,3.0,-573.2
16/05/2018 17:00:00,15/06/2023 18:58:19,Gemini_BTCUSD_1h_17_12_17_to_10_03_23.csv,BTC_USD,HOUR,105755.66,23.897,16/05/2018 19:00:00,16/05/2018 20:00:00,16/05/2018 20:00:00,EXPIRED,LONG,8284.0,8293.0,8549.52,8195.49,1.872,3.11,1.08,6345.13,2,3.0,215.07
30/04/2021 14:00:00,15/06/2023 18:58:19,Gemini_BTCUSD_1h_17_12_17_to_10_03_23.csv,BTC_USD,HOUR,105970.73,6.738,30/04/2021 15:00:00,30/04/2021 17:00:00,30/04/2021 15:00:00,STOP_LOSS_HIT,SHORT,56021.0,56335.54,55077.39,56335.54,3.562,1.71,0.56,6358.04,2,3.0,-2119.37
16/11/2018 02:00:00,15/06/2023 18:58:19,Gemini_BTCUSD_1h_17_12_17_to_10_03_23.csv,BTC_USD,HOUR,103851.36,26.831,16/11/2018 03:00:00,16/11/2018 05:00:00,16/11/2018 05:00:00,EXPIRED,LONG,5557.0,5535.0,5789.23,5479.59,1.436,4.01,1.41,6230.96,2,3.0,-590.28
11/03/2021 13:00:00,15/06/2023 18:58:19,Gemini_BTCUSD_1h_17_12_17_to_10_03_23.csv,BTC_USD,HOUR,103261.08,3.216,11/03/2021 15:00:00,11/03/2021 16:00:00,11/03/2021 15:00:00,STOP_LOSS_HIT,LONG,56907.0,56264.84,58833.49,56264.84,1.772,3.27,1.14,6195.59,2,3.0,-2065.19
01/12/2018 04:00:00,15/06/2023 18:58:19,Gemini_BTCUSD_1h_17_12_17_to_10_03_23.csv,BTC_USD,HOUR,101195.89,60.943,01/12/2018 06:00:00,01/12/2018 07:00:00,01/12/2018 07:00:00,EXPIRED,LONG,3942.0,3941.0,4041.63,3908.79,2.374,2.47,0.85,6071.75,2,3.0,-60.94
19/05/2020 08:00:00,15/06/2023 18:58:19,Gemini_BTCUSD_1h_17_12_17_to_10_03_23.csv,BTC_USD,HOUR,101134.95,30.876,19/05/2020 11:00:00,19/05/2020 11:00:00,19/05/2020 11:00:00,STOP_LOSS_HIT,LONG,9795.0,9729.49,9991.53,9729.49,2.99,1.97,0.67,6068.06,2,3.0,-2022.69
31/10/2022 23:00:00,15/06/2023 18:58:19,Gemini_BTCUSD_1h_17_12_17_to_10_03_23.csv,BTC_USD,HOUR,99112.26,7.569,01/11/2022 00:00:00,01/11/2022 02:00:00,01/11/2022 02:00:00,EXPIRED,LONG,20496.0,20578.0,21281.68,20234.11,1.565,3.69,1.29,5946.81,2,3.0,620.66
30/10/2022 22:00:00,15/06/2023 18:58:19,Gemini_BTCUSD_1h_17_12_17_to_10_03_23.csv,BTC_USD,HOUR,99732.92,14.993,30/10/2022 23:00:00,31/10/2022 01:00:00,31/10/2022 01:00:00,EXPIRED,LONG,20589.0,20526.0,20988.11,20455.96,3.095,1.9,0.65,5983.86,2,3.0,-944.56
17/05/2020 18:00:00,15/06/2023 18:58:19,Gemini_BTCUSD_1h_17_12_17_to_10_03_23.csv,BTC_USD,HOUR,98788.36,27.241,17/05/2020 21:00:00,17/05/2020 21:00:00,17/05/2020 21:00:00,EXPIRED,LONG,9759.0,9769.0,9976.59,9686.47,2.691,2.18,0.75,5927.37,2,3.0,272.41
05/01/2018 15:00:00,15/06/2023 18:58:19,Gemini_BTCUSD_1h_17_12_17_to_10_03_23.csv,BTC_USD,HOUR,99060.77,11.496,05/01/2018 18:00:00,05/01/2018 18:00:00,05/01/2018 17:00:00,TAKE_PROFIT_HIT,LONG,16042.0,16559.02,16559.02,15869.66,1.862,3.12,1.09,5943.66,2,3.0,5943.66
09/03/2021 17:00:00,15/06/2023 18:58:19,Gemini_BTCUSD_1h_17_12_17_to_10_03_23.csv,BTC_USD,HOUR,105004.43,3.576,09/03/2021 21:00:00,09/03/2021 20:00:00,09/03/2021 20:00:00,STOP_LOSS_HIT,SHORT,53807.0,54394.23,52045.31,54394.23,1.832,3.38,1.08,6299.8,2,3.0,-2099.93
29/08/2022 18:00:00,15/06/2023 18:58:19,Gemini_BTCUSD_1h_17_12_17_to_10_03_23.csv,BTC_USD,HOUR,102904.5,7.47,29/08/2022 19:00:00,29/08/2022 21:00:00,29/08/2022 21:00:00,EXPIRED,LONG,20173.0,20212.0,20999.58,19897.48,1.464,3.94,1.38,6174.55,2,3.0,291.33
06/09/2020 17:00:00,15/06/2023 18:58:19,Gemini_BTCUSD_1h_17_12_17_to_10_03_23.csv,BTC_USD,HOUR,103195.83,41.328,06/09/2020 21:00:00,06/09/2020 20:00:00,06/09/2020 20:00:00,EXPIRED,LONG,10207.0,10230.0,10356.81,10157.06,4.088,1.45,0.49,6191.35,2,3.0,950.54
24/06/2019 19:00:00,15/06/2023 18:58:19,Gemini_BTCUSD_1h_17_12_17_to_10_03_23.csv,BTC_USD,HOUR,104146.37,15.309,24/06/2019 20:00:00,24/06/2019 22:00:00,24/06/2019 22:00:00,EXPIRED,LONG,10896.0,10997.0,11304.18,10759.94,1.602,3.61,1.26,6248.83,2,3.0,1546.21
14/10/2020 02:00:00,15/06/2023 18:58:19,Gemini_BTCUSD_1h_17_12_17_to_10_03_23.csv,BTC_USD,HOUR,105692.58,30.419,14/10/2020 04:00:00,14/10/2020 05:00:00,14/10/2020 05:00:00,EXPIRED,LONG,11436.0,11420.0,11644.47,11366.51,3.291,1.79,0.61,6341.45,2,3.0,-486.7
09/03/2023 12:00:00,15/06/2023 18:58:19,Gemini_BTCUSD_1h_17_12_17_to_10_03_23.csv,BTC_USD,HOUR,105205.88,20.621,09/03/2023 14:00:00,09/03/2023 15:00:00,09/03/2023 13:00:00,STOP_LOSS_HIT,SHORT,21605.0,21707.04,21298.87,21707.04,4.235,1.44,0.47,6312.71,2,3.0,-2104.17
23/03/2020 12:00:00,15/06/2023 18:58:19,Gemini_BTCUSD_1h_17_12_17_to_10_03_23.csv,BTC_USD,HOUR,103101.71,66.863,23/03/2020 16:00:00,23/03/2020 15:00:00,23/03/2020 13:00:00,STOP_LOSS_HIT,LONG,6348.0,6317.16,6440.54,6317.16,4.117,1.44,0.49,6187.5,2,3.0,-2062.05
15/05/2018 02:00:00,15/06/2023 18:58:19,Gemini_BTCUSD_1h_17_12_17_to_10_03_23.csv,BTC_USD,HOUR,101039.66,18.336,15/05/2018 06:00:00,15/05/2018 05:00:00,15/05/2018 05:00:00,EXPIRED,LONG,8676.0,8727.0,9006.63,8565.79,1.574,3.67,1.29,6062.43,2,3.0,935.14
20/09/2018 13:00:00,15/06/2023 18:58:19,Gemini_BTCUSD_1h_17_12_17_to_10_03_23.csv,BTC_USD,HOUR,101974.8,59.426,20/09/2018 14:00:00,20/09/2018 16:00:00,20/09/2018 16:00:00,EXPIRED,LONG,6418.0,6417.0,6520.95,6383.68,3.74,1.58,0.54,6117.91,2,3.0,-59.43
04/10/2018 19:00:00,15/06/2023 18:58:19,Gemini_BTCUSD_1h_17_12_17_to_10_03_23.csv,BTC_USD,HOUR,101915.37,59.513,04/10/2018 20:00:00,04/10/2018 22:00:00,04/10/2018 20:00:00,STOP_LOSS_HIT,LONG,6567.0,6532.75,6669.75,6532.75,3.835,1.54,0.52,6114.96,2,3.0,-2038.32
07/09/2021 05:00:00,15/06/2023 18:58:19,Gemini_BTCUSD_1h_17_12_17_to_10_03_23.csv,BTC_USD,HOUR,99877.05,7.924,07/09/2021 06:00:00,07/09/2021 08:00:00,07/09/2021 06:00:00,STOP_LOSS_HIT,LONG,52686.0,52433.92,53442.25,52433.92,4.18,1.42,0.48,5992.53,2,3.0,-1997.48
19/09/2018 04:00:00,15/06/2023 18:58:19,Gemini_BTCUSD_1h_17_12_17_to_10_03_23.csv,BTC_USD,HOUR,97879.57,22.858,19/09/2018 05:00:00,19/09/2018 07:00:00,19/09/2018 07:00:00,EXPIRED,LONG,6332.0,6348.0,6588.93,6246.36,1.479,3.9,1.37,5872.91,2,3.0,365.73
18/01/2023 14:00:00,15/06/2023 18:58:19,Gemini_BTCUSD_1h_17_12_17_to_10_03_23.csv,BTC_USD,HOUR,98245.3,6.952,18/01/2023 15:00:00,18/01/2023 17:00:00,18/01/2023 16:00:00,TAKE_PROFIT_HIT,SHORT,21422.0,20574.13,20574.13,21704.63,1.516,4.12,1.3,5894.39,2,3.0,5894.39
02/01/2020 11:00:00,15/06/2023 18:58:19,Gemini_BTCUSD_1h_17_12_17_to_10_03_23.csv,BTC_USD,HOUR,104139.69,24.666,02/01/2020 12:00:00,02/01/2020 14:00:00,02/01/2020 14:00:00,EXPIRED,LONG,7117.0,7118.0,7370.33,7032.56,1.686,3.44,1.2,6248.64,2,3.0,24.67
22/08/2020 09:00:00,15/06/2023 18:58:19,Gemini_BTCUSD_1h_17_12_17_to_10_03_23.csv,BTC_USD,HOUR,104164.36,17.233,22/08/2020 10:00:00,22/08/2020 12:00:00,22/08/2020 12:00:00,EXPIRED,LONG,11592.0,11596.0,11954.67,11471.11,1.918,3.03,1.05,6249.89,2,3.0,68.93
10/01/2021 10:00:00,15/06/2023 18:58:19,Gemini_BTCUSD_1h_17_12_17_to_10_03_23.csv,BTC_USD,HOUR,104233.29,9.648,10/01/2021 11:00:00,10/01/2021 13:00:00,10/01/2021 11:00:00,STOP_LOSS_HIT,LONG,40521.0,40304.93,41169.21,40304.93,3.751,1.57,0.54,6253.93,2,3.0,-2084.64
22/05/2022 10:00:00,15/06/2023 18:58:19,Gemini_BTCUSD_1h_17_12_17_to_10_03_23.csv,BTC_USD,HOUR,102148.65,212.386,22/05/2022 11:00:00,22/05/2022 13:00:00,22/05/2022 11:00:00,STOP_LOSS_HIT,SHORT,30142.0,30151.62,30113.14,30151.62,62.671,0.1,0.03,6129.46,2,3.0,-2043.15
21/07/2021 07:00:00,15/06/2023 18:58:19,Gemini_BTCUSD_1h_17_12_17_to_10_03_23.csv,BTC_USD,HOUR,100105.5,11.254,21/07/2021 08:00:00,21/07/2021 10:00:00,21/07/2021 09:00:00,TAKE_PROFIT_HIT,LONG,30836.0,31369.7,31369.7,30658.1,3.467,1.7,0.58,6006.26,2,3.0,6006.26
04/11/2022 10:00:00,15/06/2023 18:58:19,Gemini_BTCUSD_1h_17_12_17_to_10_03_23.csv,BTC_USD,HOUR,106111.76,16.879,04/11/2022 11:00:00,04/11/2022 13:00:00,04/11/2022 12:00:00,STOP_LOSS_HIT,LONG,20660.0,20534.27,21037.19,20534.27,3.286,1.79,0.61,6366.59,2,3.0,-2122.2
12/06/2018 09:00:00,15/06/2023 18:58:19,Gemini_BTCUSD_1h_17_12_17_to_10_03_23.csv,BTC_USD,HOUR,103989.56,46.622,12/06/2018 11:00:00,12/06/2018 12:00:00,12/06/2018 12:00:00,TAKE_PROFIT_HIT,SHORT,6850.0,6716.18,6716.18,6894.61,3.071,1.99,0.65,6238.96,2,3.0,6238.96
31/01/2020 23:00:00,15/06/2023 18:58:19,Gemini_BTCUSD_1h_17_12_17_to_10_03_23.csv,BTC_USD,HOUR,110228.52,13.325,01/02/2020 00:00:00,01/02/2020 02:00:00,01/02/2020 02:00:00,EXPIRED,LONG,9331.0,9431.0,9827.35,9165.55,1.128,5.05,1.81,6613.86,2,3.0,1332.5
12/04/2019 14:00:00,15/06/2023 18:58:19,Gemini_BTCUSD_1h_17_12_17_to_10_03_23.csv,BTC_USD,HOUR,111561.02,47.092,12/04/2019 16:00:00,12/04/2019 17:00:00,12/04/2019 17:00:00,EXPIRED,SHORT,5085.0,5075.0,4942.87,5132.38,2.146,2.88,0.92,6693.19,2,3.0,470.92
06/11/2018 07:00:00,15/06/2023 18:58:19,Gemini_BTCUSD_1h_17_12_17_to_10_03_23.csv,BTC_USD,HOUR,112031.94,21.26,06/11/2018 11:00:00,06/11/2018 10:00:00,06/11/2018 10:00:00,EXPIRED,LONG,6389.0,6407.0,6705.18,6283.61,1.212,4.72,1.68,6721.99,2,3.0,382.68
01/01/2021 06:00:00,15/06/2023 18:58:19,Gemini_BTCUSD_1h_17_12_17_to_10_03_23.csv,BTC_USD,HOUR,112414.62,9.146,01/01/2021 08:00:00,01/01/2021 09:00:00,01/01/2021 09:00:00,EXPIRED,SHORT,29211.0,29287.0,28473.59,29456.81,2.377,2.59,0.83,6744.35,2,3.0,-695.1
10/05/2022 03:00:00,15/06/2023 18:58:19,Gemini_BTCUSD_1h_17_12_17_to_10_03_23.csv,BTC_USD,HOUR,111719.52,5.162,10/05/2022 04:00:00,10/05/2022 06:00:00,10/05/2022 04:00:00,STOP_LOSS_HIT,LONG,31329.0,30896.14,32627.59,30896.14,1.448,3.98,1.4,6703.32,2,3.0,-2234.42
15/07/2019 19:00:00,15/06/2023 18:58:19,Gemini_BTCUSD_1h_17_12_17_to_10_03_23.csv,BTC_USD,HOUR,109485.1,13.611,15/07/2019 20:00:00,15/07/2019 22:00:00,15/07/2019 22:00:00,EXPIRED,LONG,10860.0,10931.0,11342.65,10699.12,1.35,4.26,1.5,6569.35,2,3.0,966.38
30/07/2022 15:00:00,15/06/2023 18:58:19,Gemini_BTCUSD_1h_17_12_17_to_10_03_23.csv,BTC_USD,HOUR,110451.48,10.04,30/07/2022 16:00:00,30/07/2022 18:00:00,30/07/2022 18:00:00,EXPIRED,LONG,24534.0,24524.0,25194.07,24313.98,2.23,2.62,0.9,6627.1,2,3.0,-100.4
21/02/2021 05:00:00,15/06/2023 18:58:19,Gemini_BTCUSD_1h_17_12_17_to_10_03_23.csv,BTC_USD,HOUR,110351.08,4.105,21/02/2021 06:00:00,21/02/2021 08:00:00,21/02/2021 07:00:00,STOP_LOSS_HIT,LONG,56600.0,56062.39,58212.83,56062.39,2.105,2.77,0.96,6620.67,2,3.0,-2206.89
06/12/2022 16:00:00,15/06/2023 18:58:19,Gemini_BTCUSD_1h_17_12_17_to_10_03_23.csv,BTC_USD,HOUR,108144.19,23.876,06/12/2022 17:00:00,06/12/2022 19:00:00,06/12/2022 19:00:00,EXPIRED,LONG,16988.0,16975.0,17259.76,16897.41,3.751,1.57,0.54,6488.54,2,3.0,-310.39
23/08/2019 05:00:00,15/06/2023 18:58:19,Gemini_BTCUSD_1h_17_12_17_to_10_03_23.csv,BTC_USD,HOUR,107833.8,18.309,23/08/2019 06:00:00,23/08/2019 08:00:00,23/08/2019 08:00:00,EXPIRED,LONG,10148.0,10177.0,10501.37,10030.21,1.723,3.36,1.17,6469.85,2,3.0,530.96
08/03/2022 11:00:00,15/06/2023 18:58:19,Gemini_BTCUSD_1h_17_12_17_to_10_03_23.csv,BTC_USD,HOUR,108364.76,2.708,08/03/2022 12:00:00,08/03/2022 14:00:00,08/03/2022 14:00:00,EXPIRED,LONG,38973.0,38768.0,41373.74,38172.76,0.974,5.8,2.1,6501.2,2,3.0,-555.14
13/01/2021 19:00:00,15/06/2023 18:58:19,Gemini_BTCUSD_1h_17_12_17_to_10_03_23.csv,BTC_USD,HOUR,107809.62,3.036,13/01/2021 20:00:00,13/01/2021 22:00:00,13/01/2021 22:00:00,EXPIRED,LONG,36000.0,37247.0,38130.41,35289.86,1.014,5.59,2.01,6467.92,2,3.0,3785.89
28/07/2019 17:00:00,15/06/2023 18:58:19,Gemini_BTCUSD_1h_17_12_17_to_10_03_23.csv,BTC_USD,HOUR,111595.51,15.261,28/07/2019 18:00:00,28/07/2019 20:00:00,28/07/2019 20:00:00,EXPIRED,LONG,9532.0,9513.0,9970.76,9385.75,1.304,4.4,1.56,6695.92,2,3.0,-289.96
02/07/2022 20:00:00,15/06/2023 18:58:19,Gemini_BTCUSD_1h_17_12_17_to_10_03_23.csv,BTC_USD,HOUR,111305.55,9.644,02/07/2022 21:00:00,02/07/2022 23:00:00,02/07/2022 23:00:00,EXPIRED,LONG,19238.0,19220.0,19930.51,19007.16,1.667,3.47,1.21,6678.57,2,3.0,-173.59
18/03/2021 01:00:00,15/06/2023 18:58:19,Gemini_BTCUSD_1h_17_12_17_to_10_03_23.csv,BTC_USD,HOUR,111131.96,7.992,18/03/2021 02:00:00,18/03/2021 04:00:00,18/03/2021 03:00:00,STOP_LOSS_HIT,LONG,59075.0,58796.9,59909.32,58796.9,4.248,1.39,0.47,6667.89,2,3.0,-2222.58
23/06/2018 05:00:00,15/06/2023 18:58:19,Gemini_BTCUSD_1h_17_12_17_to_10_03_23.csv,BTC_USD,HOUR,108909.38,65.215,23/06/2018 07:00:00,23/06/2018 08:00:00,23/06/2018 06:00:00,STOP_LOSS_HIT,LONG,6101.0,6067.6,6201.2,6067.6,3.653,1.62,0.55,6534.54,2,3.0,-2178.18
11/03/2020 19:00:00,15/06/2023 18:58:19,Gemini_BTCUSD_1h_17_12_17_to_10_03_23.csv,BTC_USD,HOUR,106731.2,54.164,11/03/2020 21:00:00,11/03/2020 22:00:00,11/03/2020 20:00:00,STOP_LOSS_HIT,SHORT,7830.0,7869.41,7711.79,7869.41,3.974,1.53,0.5,6402.73,2,3.0,-2134.6
21/12/2020 09:00:00,15/06/2023 18:58:19,Gemini_BTCUSD_1h_17_12_17_to_10_03_23.csv,BTC_USD,HOUR,104596.6,18.358,21/12/2020 13:00:00,21/12/2020 12:00:00,21/12/2020 10:00:00,TAKE_PROFIT_HIT,SHORT,23450.0,23108.17,23108.17,23563.95,4.116,1.48,0.48,6275.32,2,3.0,6275.32
02/12/2022 12:00:00,15/06/2023 18:58:19,Gemini_BTCUSD_1h_17_12_17_to_10_03_23.csv,BTC_USD,HOUR,110871.92,7.955,02/12/2022 13:00:00,02/12/2022 15:00:00,02/12/2022 15:00:00,EXPIRED,LONG,17042.0,16945.0,17878.24,16763.26,1.223,4.68,1.66,6652.29,2,3.0,-771.63
26/11/2022 04:00:00,15/06/2023 18:58:19,Gemini_BTCUSD_1h_17_12_17_to_10_03_23.csv,BTC_USD,HOUR,110100.29,7.379,26/11/2022 05:00:00,26/11/2022 07:00:00,26/11/2022 07:00:00,EXPIRED,LONG,16632.0,16581.0,17527.28,16333.57,1.115,5.11,1.83,6606.27,2,3.0,-376.33
06/12/2019 22:00:00,15/06/2023 18:58:19,Gemini_BTCUSD_1h_17_12_17_to_10_03_23.csv,BTC_USD,HOUR,109723.96,24.256,07/12/2019 01:00:00,07/12/2019 01:00:00,07/12/2019 01:00:00,EXPIRED,SHORT,7528.0,7524.0,7256.58,7618.47,1.664,3.74,1.19,6583.56,2,3.0,97.02
06/01/2021 16:00:00,15/06/2023 18:58:19,Gemini_BTCUSD_1h_17_12_17_to_10_03_23.csv,BTC_USD,HOUR,109820.98,10.927,06/01/2021 18:00:00,06/01/2021 19:00:00,06/01/2021 18:00:00,TAKE_PROFIT_HIT,LONG,34720.0,35323.03,35323.03,34518.99,3.455,1.71,0.58,6589.31,2,3.0,6589.31
24/05/2018 23:00:00,15/06/2023 18:58:19,Gemini_BTCUSD_1h_17_12_17_to_10_03_23.csv,BTC_USD,HOUR,116410.29,50.945,25/05/2018 02:00:00,25/05/2018 02:00:00,25/05/2018 02:00:00,EXPIRED,LONG,7572.0,7633.0,7709.1,7526.3,3.314,1.78,0.61,6984.56,2,3.0,3107.65
29/07/2022 00:00:00,15/06/2023 18:58:19,Gemini_BTCUSD_1h_17_12_17_to_10_03_23.csv,BTC_USD,HOUR,119517.94,7.857,29/07/2022 01:00:00,29/07/2022 03:00:00,29/07/2022 03:00:00,EXPIRED,LONG,23886.0,23921.0,24798.76,23581.75,1.57,3.68,1.29,7171.56,2,3.0,275.0
25/11/2022 22:00:00,15/06/2023 18:58:19,Gemini_BTCUSD_1h_17_12_17_to_10_03_23.csv,BTC_USD,HOUR,119792.94,12.785,26/11/2022 00:00:00,26/11/2022 01:00:00,26/11/2022 01:00:00,EXPIRED,LONG,16520.0,16631.0,17082.17,16332.61,1.763,3.29,1.15,7187.34,2,3.0,1419.14
20/11/2019 16:00:00,15/06/2023 18:58:19,Gemini_BTCUSD_1h_17_12_17_to_10_03_23.csv,BTC_USD,HOUR,121212.08,25.414,20/11/2019 18:00:00,20/11/2019 19:00:00,20/11/2019 19:00:00,EXPIRED,LONG,8112.0,8076.0,8398.17,8016.61,1.701,3.41,1.19,7272.72,2,3.0,-914.9
21/02/2020 06:00:00,15/06/2023 18:58:19,Gemini_BTCUSD_1h_17_12_17_to_10_03_23.csv,BTC_USD,HOUR,120297.18,26.416,21/02/2020 07:00:00,21/02/2020 09:00:00,21/02/2020 09:00:00,EXPIRED,LONG,9692.0,9673.0,9965.24,9600.92,2.128,2.74,0.95,7217.91,2,3.0,-501.9
27/05/2022 14:00:00,15/06/2023 18:58:19,Gemini_BTCUSD_1h_17_12_17_to_10_03_23.csv,BTC_USD,HOUR,119795.28,6.272,27/05/2022 16:00:00,27/05/2022 17:00:00,27/05/2022 17:00:00,STOP_LOSS_HIT,LONG,28759.0,28377.0,29905.02,28377.0,1.506,3.83,1.35,7187.84,2,3.0,-2395.9
06/12/2020 23:00:00,15/06/2023 18:58:19,Gemini_BTCUSD_1h_17_12_17_to_10_03_23.csv,BTC_USD,HOUR,117399.38,21.735,07/12/2020 01:00:00,07/12/2020 02:00:00,07/12/2020 01:00:00,STOP_LOSS_HIT,LONG,19380.0,19271.97,19704.1,19271.97,3.588,1.64,0.56,7044.31,2,3.0,-2348.03
24/06/2018 15:00:00,15/06/2023 18:58:19,Gemini_BTCUSD_1h_17_12_17_to_10_03_23.csv,BTC_USD,HOUR,115051.35,76.983,24/06/2018 18:00:00,24/06/2018 18:00:00,24/06/2018 16:00:00,TAKE_PROFIT_HIT,LONG,5780.0,5869.68,5869.68,5750.11,3.868,1.53,0.52,6903.84,2,3.0,6903.84
19/10/2018 04:00:00,15/06/2023 18:58:19,Gemini_BTCUSD_1h_17_12_17_to_10_03_23.csv,BTC_USD,HOUR,121955.19,77.456,19/10/2018 07:00:00,19/10/2018 07:00:00,19/10/2018 06:00:00,STOP_LOSS_HIT,LONG,6396.0,6364.51,6490.46,6364.51,4.062,1.46,0.49,7316.49,2,3.0,-2439.09
07/01/2020 22:00:00,15/06/2023 18:58:19,Gemini_BTCUSD_1h_17_12_17_to_10_03_23.csv,BTC_USD,HOUR,119516.1,54.849,08/01/2020 00:00:00,08/01/2020 01:00:00,07/01/2020 23:00:00,STOP_LOSS_HIT,SHORT,8049.0,8092.58,7918.26,8092.58,3.694,1.65,0.54,7170.96,2,3.0,-2390.32
31/08/2019 02:00:00,15/06/2023 18:58:19,Gemini_BTCUSD_1h_17_12_17_to_10_03_23.csv,BTC_USD,HOUR,117125.78,27.078,31/08/2019 03:00:00,31/08/2019 05:00:00,31/08/2019 05:00:00,EXPIRED,LONG,9625.0,9619.0,9884.54,9538.49,2.225,2.63,0.91,7027.82,2,3.0,-162.47
26/12/2019 16:00:00,15/06/2023 18:58:19,Gemini_BTCUSD_1h_17_12_17_to_10_03_23.csv,BTC_USD,HOUR,116963.31,15.715,26/12/2019 17:00:00,26/12/2019 19:00:00,26/12/2019 19:00:00,EXPIRED,LONG,7310.0,7287.0,7756.58,7161.14,0.982,5.76,2.08,7018.0,2,3.0,-361.44
17/01/2018 17:00:00,15/06/2023 18:58:19,Gemini_BTCUSD_1h_17_12_17_to_10_03_23.csv,BTC_USD,HOUR,116601.87,18.739,17/01/2018 18:00:00,17/01/2018 20:00:00,17/01/2018 19:00:00,STOP_LOSS_HIT,SHORT,10081.0,10205.45,9707.67,10205.45,1.62,3.85,1.22,6995.83,2,3.0,-2332.07
06/10/2018 01:00:00,15/06/2023 18:58:19,Gemini_BTCUSD_1h_17_12_17_to_10_03_23.csv,BTC_USD,HOUR,114269.8,23.529,06/10/2018 02:00:00,06/10/2018 04:00:00,06/10/2018 04:00:00,EXPIRED,LONG,6581.0,6567.0,6872.39,6483.87,1.355,4.24,1.5,6856.12,2,3.0,-329.41
25/06/2019 12:00:00,15/06/2023 18:58:19,Gemini_BTCUSD_1h_17_12_17_to_10_03_23.csv,BTC_USD,HOUR,113940.39,14.878,25/06/2019 14:00:00,25/06/2019 15:00:00,25/06/2019 15:00:00,EXPIRED,LONG,11199.0,11352.0,11658.5,11045.83,1.462,3.94,1.39,6836.44,2,3.0,2276.33
23/09/2021 18:00:00,15/06/2023 18:58:19,Gemini_BTCUSD_1h_17_12_17_to_10_03_23.csv,BTC_USD,HOUR,116216.72,15.408,23/09/2021 19:00:00,23/09/2021 21:00:00,23/09/2021 21:00:00,EXPIRED,SHORT,44759.0,44695.0,44306.46,44909.85,5.934,1.02,0.34,6972.74,2,3.0,986.11
02/05/2018 00:00:00,15/06/2023 18:58:19,Gemini_BTCUSD_1h_17_12_17_to_10_03_23.csv,BTC_USD,HOUR,117202.83,54.615,02/05/2018 03:00:00,02/05/2018 03:00:00,02/05/2018 03:00:00,EXPIRED,SHORT,9029.0,9032.0,8900.23,9071.92,4.207,1.45,0.47,7032.77,2,3.0,-163.84
20/11/2020 12:00:00,15/06/2023 18:58:19,Gemini_BTCUSD_1h_17_12_17_to_10_03_23.csv,BTC_USD,HOUR,117038.99,23.959,20/11/2020 16:00:00,20/11/2020 15:00:00,20/11/2020 14:00:00,STOP_LOSS_HIT,SHORT,18248.0,18345.7,17954.91,18345.7,3.736,1.63,0.53,7022.14,2,3.0,-2340.79
24/01/2023 17:00:00,15/06/2023 18:58:19,Gemini_BTCUSD_1h_17_12_17_to_10_03_23.csv,BTC_USD,HOUR,114698.2,6.948,24/01/2023 18:00:00,24/01/2023 20:00:00,24/01/2023 20:00:00,EXPIRED,LONG,22913.0,23030.0,23903.5,22582.84,1.388,4.14,1.46,6881.99,2,3.0,812.92
05/07/2019 13:00:00,15/06/2023 18:58:19,Gemini_BTCUSD_1h_17_12_17_to_10_03_23.csv,BTC_USD,HOUR,115511.12,23.003,05/07/2019 17:00:00,05/07/2019 16:00:00,05/07/2019 16:00:00,EXPIRED,LONG,11182.0,11167.0,11483.28,11081.57,2.227,2.62,0.91,6930.34,2,3.0,-345.04
09/06/2018 22:00:00,15/06/2023 18:58:19,Gemini_BTCUSD_1h_17_12_17_to_10_03_23.csv,BTC_USD,HOUR,115166.08,59.395,10/06/2018 00:00:00,10/06/2018 01:00:00,09/06/2018 23:00:00,STOP_LOSS_HIT,LONG,7593.0,7554.22,7709.35,7554.22,3.916,1.51,0.51,6910.61,2,3.0,-2303.34
30/03/2020 23:00:00,15/06/2023 18:58:19,Gemini_BTCUSD_1h_17_12_17_to_10_03_23.csv,BTC_USD,HOUR,112862.74,68.966,31/03/2020 01:00:00,31/03/2020 02:00:00,31/03/2020 01:00:00,TAKE_PROFIT_HIT,LONG,6407.0,6505.19,6505.19,6374.27,3.915,1.51,0.51,6771.77,2,3.0,6771.77
08/05/2019 12:00:00,15/06/2023 18:58:19,Gemini_BTCUSD_1h_17_12_17_to_10_03_23.csv,BTC_USD,HOUR,119634.51,36.743,08/05/2019 15:00:00,08/05/2019 15:00:00,08/05/2019 15:00:00,EXPIRED,LONG,5850.0,5891.0,6045.37,5784.88,1.797,3.23,1.13,7178.48,2,3.0,1506.46
13/09/2018 17:00:00,15/06/2023 18:58:19,Gemini_BTCUSD_1h_17_12_17_to_10_03_23.csv,BTC_USD,HOUR,121140.97,34.211,13/09/2018 18:00:00,13/09/2018 20:00:00,13/09/2018 20:00:00,STOP_LOSS_HIT,LONG,6502.0,6431.18,6714.45,6431.18,1.836,3.16,1.1,7268.13,2,3.0,-2422.82
11/07/2018 12:00:00,15/06/2023 18:58:19,Gemini_BTCUSD_1h_17_12_17_to_10_03_23.csv,BTC_USD,HOUR,118718.15,32.754,11/07/2018 13:00:00,11/07/2018 15:00:00,11/07/2018 15:00:00,EXPIRED,LONG,6366.0,6359.0,6583.48,6293.51,1.756,3.3,1.15,7123.34,2,3.0,-229.28
17/07/2021 19:00:00,15/06/2023 18:58:19,Gemini_BTCUSD_1h_17_12_17_to_10_03_23.csv,BTC_USD,HOUR,118488.87,12.477,17/07/2021 21:00:00,17/07/2021 22:00:00,17/07/2021 22:00:00,EXPIRED,SHORT,31851.0,31635.0,31281.22,32040.93,3.354,1.82,0.59,7109.15,2,3.0,2695.03
25/09/2020 08:00:00,15/06/2023 18:58:19,Gemini_BTCUSD_1h_17_12_17_to_10_03_23.csv,BTC_USD,HOUR,121183.9,28.747,25/09/2020 12:00:00,25/09/2020 11:00:00,25/09/2020 11:00:00,EXPIRED,SHORT,10608.0,10638.0,10355.07,10692.31,2.516,2.44,0.79,7270.98,2,3.0,-862.41
23/01/2023 12:00:00,15/06/2023 18:58:19,Gemini_BTCUSD_1h_17_12_17_to_10_03_23.csv,BTC_USD,HOUR,120321.49,9.469,23/01/2023 13:00:00,23/01/2023 15:00:00,23/01/2023 14:00:00,STOP_LOSS_HIT,LONG,22900.0,22645.85,23662.46,22645.85,1.802,3.22,1.12,7219.73,2,3.0,-2406.55
26/10/2018 13:00:00,15/06/2023 18:58:19,Gemini_BTCUSD_1h_17_12_17_to_10_03_23.csv,BTC_USD,HOUR,117914.94,29.104,26/10/2018 17:00:00,26/10/2018 16:00:00,26/10/2018 16:00:00,EXPIRED,SHORT,6386.0,6407.0,6142.91,6467.03,1.576,3.96,1.25,7074.89,2,3.0,-611.18
21/08/2021 00:00:00,15/06/2023 18:58:19,Gemini_BTCUSD_1h_17_12_17_to_10_03_23.csv,BTC_USD,HOUR,117303.76,4.556,21/08/2021 04:00:00,21/08/2021 03:00:00,21/08/2021 03:00:00,EXPIRED,SHORT,48938.0,48840.0,47393.04,49452.99,1.901,3.26,1.04,7038.84,2,3.0,446.49
10/12/2022 07:00:00,15/06/2023 18:58:19,Gemini_BTCUSD_1h_17_12_17_to_10_03_23.csv,BTC_USD,HOUR,117750.25,8.913,10/12/2022 08:00:00,10/12/2022 10:00:00,10/12/2022 10:00:00,EXPIRED,LONG,17161.0,17166.0,17953.66,16896.78,1.299,4.42,1.56,7064.98,2,3.0,44.57
13/12/2018 13:00:00,15/06/2023 18:58:19,Gemini_BTCUSD_1h_17_12_17_to_10_03_23.csv,BTC_USD,HOUR,117794.82,134.162,13/12/2018 16:00:00,13/12/2018 16:00:00,13/12/2018 14:00:00,STOP_LOSS_HIT,LONG,3395.0,3377.44,3447.67,3377.44,3.867,1.53,0.52,7066.31,2,3.0,-2355.88
03/10/2021 08:00:00,15/06/2023 18:58:19,Gemini_BTCUSD_1h_17_12_17_to_10_03_23.csv,BTC_USD,HOUR,115438.94,8.971,03/10/2021 10:00:00,03/10/2021 11:00:00,03/10/2021 11:00:00,EXPIRED,LONG,47840.0,48018.0,48612.09,47582.64,3.718,1.59,0.54,6926.42,2,3.0,1596.84
09/06/2022 12:00:00,15/06/2023 18:58:19,Gemini_BTCUSD_1h_17_12_17_to_10_03_23.csv,BTC_USD,HOUR,117035.78,12.475,09/06/2022 15:00:00,09/06/2022 15:00:00,09/06/2022 15:00:00,STOP_LOSS_HIT,SHORT,30076.0,30263.63,29513.12,30263.63,3.206,1.91,0.62,7021.93,2,3.0,-2340.68
17/04/2022 20:00:00,15/06/2023 18:58:19,Gemini_BTCUSD_1h_17_12_17_to_10_03_23.csv,BTC_USD,HOUR,114695.1,6.207,17/04/2022 21:00:00,17/04/2022 23:00:00,17/04/2022 23:00:00,STOP_LOSS_HIT,LONG,40273.0,39903.46,41381.63,39903.46,2.179,2.68,0.93,6881.27,2,3.0,-2293.73
13/12/2018 10:00:00,15/06/2023 18:58:19,Gemini_BTCUSD_1h_17_12_17_to_10_03_23.csv,BTC_USD,HOUR,112401.37,138.853,13/12/2018 14:00:00,13/12/2018 13:00:00,13/12/2018 11:00:00,STOP_LOSS_HIT,LONG,3384.0,3367.81,3432.57,3367.81,4.18,1.41,0.48,6744.09,2,3.0,-2248.03
13/07/2019 18:00:00,15/06/2023 18:58:19,Gemini_BTCUSD_1h_17_12_17_to_10_03_23.csv,BTC_USD,HOUR,110153.34,32.503,13/07/2019 20:00:00,13/07/2019 21:00:00,13/07/2019 19:00:00,STOP_LOSS_HIT,SHORT,11134.0,11201.78,10930.68,11201.78,3.285,1.86,0.61,6608.51,2,3.0,-2203.05
23/05/2019 16:00:00,15/06/2023 18:58:19,Gemini_BTCUSD_1h_17_12_17_to_10_03_23.csv,BTC_USD,HOUR,107950.29,31.445,23/05/2019 17:00:00,23/05/2019 19:00:00,23/05/2019 17:00:00,STOP_LOSS_HIT,LONG,7831.0,7762.34,8036.97,7762.34,2.281,2.56,0.88,6476.73,2,3.0,-2159.01
03/09/2021 12:00:00,15/06/2023 18:58:19,Gemini_BTCUSD_1h_17_12_17_to_10_03_23.csv,BTC_USD,HOUR,105791.28,3.202,03/09/2021 13:00:00,03/09/2021 15:00:00,03/09/2021 15:00:00,EXPIRED,LONG,50666.0,50588.0,52648.32,50005.23,1.534,3.77,1.32,6347.39,2,3.0,-249.76
31/03/2022 04:00:00,15/06/2023 18:58:19,Gemini_BTCUSD_1h_17_12_17_to_10_03_23.csv,BTC_USD,HOUR,105541.52,7.637,31/03/2022 08:00:00,31/03/2022 07:00:00,31/03/2022 07:00:00,EXPIRED,SHORT,47029.0,47193.0,46199.85,47305.39,3.403,1.79,0.58,6332.22,2,3.0,-1252.47
06/04/2019 06:00:00,15/06/2023 18:58:19,Gemini_BTCUSD_1h_17_12_17_to_10_03_23.csv,BTC_USD,HOUR,104289.05,30.687,06/04/2019 09:00:00,06/04/2019 09:00:00,06/04/2019 09:00:00,EXPIRED,LONG,5020.0,4985.0,5223.92,4952.03,1.477,3.9,1.37,6257.69,2,3.0,-1074.04
11/07/2019 01:00:00,15/06/2023 18:58:19,Gemini_BTCUSD_1h_17_12_17_to_10_03_23.csv,BTC_USD,HOUR,103215.01,12.46,11/07/2019 02:00:00,11/07/2019 04:00:00,11/07/2019 03:00:00,STOP_LOSS_HIT,LONG,11996.0,11830.32,12493.03,11830.32,1.448,3.98,1.4,6192.99,2,3.0,-2064.37
06/06/2018 22:00:00,15/06/2023 18:58:19,Gemini_BTCUSD_1h_17_12_17_to_10_03_23.csv,BTC_USD,HOUR,101150.64,18.458,06/06/2018 23:00:00,07/06/2018 01:00:00,07/06/2018 01:00:00,EXPIRED,LONG,7660.0,7720.0,7988.8,7550.4,1.398,4.12,1.45,6068.99,2,3.0,1107.48
27/09/2019 00:00:00,15/06/2023 18:58:19,Gemini_BTCUSD_1h_17_12_17_to_10_03_23.csv,BTC_USD,HOUR,102258.12,44.296,27/09/2019 04:00:00,27/09/2019 03:00:00,27/09/2019 03:00:00,STOP_LOSS_HIT,SHORT,7979.0,8025.17,7840.5,8025.17,3.456,1.77,0.58,6135.0,2,3.0,-2045.15
16/08/2018 10:00:00,15/06/2023 18:58:19,Gemini_BTCUSD_1h_17_12_17_to_10_03_23.csv,BTC_USD,HOUR,100212.97,17.958,16/08/2018 11:00:00,16/08/2018 13:00:00,16/08/2018 12:00:00,STOP_LOSS_HIT,LONG,6447.0,6335.39,6781.83,6335.39,1.155,4.94,1.76,6012.88,2,3.0,-2004.29
20/03/2022 00:00:00,15/06/2023 18:58:19,Gemini_BTCUSD_1h_17_12_17_to_10_03_23.csv,BTC_USD,HOUR,98208.68,5.068,20/03/2022 01:00:00,20/03/2022 03:00:00,20/03/2022 03:00:00,EXPIRED,LONG,42076.0,41970.0,43238.76,41688.42,2.171,2.69,0.93,5892.87,2,3.0,-537.21
04/04/2022 15:00:00,15/06/2023 18:58:19,Gemini_BTCUSD_1h_17_12_17_to_10_03_23.csv,BTC_USD,HOUR,97671.47,6.306,04/04/2022 16:00:00,04/04/2022 18:00:00,04/04/2022 17:00:00,STOP_LOSS_HIT,LONG,45633.0,45323.25,46562.26,45323.25,2.946,2.0,0.68,5859.91,2,3.0,-1953.28
26/08/2019 00:00:00,15/06/2023 18:58:19,Gemini_BTCUSD_1h_17_12_17_to_10_03_23.csv,BTC_USD,HOUR,95718.19,14.262,26/08/2019 01:00:00,26/08/2019 03:00:00,26/08/2019 03:00:00,STOP_LOSS_HIT,LONG,10509.0,10374.77,10911.68,10374.77,1.566,3.69,1.29,5743.02,2,3.0,-1914.39
11/11/2020 01:00:00,15/06/2023 18:58:19,Gemini_BTCUSD_1h_17_12_17_to_10_03_23.csv,BTC_USD,HOUR,93803.8,20.171,11/11/2020 02:00:00,11/11/2020 04:00:00,11/11/2020 02:00:00,STOP_LOSS_HIT,LONG,15456.0,15362.99,15735.04,15362.99,3.324,1.77,0.61,5628.52,2,3.0,-1876.1
27/12/2019 15:00:00,15/06/2023 18:58:19,Gemini_BTCUSD_1h_17_12_17_to_10_03_23.csv,BTC_USD,HOUR,91927.7,47.792,27/12/2019 19:00:00,27/12/2019 18:00:00,27/12/2019 16:00:00,STOP_LOSS_HIT,LONG,7215.0,7176.53,7330.42,7176.53,3.751,1.57,0.54,5516.15,2,3.0,-1838.56
09/03/2022 08:00:00,15/06/2023 18:58:19,Gemini_BTCUSD_1h_17_12_17_to_10_03_23.csv,BTC_USD,HOUR,90089.14,7.864,09/03/2022 10:00:00,09/03/2022 11:00:00,09/03/2022 11:00:00,STOP_LOSS_HIT,SHORT,42068.0,42297.11,41380.67,42297.11,3.672,1.66,0.54,5405.16,2,3.0,-1801.72
30/08/2021 20:00:00,15/06/2023 18:58:19,Gemini_BTCUSD_1h_17_12_17_to_10_03_23.csv,BTC_USD,HOUR,88287.42,4.342,30/08/2021 22:00:00,30/08/2021 23:00:00,30/08/2021 21:00:00,STOP_LOSS_HIT,LONG,48659.0,48252.34,49878.98,48252.34,2.393,2.45,0.84,5297.15,2,3.0,-1765.72
18/05/2020 01:00:00,15/06/2023 18:58:19,Gemini_BTCUSD_1h_17_12_17_to_10_03_23.csv,BTC_USD,HOUR,86521.7,37.238,18/05/2020 04:00:00,18/05/2020 04:00:00,18/05/2020 02:00:00,STOP_LOSS_HIT,LONG,9903.0,9856.53,10042.4,9856.53,4.262,1.39,0.47,5190.98,2,3.0,-1730.45
01/03/2022 23:00:00,15/06/2023 18:58:19,Gemini_BTCUSD_1h_17_12_17_to_10_03_23.csv,BTC_USD,HOUR,84791.25,3.507,02/03/2022 03:00:00,02/03/2022 02:00:00,02/03/2022 02:00:00,EXPIRED,SHORT,44441.0,44227.0,42990.23,44924.59,1.838,3.37,1.08,5087.85,2,3.0,750.5
14/02/2019 19:00:00,15/06/2023 18:58:19,Gemini_BTCUSD_1h_17_12_17_to_10_03_23.csv,BTC_USD,HOUR,85541.75,96.822,14/02/2019 20:00:00,14/02/2019 22:00:00,14/02/2019 22:00:00,EXPIRED,LONG,3574.0,3565.0,3627.03,3556.33,4.045,1.46,0.5,5134.47,2,3.0,-871.4
03/05/2019 08:00:00,15/06/2023 18:58:19,Gemini_BTCUSD_1h_17_12_17_to_10_03_23.csv,BTC_USD,HOUR,84670.35,20.04,03/05/2019 09:00:00,03/05/2019 11:00:00,03/05/2019 11:00:00,EXPIRED,LONG,5675.0,5701.0,5928.5,5590.5,1.343,4.28,1.51,5080.14,2,3.0,521.04
10/01/2021 16:00:00,15/06/2023 18:58:19,Gemini_BTCUSD_1h_17_12_17_to_10_03_23.csv,BTC_USD,HOUR,85191.39,7.485,10/01/2021 20:00:00,10/01/2021 19:00:00,10/01/2021 17:00:00,TAKE_PROFIT_HIT,SHORT,39319.0,38636.09,38636.09,39546.64,3.455,1.77,0.58,5111.58,2,3.0,5111.58
30/03/2018 08:00:00,15/06/2023 18:58:19,Gemini_BTCUSD_1h_17_12_17_to_10_03_23.csv,BTC_USD,HOUR,90302.97,17.528,30/03/2018 09:00:00,30/03/2018 11:00:00,30/03/2018 10:00:00,STOP_LOSS_HIT,LONG,7097.0,6993.96,7406.11,6993.96,1.378,4.17,1.47,5418.08,2,3.0,-1806.09
19/10/2021 08:00:00,15/06/2023 18:58:19,Gemini_BTCUSD_1h_17_12_17_to_10_03_23.csv,BTC_USD,HOUR,88496.88,2.12,19/10/2021 10:00:00,19/10/2021 11:00:00,19/10/2021 11:00:00,EXPIRED,SHORT,62517.0,62157.0,60012.58,63351.81,1.498,4.17,1.32,5309.37,2,3.0,763.2
17/04/2019 11:00:00,15/06/2023 18:58:19,Gemini_BTCUSD_1h_17_12_17_to_10_03_23.csv,BTC_USD,HOUR,89260.08,20.045,17/04/2019 13:00:00,17/04/2019 14:00:00,17/04/2019 14:00:00,EXPIRED,LONG,5245.0,5212.0,5512.18,5155.94,1.178,4.85,1.73,5355.62,2,3.0,-661.48
08/12/2022 13:00:00,15/06/2023 18:58:19,Gemini_BTCUSD_1h_17_12_17_to_10_03_23.csv,BTC_USD,HOUR,88598.6,20.372,08/12/2022 14:00:00,08/12/2022 16:00:00,08/12/2022 16:00:00,EXPIRED,LONG,16860.0,16958.0,17120.93,16773.02,3.877,1.52,0.52,5315.67,2,3.0,1996.46
09/07/2018 09:00:00,15/06/2023 18:58:19,Gemini_BTCUSD_1h_17_12_17_to_10_03_23.csv,BTC_USD,HOUR,90595.06,17.38,09/07/2018 11:00:00,09/07/2018 12:00:00,09/07/2018 12:00:00,EXPIRED,LONG,6683.0,6708.0,6995.75,6578.75,1.282,4.47,1.58,5435.59,2,3.0,434.5
12/01/2022 10:00:00,15/06/2023 18:58:19,Gemini_BTCUSD_1h_17_12_17_to_10_03_23.csv,BTC_USD,HOUR,91029.56,3.147,12/01/2022 13:00:00,12/01/2022 13:00:00,12/01/2022 13:00:00,EXPIRED,LONG,42801.0,43960.0,44536.79,42222.4,1.48,3.9,1.37,5462.53,2,3.0,3647.37
18/04/2020 13:00:00,15/06/2023 18:58:19,Gemini_BTCUSD_1h_17_12_17_to_10_03_23.csv,BTC_USD,HOUR,94676.93,18.226,18/04/2020 16:00:00,18/04/2020 16:00:00,18/04/2020 16:00:00,EXPIRED,LONG,7254.0,7201.0,7565.67,7150.11,1.396,4.12,1.45,5680.5,2,3.0,-965.98
14/02/2020 18:00:00,15/06/2023 18:58:19,Gemini_BTCUSD_1h_17_12_17_to_10_03_23.csv,BTC_USD,HOUR,93710.95,10.355,14/02/2020 19:00:00,14/02/2020 21:00:00,14/02/2020 21:00:00,EXPIRED,LONG,10355.0,10342.0,10897.96,10174.01,1.144,4.98,1.78,5622.35,2,3.0,-134.61
01/04/2021 21:00:00,15/06/2023 18:58:19,Gemini_BTCUSD_1h_17_12_17_to_10_03_23.csv,BTC_USD,HOUR,93576.34,3.789,02/04/2021 00:00:00,02/04/2021 00:00:00,02/04/2021 00:00:00,EXPIRED,LONG,58780.0,58612.0,60261.68,58286.11,2.38,2.46,0.85,5614.09,2,3.0,-636.55
25/01/2022 16:00:00,15/06/2023 18:58:19,Gemini_BTCUSD_1h_17_12_17_to_10_03_23.csv,BTC_USD,HOUR,92939.79,5.938,25/01/2022 18:00:00,25/01/2022 19:00:00,25/01/2022 17:00:00,STOP_LOSS_HIT,SHORT,36867.0,37180.02,35927.95,37180.02,2.355,2.61,0.84,5576.08,2,3.0,-1858.71
15/03/2018 02:00:00,15/06/2023 18:58:19,Gemini_BTCUSD_1h_17_12_17_to_10_03_23.csv,BTC_USD,HOUR,91081.08,45.586,15/03/2018 03:00:00,15/03/2018 05:00:00,15/03/2018 03:00:00,TAKE_PROFIT_HIT,LONG,7793.0,7912.88,7912.88,7753.04,3.9,1.51,0.52,5464.85,2,3.0,5464.85
17/08/2018 22:00:00,15/06/2023 18:58:19,Gemini_BTCUSD_1h_17_12_17_to_10_03_23.csv,BTC_USD,HOUR,96545.93,33.587,17/08/2018 23:00:00,18/08/2018 01:00:00,18/08/2018 00:00:00,STOP_LOSS_HIT,SHORT,6550.0,6607.49,6377.54,6607.49,2.279,2.7,0.87,5792.41,2,3.0,-1930.92
01/08/2021 22:00:00,15/06/2023 18:58:19,Gemini_BTCUSD_1h_17_12_17_to_10_03_23.csv,BTC_USD,HOUR,94615.01,3.598,01/08/2021 23:00:00,02/08/2021 01:00:00,01/08/2021 23:00:00,STOP_LOSS_HIT,LONG,40292.0,39766.06,41869.82,39766.06,1.532,3.77,1.32,5677.0,2,3.0,-1892.33
19/12/2018 04:00:00,15/06/2023 18:58:19,Gemini_BTCUSD_1h_17_12_17_to_10_03_23.csv,BTC_USD,HOUR,92722.68,35.828,19/12/2018 05:00:00,19/12/2018 07:00:00,19/12/2018 07:00:00,EXPIRED,LONG,3713.0,3708.0,3868.29,3661.24,1.435,4.01,1.41,5563.73,2,3.0,-179.14
26/09/2020 04:00:00,15/06/2023 18:58:19,Gemini_BTCUSD_1h_17_12_17_to_10_03_23.csv,BTC_USD,HOUR,92543.54,13.937,26/09/2020 07:00:00,26/09/2020 07:00:00,26/09/2020 07:00:00,EXPIRED,LONG,10741.0,10718.0,11139.39,10608.2,1.618,3.58,1.25,5552.36,2,3.0,-320.55
04/04/2021 15:00:00,15/06/2023 18:58:19,Gemini_BTCUSD_1h_17_12_17_to_10_03_23.csv,BTC_USD,HOUR,92222.99,5.638,04/04/2021 17:00:00,04/04/2021 18:00:00,04/04/2021 18:00:00,EXPIRED,LONG,57926.0,58136.0,58907.47,57598.85,3.541,1.67,0.57,5533.53,2,3.0,1183.98
27/10/2020 10:00:00,15/06/2023 18:58:19,Gemini_BTCUSD_1h_17_12_17_to_10_03_23.csv,BTC_USD,HOUR,93406.97,9.972,27/10/2020 11:00:00,27/10/2020 13:00:00,27/10/2020 13:00:00,EXPIRED,LONG,13275.0,13407.0,13837.0,13087.67,1.417,4.06,1.43,5604.26,2,3.0,1316.3
07/08/2019 09:00:00,15/06/2023 18:58:19,Gemini_BTCUSD_1h_17_12_17_to_10_03_23.csv,BTC_USD,HOUR,94723.27,20.443,07/08/2019 13:00:00,07/08/2019 12:00:00,07/08/2019 12:00:00,EXPIRED,LONG,11605.0,11768.0,11883.0,11512.33,2.505,2.34,0.8,5683.15,2,3.0,3332.21
28/05/2020 20:00:00,15/06/2023 18:58:19,Gemini_BTCUSD_1h_17_12_17_to_10_03_23.csv,BTC_USD,HOUR,98055.48,31.524,28/05/2020 23:00:00,28/05/2020 23:00:00,28/05/2020 23:00:00,EXPIRED,LONG,9449.0,9489.0,9635.62,9386.79,3.038,1.94,0.66,5883.01,2,3.0,1260.96
24/11/2019 23:00:00,15/06/2023 18:58:19,Gemini_BTCUSD_1h_17_12_17_to_10_03_23.csv,BTC_USD,HOUR,99316.44,58.182,25/11/2019 00:00:00,25/11/2019 02:00:00,25/11/2019 00:00:00,STOP_LOSS_HIT,LONG,6913.0,6878.86,7015.41,6878.86,4.05,1.46,0.5,5958.42,2,3.0,-1986.33
01/03/2022 14:00:00,15/06/2023 18:58:19,Gemini_BTCUSD_1h_17_12_17_to_10_03_23.csv,BTC_USD,HOUR,97330.11,3.625,01/03/2022 15:00:00,01/03/2022 17:00:00,01/03/2022 16:00:00,STOP_LOSS_HIT,LONG,43814.0,43277.01,45424.99,43277.01,1.632,3.55,1.24,5839.84,2,3.0,-1946.59
28/10/2020 00:00:00,15/06/2023 18:58:19,Gemini_BTCUSD_1h_17_12_17_to_10_03_23.csv,BTC_USD,HOUR,95383.52,16.373,28/10/2020 01:00:00,28/10/2020 03:00:00,28/10/2020 03:00:00,EXPIRED,LONG,13728.0,13803.0,14077.53,13611.49,2.356,2.48,0.86,5722.85,2,3.0,1227.98
05/05/2018 03:00:00,15/06/2023 18:58:19,Gemini_BTCUSD_1h_17_12_17_to_10_03_23.csv,BTC_USD,HOUR,96611.5,10.387,05/05/2018 04:00:00,05/05/2018 06:00:00,05/05/2018 06:00:00,EXPIRED,LONG,9814.0,9772.0,10372.1,9627.97,1.055,5.38,1.93,5796.98,2,3.0,-436.25
11/12/2021 12:00:00,15/06/2023 18:58:19,Gemini_BTCUSD_1h_17_12_17_to_10_03_23.csv,BTC_USD,HOUR,96175.25,2.432,11/12/2021 13:00:00,11/12/2021 15:00:00,11/12/2021 15:00:00,EXPIRED,LONG,48565.0,48784.0,50937.75,47774.08,1.228,4.66,1.66,5770.53,2,3.0,532.61
06/09/2021 23:00:00,15/06/2023 18:58:19,Gemini_BTCUSD_1h_17_12_17_to_10_03_23.csv,BTC_USD,HOUR,96707.86,2.419,07/09/2021 00:00:00,07/09/2021 02:00:00,07/09/2021 02:00:00,EXPIRED,LONG,52697.0,52742.0,55095.79,51897.4,1.318,4.35,1.54,5802.67,2,3.0,108.86
23/06/2021 22:00:00,15/06/2023 18:58:20,Gemini_BTCUSD_1h_17_12_17_to_10_03_23.csv,BTC_USD,HOUR,96816.72,12.524,24/06/2021 02:00:00,24/06/2021 01:00:00,23/06/2021 23:00:00,STOP_LOSS_HIT,SHORT,33498.0,33652.61,33034.18,33652.61,4.333,1.4,0.46,5808.88,2,3.0,-1936.34
23/08/2022 09:00:00,15/06/2023 18:58:20,Gemini_BTCUSD_1h_17_12_17_to_10_03_23.csv,BTC_USD,HOUR,94880.38,17.246,23/08/2022 10:00:00,23/08/2022 12:00:00,23/08/2022 10:00:00,STOP_LOSS_HIT,LONG,21467.0,21356.97,21797.08,21356.97,3.902,1.51,0.52,5692.56,2,3.0,-1897.58
04/07/2020 13:00:00,15/06/2023 18:58:20,Gemini_BTCUSD_1h_17_12_17_to_10_03_23.csv,BTC_USD,HOUR,92982.8,35.984,04/07/2020 16:00:00,04/07/2020 16:00:00,04/07/2020 16:00:00,EXPIRED,LONG,9083.0,9076.0,9238.03,9031.32,3.515,1.68,0.57,5578.6,2,3.0,-251.89
19/02/2023 14:00:00,15/06/2023 18:58:20,Gemini_BTCUSD_1h_17_12_17_to_10_03_23.csv,BTC_USD,HOUR,92730.91,14.655,19/02/2023 15:00:00,19/02/2023 17:00:00,19/02/2023 16:00:00,TAKE_PROFIT_HIT,LONG,24776.0,25155.65,25155.65,24649.45,3.916,1.51,0.51,5563.77,2,3.0,5563.77
02/07/2018 01:00:00,15/06/2023 18:58:20,Gemini_BTCUSD_1h_17_12_17_to_10_03_23.csv,BTC_USD,HOUR,98294.68,24.009,02/07/2018 04:00:00,02/07/2018 04:00:00,02/07/2018 04:00:00,EXPIRED,SHORT,6329.0,6303.0,6083.35,6410.88,1.546,4.04,1.28,5897.81,2,3.0,624.23
23/04/2020 10:00:00,15/06/2023 18:58:20,Gemini_BTCUSD_1h_17_12_17_to_10_03_23.csv,BTC_USD,HOUR,98918.91,25.396,23/04/2020 14:00:00,23/04/2020 13:00:00,23/04/2020 13:00:00,EXPIRED,LONG,7076.0,7251.0,7309.72,6998.1,1.817,3.2,1.11,5935.55,2,3.0,4444.3
26/05/2019 11:00:00,15/06/2023 18:58:20,Gemini_BTCUSD_1h_17_12_17_to_10_03_23.csv,BTC_USD,HOUR,103363.21,27.417,26/05/2019 12:00:00,26/05/2019 14:00:00,26/05/2019 14:00:00,EXPIRED,LONG,7930.0,8018.0,8156.19,7854.6,2.103,2.77,0.96,6201.45,2,3.0,2412.7
25/06/2020 12:00:00,15/06/2023 18:58:20,Gemini_BTCUSD_1h_17_12_17_to_10_03_23.csv,BTC_USD,HOUR,105775.91,38.881,25/06/2020 15:00:00,25/06/2020 15:00:00,25/06/2020 13:00:00,STOP_LOSS_HIT,SHORT,9173.0,9227.41,9009.76,9227.41,3.372,1.81,0.59,6346.93,2,3.0,-2115.52
04/12/2019 11:00:00,15/06/2023 18:58:20,Gemini_BTCUSD_1h_17_12_17_to_10_03_23.csv,BTC_USD,HOUR,103660.39,18.776,04/12/2019 12:00:00,04/12/2019 14:00:00,04/12/2019 13:00:00,TAKE_PROFIT_HIT,LONG,7204.0,7535.25,7535.25,7093.58,1.305,4.4,1.56,6219.55,2,3.0,6219.55
02/06/2022 06:00:00,15/06/2023 18:58:20,Gemini_BTCUSD_1h_17_12_17_to_10_03_23.csv,BTC_USD,HOUR,109879.94,12.604,02/06/2022 10:00:00,02/06/2022 09:00:00,02/06/2022 09:00:00,EXPIRED,LONG,29903.0,29888.0,30426.07,29728.64,3.43,1.72,0.59,6592.77,2,3.0,-189.06
10/07/2020 15:00:00,15/06/2023 18:58:20,Gemini_BTCUSD_1h_17_12_17_to_10_03_23.csv,BTC_USD,HOUR,109690.88,20.824,10/07/2020 16:00:00,10/07/2020 18:00:00,10/07/2020 18:00:00,EXPIRED,LONG,9245.0,9220.0,9561.06,9139.65,1.755,3.31,1.15,6581.63,2,3.0,-520.6
06/09/2018 14:00:00,15/06/2023 18:58:20,Gemini_BTCUSD_1h_17_12_17_to_10_03_23.csv,BTC_USD,HOUR,109170.28,24.489,06/09/2018 15:00:00,06/09/2018 17:00:00,06/09/2018 17:00:00,EXPIRED,LONG,6460.0,6374.0,6727.49,6370.84,1.449,3.98,1.4,6550.56,2,3.0,-2106.05
27/10/2021 06:00:00,15/06/2023 18:58:20,Gemini_BTCUSD_1h_17_12_17_to_10_03_23.csv,BTC_USD,HOUR,107064.23,4.186,27/10/2021 07:00:00,27/10/2021 09:00:00,27/10/2021 07:00:00,STOP_LOSS_HIT,LONG,60722.0,60210.44,62256.69,60210.44,2.374,2.47,0.85,6424.21,2,3.0,-2141.39
24/11/2018 13:00:00,15/06/2023 18:58:20,Gemini_BTCUSD_1h_17_12_17_to_10_03_23.csv,BTC_USD,HOUR,104922.84,62.828,24/11/2018 16:00:00,24/11/2018 16:00:00,24/11/2018 16:00:00,EXPIRED,SHORT,4245.0,4199.0,4144.81,4278.4,2.542,2.42,0.78,6294.74,2,3.0,2890.09
02/04/2022 05:00:00,15/06/2023 18:58:20,Gemini_BTCUSD_1h_17_12_17_to_10_03_23.csv,BTC_USD,HOUR,107812.93,3.326,02/04/2022 07:00:00,02/04/2022 08:00:00,02/04/2022 08:00:00,EXPIRED,SHORT,46564.0,46546.0,44619.09,47212.31,1.436,4.36,1.37,6468.77,2,3.0,59.87
01/03/2022 16:00:00,15/06/2023 18:58:20,Gemini_BTCUSD_1h_17_12_17_to_10_03_23.csv,BTC_USD,HOUR,107872.8,8.381,01/03/2022 19:00:00,01/03/2022 19:00:00,01/03/2022 17:00:00,STOP_LOSS_HIT,SHORT,43397.0,43654.42,42624.73,43654.42,3.372,1.81,0.59,6472.39,2,3.0,-2157.44
08/06/2020 01:00:00,15/06/2023 18:58:20,Gemini_BTCUSD_1h_17_12_17_to_10_03_23.csv,BTC_USD,HOUR,105715.36,36.624,08/06/2020 05:00:00,08/06/2020 04:00:00,08/06/2020 04:00:00,EXPIRED,SHORT,9748.0,9737.0,9574.82,9805.73,3.377,1.81,0.59,6342.54,2,3.0,402.86
09/11/2021 03:00:00,15/06/2023 18:58:20,Gemini_BTCUSD_1h_17_12_17_to_10_03_23.csv,BTC_USD,HOUR,106118.22,5.354,09/11/2021 06:00:00,09/11/2021 06:00:00,09/11/2021 06:00:00,EXPIRED,SHORT,68526.0,68054.0,67336.81,68922.4,3.457,1.77,0.58,6366.92,2,3.0,2527.09
22/09/2021 09:00:00,15/06/2023 18:58:20,Gemini_BTCUSD_1h_17_12_17_to_10_03_23.csv,BTC_USD,HOUR,108645.31,10.412,22/09/2021 10:00:00,22/09/2021 12:00:00,22/09/2021 10:00:00,STOP_LOSS_HIT,LONG,42391.0,42182.31,43017.08,42182.31,4.063,1.46,0.49,6518.74,2,3.0,-2172.88
04/12/2018 16:00:00,15/06/2023 18:58:20,Gemini_BTCUSD_1h_17_12_17_to_10_03_23.csv,BTC_USD,HOUR,106472.43,103.724,04/12/2018 20:00:00,04/12/2018 19:00:00,04/12/2018 17:00:00,STOP_LOSS_HIT,LONG,3941.0,3920.47,4002.6,3920.47,3.839,1.54,0.52,6389.4,2,3.0,-2129.45
20/09/2018 00:00:00,15/06/2023 18:58:20,Gemini_BTCUSD_1h_17_12_17_to_10_03_23.csv,BTC_USD,HOUR,104342.98,23.94,20/09/2018 04:00:00,20/09/2018 03:00:00,20/09/2018 03:00:00,EXPIRED,SHORT,6415.0,6401.0,6153.5,6502.17,1.472,4.25,1.34,6260.31,2,3.0,335.16
20/10/2020 05:00:00,15/06/2023 18:58:20,Gemini_BTCUSD_1h_17_12_17_to_10_03_23.csv,BTC_USD,HOUR,104678.14,10.671,20/10/2020 08:00:00,20/10/2020 08:00:00,20/10/2020 08:00:00,EXPIRED,LONG,11770.0,11751.0,12358.62,11573.8,1.2,4.76,1.7,6281.16,2,3.0,-202.75
08/03/2019 19:00:00,15/06/2023 18:58:20,Gemini_BTCUSD_1h_17_12_17_to_10_03_23.csv,BTC_USD,HOUR,104475.39,86.594,08/03/2019 21:00:00,08/03/2019 22:00:00,08/03/2019 21:00:00,STOP_LOSS_HIT,LONG,3897.0,3872.87,3969.38,3872.87,3.23,1.82,0.62,6267.67,2,3.0,-2089.51
02/02/2023 21:00:00,15/06/2023 18:58:20,Gemini_BTCUSD_1h_17_12_17_to_10_03_23.csv,BTC_USD,HOUR,102385.88,14.366,03/02/2023 01:00:00,03/02/2023 00:00:00,02/02/2023 22:00:00,STOP_LOSS_HIT,SHORT,23468.0,23610.54,23040.38,23610.54,3.293,1.86,0.6,6143.19,2,3.0,-2047.73
23/09/2021 10:00:00,15/06/2023 18:58:20,Gemini_BTCUSD_1h_17_12_17_to_10_03_23.csv,BTC_USD,HOUR,100338.15,7.541,23/09/2021 13:00:00,23/09/2021 13:00:00,23/09/2021 13:00:00,STOP_LOSS_HIT,SHORT,43793.0,44059.12,42994.64,44059.12,3.291,1.86,0.6,6020.43,2,3.0,-2006.81
03/01/2019 10:00:00,15/06/2023 18:58:20,Gemini_BTCUSD_1h_17_12_17_to_10_03_23.csv,BTC_USD,HOUR,98331.34,104.496,03/01/2019 12:00:00,03/01/2019 13:00:00,03/01/2019 13:00:00,EXPIRED,SHORT,3835.0,3847.0,3778.54,3853.82,4.075,1.49,0.49,5899.84,2,3.0,-1253.95
29/01/2022 09:00:00,15/06/2023 18:58:20,Gemini_BTCUSD_1h_17_12_17_to_10_03_23.csv,BTC_USD,HOUR,97077.39,2.787,29/01/2022 11:00:00,29/01/2022 12:00:00,29/01/2022 12:00:00,EXPIRED,LONG,37729.0,37877.0,39818.87,37032.38,1.083,5.25,1.88,5824.47,2,3.0,412.48
15/01/2023 07:00:00,15/06/2023 18:58:20,Gemini_BTCUSD_1h_17_12_17_to_10_03_23.csv,BTC_USD,HOUR,97489.87,20.103,15/01/2023 11:00:00,15/01/2023 10:00:00,15/01/2023 10:00:00,EXPIRED,SHORT,20738.0,20733.0,20447.03,20834.99,4.276,1.42,0.47,5849.37,2,3.0,100.52
30/01/2023 01:00:00,15/06/2023 18:58:20,Gemini_BTCUSD_1h_17_12_17_to_10_03_23.csv,BTC_USD,HOUR,97590.39,15.648,30/01/2023 04:00:00,30/01/2023 04:00:00,30/01/2023 04:00:00,EXPIRED,LONG,23672.0,23711.0,24046.2,23547.27,3.796,1.56,0.53,5855.48,2,3.0,610.27
20/05/2022 23:00:00,15/06/2023 18:58:20,Gemini_BTCUSD_1h_17_12_17_to_10_03_23.csv,BTC_USD,HOUR,98200.66,13.808,21/05/2022 01:00:00,21/05/2022 02:00:00,21/05/2022 00:00:00,STOP_LOSS_HIT,SHORT,29166.0,29308.24,28739.28,29308.24,4.101,1.48,0.49,5892.15,2,3.0,-1964.05
26/09/2018 14:00:00,15/06/2023 18:58:20,Gemini_BTCUSD_1h_17_12_17_to_10_03_23.csv,BTC_USD,HOUR,96236.61,23.159,26/09/2018 15:00:00,26/09/2018 17:00:00,26/09/2018 17:00:00,EXPIRED,LONG,6508.0,6519.0,6757.32,6424.89,1.566,3.69,1.29,5774.0,2,3.0,254.75
30/06/2019 21:00:00,15/06/2023 18:58:20,Gemini_BTCUSD_1h_17_12_17_to_10_03_23.csv,BTC_USD,HOUR,96491.36,29.999,30/06/2019 22:00:00,01/07/2019 00:00:00,30/06/2019 22:00:00,STOP_LOSS_HIT,LONG,11265.0,11200.67,11458.0,11200.67,3.502,1.68,0.57,5789.81,2,3.0,-1929.84
14/04/2019 11:00:00,15/06/2023 18:58:20,Gemini_BTCUSD_1h_17_12_17_to_10_03_23.csv,BTC_USD,HOUR,94561.52,43.85,14/04/2019 13:00:00,14/04/2019 14:00:00,14/04/2019 14:00:00,EXPIRED,SHORT,5074.0,5075.0,4944.61,5117.13,2.353,2.62,0.84,5673.75,2,3.0,-43.85
26/11/2020 17:00:00,15/06/2023 18:58:20,Gemini_BTCUSD_1h_17_12_17_to_10_03_23.csv,BTC_USD,HOUR,94517.67,16.69,26/11/2020 21:00:00,26/11/2020 20:00:00,26/11/2020 18:00:00,STOP_LOSS_HIT,LONG,16731.0,16617.74,17070.77,16617.74,2.954,1.99,0.68,5670.76,2,3.0,-1890.31
02/09/2021 01:00:00,15/06/2023 18:58:20,Gemini_BTCUSD_1h_17_12_17_to_10_03_23.csv,BTC_USD,HOUR,92627.36,6.638,02/09/2021 02:00:00,02/09/2021 04:00:00,02/09/2021 04:00:00,STOP_LOSS_HIT,LONG,49704.0,49424.9,50541.32,49424.9,3.562,1.66,0.56,5558.13,2,3.0,-1852.67
15/07/2019 13:00:00,15/06/2023 18:58:20,Gemini_BTCUSD_1h_17_12_17_to_10_03_23.csv,BTC_USD,HOUR,90774.69,21.354,15/07/2019 15:00:00,15/07/2019 16:00:00,15/07/2019 16:00:00,TAKE_PROFIT_HIT,LONG,10392.0,10647.06,10647.06,10306.98,2.445,2.4,0.82,5446.55,2,3.0,5446.55
02/01/2018 03:00:00,15/06/2023 18:58:20,Gemini_BTCUSD_1h_17_12_17_to_10_03_23.csv,BTC_USD,HOUR,96221.24,13.435,02/01/2018 04:00:00,02/01/2018 06:00:00,02/01/2018 04:00:00,STOP_LOSS_HIT,LONG,13049.0,12905.76,13478.71,12905.76,1.822,3.19,1.11,5773.15,2,3.0,-1924.43
18/02/2019 20:00:00,15/06/2023 18:58:20,Gemini_BTCUSD_1h_17_12_17_to_10_03_23.csv,BTC_USD,HOUR,94296.81,85.763,18/02/2019 21:00:00,18/02/2019 23:00:00,18/02/2019 22:00:00,STOP_LOSS_HIT,LONG,3865.0,3843.01,3930.97,3843.01,3.515,1.68,0.57,5657.79,2,3.0,-1885.93
11/02/2020 14:00:00,15/06/2023 18:58:20,Gemini_BTCUSD_1h_17_12_17_to_10_03_23.csv,BTC_USD,HOUR,92410.88,17.022,11/02/2020 15:00:00,11/02/2020 17:00:00,11/02/2020 15:00:00,TAKE_PROFIT_HIT,LONG,9861.0,10186.74,10186.74,9752.42,1.816,3.2,1.11,5544.75,2,3.0,5544.75
23/11/2022 23:00:00,15/06/2023 18:58:20,Gemini_BTCUSD_1h_17_12_17_to_10_03_23.csv,BTC_USD,HOUR,97955.63,11.407,24/11/2022 03:00:00,24/11/2022 02:00:00,24/11/2022 02:00:00,STOP_LOSS_HIT,SHORT,16600.0,16771.74,16084.77,16771.74,1.933,3.2,1.02,5877.23,2,3.0,-1959.04
10/03/2019 18:00:00,15/06/2023 18:58:20,Gemini_BTCUSD_1h_17_12_17_to_10_03_23.csv,BTC_USD,HOUR,95996.59,96.528,10/03/2019 20:00:00,10/03/2019 21:00:00,10/03/2019 21:00:00,EXPIRED,SHORT,3883.0,3893.0,3823.32,3902.89,3.904,1.56,0.51,5760.79,2,3.0,-965.28
29/06/2020 10:00:00,15/06/2023 18:58:20,Gemini_BTCUSD_1h_17_12_17_to_10_03_23.csv,BTC_USD,HOUR,95031.31,15.495,29/06/2020 12:00:00,29/06/2020 13:00:00,29/06/2020 13:00:00,EXPIRED,LONG,9110.0,9040.0,9477.99,8987.34,1.485,3.88,1.36,5702.01,2,3.0,-1084.65
17/06/2020 00:00:00,15/06/2023 18:58:20,Gemini_BTCUSD_1h_17_12_17_to_10_03_23.csv,BTC_USD,HOUR,93946.66,21.454,17/06/2020 02:00:00,17/06/2020 03:00:00,17/06/2020 03:00:00,EXPIRED,LONG,9477.0,9449.0,9739.75,9389.42,2.164,2.7,0.93,5637.04,2,3.0,-600.71
01/02/2022 19:00:00,15/06/2023 18:58:20,Gemini_BTCUSD_1h_17_12_17_to_10_03_23.csv,BTC_USD,HOUR,93345.95,3.312,01/02/2022 20:00:00,01/02/2022 22:00:00,01/02/2022 22:00:00,EXPIRED,LONG,38423.0,38724.0,40114.26,37859.25,1.363,4.22,1.49,5601.45,2,3.0,996.91
08/11/2021 13:00:00,15/06/2023 18:58:20,Gemini_BTCUSD_1h_17_12_17_to_10_03_23.csv,BTC_USD,HOUR,94342.86,4.65,08/11/2021 14:00:00,08/11/2021 16:00:00,08/11/2021 16:00:00,EXPIRED,LONG,65418.0,65966.0,66635.42,65012.19,3.224,1.83,0.62,5661.0,2,3.0,2548.2
16/02/2022 01:00:00,15/06/2023 18:58:20,Gemini_BTCUSD_1h_17_12_17_to_10_03_23.csv,BTC_USD,HOUR,96891.06,3.284,16/02/2022 03:00:00,16/02/2022 04:00:00,16/02/2022 04:00:00,EXPIRED,LONG,44021.0,43912.0,45791.03,43430.99,1.492,3.87,1.36,5812.78,2,3.0,-357.96
26/03/2021 22:00:00,15/06/2023 18:58:20,Gemini_BTCUSD_1h_17_12_17_to_10_03_23.csv,BTC_USD,HOUR,96533.1,2.486,26/03/2021 23:00:00,27/03/2021 01:00:00,27/03/2021 01:00:00,EXPIRED,LONG,54444.0,54773.0,56773.8,53667.4,1.402,4.1,1.45,5791.88,2,3.0,817.89
21/03/2020 19:00:00,15/06/2023 18:58:20,Gemini_BTCUSD_1h_17_12_17_to_10_03_23.csv,BTC_USD,HOUR,97350.99,36.729,21/03/2020 20:00:00,21/03/2020 22:00:00,21/03/2020 21:00:00,STOP_LOSS_HIT,LONG,6230.0,6176.99,6389.02,6176.99,2.35,2.49,0.86,5840.65,2,3.0,-1947.0
09/11/2020 20:00:00,15/06/2023 18:58:20,Gemini_BTCUSD_1h_17_12_17_to_10_03_23.csv,BTC_USD,HOUR,95403.99,13.877,09/11/2020 21:00:00,09/11/2020 23:00:00,09/11/2020 22:00:00,STOP_LOSS_HIT,LONG,15386.0,15248.5,15798.5,15248.5,2.238,2.61,0.9,5724.26,2,3.0,-1908.09
01/12/2018 01:00:00,15/06/2023 18:58:20,Gemini_BTCUSD_1h_17_12_17_to_10_03_23.csv,BTC_USD,HOUR,93495.9,61.98,01/12/2018 04:00:00,01/12/2018 04:00:00,01/12/2018 03:00:00,STOP_LOSS_HIT,LONG,3972.0,3941.83,4062.5,3941.83,2.633,2.23,0.77,5609.19,2,3.0,-1869.94
04/10/2020 07:00:00,15/06/2023 18:58:20,Gemini_BTCUSD_1h_17_12_17_to_10_03_23.csv,BTC_USD,HOUR,91625.96,20.285,04/10/2020 08:00:00,04/10/2020 10:00:00,04/10/2020 10:00:00,EXPIRED,LONG,10624.0,10585.0,10895.02,10533.66,2.352,2.49,0.86,5497.64,2,3.0,-791.11
29/11/2021 14:00:00,15/06/2023 18:58:20,Gemini_BTCUSD_1h_17_12_17_to_10_03_23.csv,BTC_USD,HOUR,90834.85,2.23,29/11/2021 18:00:00,29/11/2021 17:00:00,29/11/2021 17:00:00,EXPIRED,LONG,57080.0,58653.0,59524.14,56265.29,1.401,4.11,1.45,5450.43,2,3.0,3507.79
13/02/2023 07:00:00,15/06/2023 18:58:20,Gemini_BTCUSD_1h_17_12_17_to_10_03_23.csv,BTC_USD,HOUR,94342.64,7.686,13/02/2023 11:00:00,13/02/2023 10:00:00,13/02/2023 09:00:00,STOP_LOSS_HIT,LONG,21885.0,21639.52,22621.43,21639.52,1.783,3.26,1.13,5660.2,2,3.0,-1886.76
22/02/2020 21:00:00,15/06/2023 18:58:20,Gemini_BTCUSD_1h_17_12_17_to_10_03_23.csv,BTC_USD,HOUR,92455.88,11.602,22/02/2020 22:00:00,23/02/2020 00:00:00,23/02/2020 00:00:00,EXPIRED,LONG,9707.0,9701.0,10185.13,9547.62,1.218,4.69,1.67,5547.26,2,3.0,-69.61
20/10/2019 07:00:00,15/06/2023 18:58:20,Gemini_BTCUSD_1h_17_12_17_to_10_03_23.csv,BTC_USD,HOUR,92386.27,16.161,20/10/2019 08:00:00,20/10/2019 10:00:00,20/10/2019 10:00:00,EXPIRED,LONG,7919.0,7935.0,8261.98,7804.67,1.385,4.15,1.46,5542.9,2,3.0,258.58
12/07/2019 23:00:00,15/06/2023 18:58:20,Gemini_BTCUSD_1h_17_12_17_to_10_03_23.csv,BTC_USD,HOUR,92644.85,14.24,13/07/2019 00:00:00,13/07/2019 02:00:00,13/07/2019 02:00:00,EXPIRED,LONG,11776.0,11692.0,12166.36,11645.88,1.81,3.21,1.12,5558.73,2,3.0,-1196.16
22/04/2019 07:00:00,15/06/2023 18:58:20,Gemini_BTCUSD_1h_17_12_17_to_10_03_23.csv,BTC_USD,HOUR,91448.69,65.744,22/04/2019 11:00:00,22/04/2019 10:00:00,22/04/2019 10:00:00,EXPIRED,LONG,5287.0,5312.0,5370.45,5259.18,3.801,1.55,0.53,5486.34,2,3.0,1643.6
08/07/2021 22:00:00,15/06/2023 18:58:20,Gemini_BTCUSD_1h_17_12_17_to_10_03_23.csv,BTC_USD,HOUR,93092.29,9.933,09/07/2021 00:00:00,09/07/2021 01:00:00,09/07/2021 01:00:00,STOP_LOSS_HIT,LONG,32568.0,32380.55,33130.34,32380.55,3.475,1.7,0.58,5585.72,2,3.0,-1861.94
13/03/2021 14:00:00,15/06/2023 18:58:20,Gemini_BTCUSD_1h_17_12_17_to_10_03_23.csv,BTC_USD,HOUR,91230.35,2.745,13/03/2021 15:00:00,13/03/2021 17:00:00,13/03/2021 17:00:00,EXPIRED,LONG,59775.0,60335.0,61768.84,59110.39,1.799,3.23,1.12,5473.09,2,3.0,1537.2
14/02/2018 00:00:00,15/06/2023 18:58:20,Gemini_BTCUSD_1h_17_12_17_to_10_03_23.csv,BTC_USD,HOUR,92767.55,46.582,14/02/2018 04:00:00,14/02/2018 03:00:00,14/02/2018 02:00:00,TAKE_PROFIT_HIT,LONG,8602.0,8721.5,8721.5,8562.17,4.319,1.37,0.47,5566.55,2,3.0,5566.55
23/05/2020 00:00:00,15/06/2023 18:58:20,Gemini_BTCUSD_1h_17_12_17_to_10_03_23.csv,BTC_USD,HOUR,98334.1,25.066,23/05/2020 01:00:00,23/05/2020 03:00:00,23/05/2020 03:00:00,EXPIRED,LONG,9249.0,9287.0,9484.39,9170.54,2.358,2.48,0.86,5900.29,2,3.0,952.51
05/01/2021 04:00:00,15/06/2023 18:58:20,Gemini_BTCUSD_1h_17_12_17_to_10_03_23.csv,BTC_USD,HOUR,99286.61,9.999,05/01/2021 08:00:00,05/01/2021 07:00:00,05/01/2021 05:00:00,STOP_LOSS_HIT,LONG,30918.0,30719.4,31513.81,30719.4,3.114,1.89,0.65,5957.5,2,3.0,-1985.8
24/10/2020 17:00:00,15/06/2023 18:58:20,Gemini_BTCUSD_1h_17_12_17_to_10_03_23.csv,BTC_USD,HOUR,97300.81,25.84,24/10/2020 18:00:00,24/10/2020 20:00:00,24/10/2020 20:00:00,EXPIRED,LONG,13147.0,13121.0,13372.93,13071.69,3.491,1.69,0.58,5838.03,2,3.0,-671.84
15/08/2019 17:00:00,15/06/2023 18:58:20,Gemini_BTCUSD_1h_17_12_17_to_10_03_23.csv,BTC_USD,HOUR,96628.97,19.232,15/08/2019 18:00:00,15/08/2019 20:00:00,15/08/2019 20:00:00,TAKE_PROFIT_HIT,LONG,10022.0,10323.48,10323.48,9921.51,1.995,2.92,1.01,5798.06,2,3.0,5798.06
07/12/2019 18:00:00,15/06/2023 18:58:20,Gemini_BTCUSD_1h_17_12_17_to_10_03_23.csv,BTC_USD,HOUR,102427.03,30.471,07/12/2019 20:00:00,07/12/2019 21:00:00,07/12/2019 21:00:00,EXPIRED,SHORT,7501.0,7496.0,7299.32,7568.23,2.231,2.76,0.89,6145.39,2,3.0,152.35
29/06/2022 20:00:00,15/06/2023 18:58:20,Gemini_BTCUSD_1h_17_12_17_to_10_03_23.csv,BTC_USD,HOUR,102579.38,7.208,29/06/2022 21:00:00,29/06/2022 23:00:00,29/06/2022 23:00:00,EXPIRED,LONG,20196.0,20092.0,21049.87,19911.38,1.419,4.06,1.43,6154.69,2,3.0,-749.63
20/11/2021 22:00:00,15/06/2023 18:58:20,Gemini_BTCUSD_1h_17_12_17_to_10_03_23.csv,BTC_USD,HOUR,101829.75,4.163,21/11/2021 02:00:00,21/11/2021 01:00:00,21/11/2021 01:00:00,EXPIRED,SHORT,59760.0,59378.0,58292.43,60249.19,2.443,2.52,0.81,6109.49,2,3.0,1590.27
29/01/2022 23:00:00,15/06/2023 18:58:20,Gemini_BTCUSD_1h_17_12_17_to_10_03_23.csv,BTC_USD,HOUR,103420.02,2.979,30/01/2022 00:00:00,30/01/2022 02:00:00,30/01/2022 02:00:00,EXPIRED,LONG,38175.0,37980.0,40258.21,37480.6,1.1,5.17,1.85,6205.88,2,3.0,-580.9
25/03/2019 15:00:00,15/06/2023 18:58:20,Gemini_BTCUSD_1h_17_12_17_to_10_03_23.csv,BTC_USD,HOUR,102839.12,41.847,25/03/2019 19:00:00,25/03/2019 18:00:00,25/03/2019 18:00:00,STOP_LOSS_HIT,LONG,3950.0,3900.85,4097.44,3900.85,1.607,3.6,1.26,6169.92,2,3.0,-2056.78
31/05/2020 11:00:00,15/06/2023 18:58:20,Gemini_BTCUSD_1h_17_12_17_to_10_03_23.csv,BTC_USD,HOUR,100782.34,26.345,31/05/2020 14:00:00,31/05/2020 14:00:00,31/05/2020 14:00:00,STOP_LOSS_HIT,LONG,9587.0,9510.49,9816.53,9510.49,2.506,2.34,0.8,6046.97,2,3.0,-2015.66
20/01/2020 20:00:00,15/06/2023 18:58:20,Gemini_BTCUSD_1h_17_12_17_to_10_03_23.csv,BTC_USD,HOUR,98766.68,26.408,20/01/2020 23:00:00,20/01/2020 23:00:00,20/01/2020 23:00:00,EXPIRED,LONG,8657.0,8628.0,8881.41,8582.2,2.315,2.53,0.87,5926.22,2,3.0,-765.83
16/07/2018 09:00:00,15/06/2023 18:58:20,Gemini_BTCUSD_1h_17_12_17_to_10_03_23.csv,BTC_USD,HOUR,98000.85,33.735,16/07/2018 13:00:00,16/07/2018 12:00:00,16/07/2018 12:00:00,EXPIRED,LONG,6518.0,6600.0,6692.29,6459.9,2.244,2.6,0.9,5879.67,2,3.0,2766.27
13/11/2019 18:00:00,15/06/2023 18:58:20,Gemini_BTCUSD_1h_17_12_17_to_10_03_23.csv,BTC_USD,HOUR,100767.12,45.865,13/11/2019 22:00:00,13/11/2019 21:00:00,13/11/2019 21:00:00,EXPIRED,LONG,8742.0,8754.0,8873.82,8698.06,3.979,1.49,0.51,6045.92,2,3.0,550.38
03/07/2019 21:00:00,15/06/2023 18:58:20,Gemini_BTCUSD_1h_17_12_17_to_10_03_23.csv,BTC_USD,HOUR,101317.5,9.617,03/07/2019 22:00:00,04/07/2019 00:00:00,04/07/2019 00:00:00,TAKE_PROFIT_HIT,LONG,11395.0,12027.14,12027.14,11184.29,1.082,5.26,1.88,6079.29,2,3.0,6079.29
02/01/2019 15:00:00,15/06/2023 18:58:20,Gemini_BTCUSD_1h_17_12_17_to_10_03_23.csv,BTC_USD,HOUR,107396.79,46.919,02/01/2019 17:00:00,02/01/2019 18:00:00,02/01/2019 18:00:00,EXPIRED,LONG,3818.0,3850.0,3955.35,3772.22,1.668,3.47,1.21,6444.32,2,3.0,1501.41
25/02/2019 06:00:00,15/06/2023 18:58:20,Gemini_BTCUSD_1h_17_12_17_to_10_03_23.csv,BTC_USD,HOUR,108898.2,43.655,25/02/2019 10:00:00,25/02/2019 09:00:00,25/02/2019 09:00:00,EXPIRED,LONG,3779.0,3774.0,3928.67,3729.11,1.515,3.81,1.34,6533.84,2,3.0,-218.27
27/12/2021 18:00:00,15/06/2023 18:58:20,Gemini_BTCUSD_1h_17_12_17_to_10_03_23.csv,BTC_USD,HOUR,108679.93,8.528,27/12/2021 21:00:00,27/12/2021 21:00:00,27/12/2021 19:00:00,STOP_LOSS_HIT,LONG,51708.0,51453.12,52472.65,51453.12,4.057,1.46,0.5,6520.94,2,3.0,-2173.62
09/06/2018 06:00:00,15/06/2023 18:58:20,Gemini_BTCUSD_1h_17_12_17_to_10_03_23.csv,BTC_USD,HOUR,106506.31,40.996,09/06/2018 07:00:00,09/06/2018 09:00:00,09/06/2018 09:00:00,EXPIRED,LONG,7669.0,7634.0,7824.89,7617.04,2.952,1.99,0.68,6390.87,2,3.0,-1434.86
15/08/2018 16:00:00,15/06/2023 18:58:20,Gemini_BTCUSD_1h_17_12_17_to_10_03_23.csv,BTC_USD,HOUR,105071.45,67.267,15/08/2018 17:00:00,15/08/2018 19:00:00,15/08/2018 17:00:00,STOP_LOSS_HIT,LONG,6592.0,6560.76,6685.71,6560.76,4.22,1.4,0.48,6303.59,2,3.0,-2101.42
04/04/2020 07:00:00,15/06/2023 18:58:20,Gemini_BTCUSD_1h_17_12_17_to_10_03_23.csv,BTC_USD,HOUR,102970.03,18.608,04/04/2020 09:00:00,04/04/2020 10:00:00,04/04/2020 10:00:00,EXPIRED,LONG,6740.0,6891.0,7072.01,6629.33,1.218,4.69,1.67,6178.04,2,3.0,2809.81
07/06/2022 19:00:00,15/06/2023 18:58:20,Gemini_BTCUSD_1h_17_12_17_to_10_03_23.csv,BTC_USD,HOUR,105779.84,8.535,07/06/2022 20:00:00,07/06/2022 22:00:00,07/06/2022 22:00:00,STOP_LOSS_HIT,LONG,31046.0,30798.13,31789.6,30798.13,2.505,2.34,0.8,6346.63,2,3.0,-2115.57
30/08/2018 02:00:00,15/06/2023 18:58:20,Gemini_BTCUSD_1h_17_12_17_to_10_03_23.csv,BTC_USD,HOUR,103664.27,45.991,30/08/2018 05:00:00,30/08/2018 05:00:00,30/08/2018 05:00:00,STOP_LOSS_HIT,LONG,7008.0,6962.92,7143.23,6962.92,3.109,1.89,0.65,6219.36,2,3.0,-2073.27
30/12/2021 01:00:00,15/06/2023 18:58:20,Gemini_BTCUSD_1h_17_12_17_to_10_03_23.csv,BTC_USD,HOUR,101591.0,4.264,30/12/2021 05:00:00,30/12/2021 04:00:00,30/12/2021 04:00:00,EXPIRED,SHORT,46578.0,46737.0,45148.42,47054.53,1.955,3.17,1.01,6095.73,2,3.0,-677.98
25/07/2021 23:00:00,15/06/2023 18:58:20,Gemini_BTCUSD_1h_17_12_17_to_10_03_23.csv,BTC_USD,HOUR,100913.02,5.191,26/07/2021 02:00:00,26/07/2021 02:00:00,26/07/2021 00:00:00,TAKE_PROFIT_HIT,LONG,35443.0,36609.36,36609.36,35054.22,1.823,3.19,1.11,6054.57,2,3.0,6054.57
28/07/2022 05:00:00,15/06/2023 18:58:20,Gemini_BTCUSD_1h_17_12_17_to_10_03_23.csv,BTC_USD,HOUR,106967.59,7.035,28/07/2022 06:00:00,28/07/2022 08:00:00,28/07/2022 07:00:00,STOP_LOSS_HIT,LONG,23252.0,22947.91,24164.27,22947.91,1.529,3.78,1.33,6417.82,2,3.0,-2139.27
28/10/2021 06:00:00,15/06/2023 18:58:20,Gemini_BTCUSD_1h_17_12_17_to_10_03_23.csv,BTC_USD,HOUR,104828.32,5.714,28/10/2021 08:00:00,28/10/2021 09:00:00,28/10/2021 08:00:00,STOP_LOSS_HIT,SHORT,59064.0,59430.89,57963.34,59430.89,3.219,1.9,0.62,6289.17,2,3.0,-2096.41
16/10/2020 00:00:00,15/06/2023 18:58:20,Gemini_BTCUSD_1h_17_12_17_to_10_03_23.csv,BTC_USD,HOUR,102731.91,35.783,16/10/2020 01:00:00,16/10/2020 03:00:00,16/10/2020 03:00:00,EXPIRED,LONG,11518.0,11514.0,11690.26,11460.58,4.012,1.47,0.5,6163.98,2,3.0,-143.13
08/02/2021 16:00:00,15/06/2023 18:58:20,Gemini_BTCUSD_1h_17_12_17_to_10_03_23.csv,BTC_USD,HOUR,102588.78,9.94,08/02/2021 17:00:00,08/02/2021 19:00:00,08/02/2021 17:00:00,STOP_LOSS_HIT,LONG,43283.0,43076.58,43902.28,43076.58,4.194,1.41,0.48,6155.64,2,3.0,-2051.81
08/02/2022 22:00:00,15/06/2023 18:58:20,Gemini_BTCUSD_1h_17_12_17_to_10_03_23.csv,BTC_USD,HOUR,100536.97,9.382,09/02/2022 02:00:00,09/02/2022 01:00:00,09/02/2022 01:00:00,STOP_LOSS_HIT,LONG,44110.0,43895.67,44753.0,43895.67,4.116,1.44,0.49,6032.63,2,3.0,-2010.84
21/12/2021 06:00:00,15/06/2023 18:58:20,Gemini_BTCUSD_1h_17_12_17_to_10_03_23.csv,BTC_USD,HOUR,98526.13,6.232,21/12/2021 07:00:00,21/12/2021 09:00:00,21/12/2021 09:00:00,EXPIRED,LONG,48559.0,48624.0,49507.62,48242.8,3.071,1.92,0.66,5911.8,2,3.0,405.08
05/05/2020 23:00:00,15/06/2023 18:58:20,Gemini_BTCUSD_1h_17_12_17_to_10_03_23.csv,BTC_USD,HOUR,98931.21,12.758,06/05/2020 00:00:00,06/05/2020 02:00:00,06/05/2020 02:00:00,EXPIRED,LONG,9024.0,8983.0,9489.26,8868.91,1.164,4.9,1.75,5935.79,2,3.0,-523.08
18/07/2019 06:00:00,15/06/2023 18:58:20,Gemini_BTCUSD_1h_17_12_17_to_10_03_23.csv,BTC_USD,HOUR,98408.13,14.216,18/07/2019 08:00:00,18/07/2019 09:00:00,18/07/2019 08:00:00,STOP_LOSS_HIT,LONG,9878.0,9739.55,10293.36,9739.55,1.427,4.04,1.42,5904.76,2,3.0,-1968.21
22/06/2020 15:00:00,15/06/2023 18:58:20,Gemini_BTCUSD_1h_17_12_17_to_10_03_23.csv,BTC_USD,HOUR,96439.92,15.323,22/06/2020 16:00:00,22/06/2020 18:00:00,22/06/2020 18:00:00,EXPIRED,LONG,9498.0,9582.0,9875.65,9372.12,1.509,3.82,1.34,5786.73,2,3.0,1287.13
27/01/2021 20:00:00,15/06/2023 18:58:20,Gemini_BTCUSD_1h_17_12_17_to_10_03_23.csv,BTC_USD,HOUR,97727.05,6.923,27/01/2021 21:00:00,27/01/2021 23:00:00,27/01/2021 21:00:00,STOP_LOSS_HIT,LONG,31580.0,31297.69,32426.94,31297.69,2.237,2.61,0.9,5863.37,2,3.0,-1954.43
26/01/2021 16:00:00,15/06/2023 18:58:20,Gemini_BTCUSD_1h_17_12_17_to_10_03_23.csv,BTC_USD,HOUR,95772.62,7.018,26/01/2021 20:00:00,26/01/2021 19:00:00,26/01/2021 19:00:00,EXPIRED,LONG,32032.0,32247.0,32850.79,31759.07,2.347,2.49,0.86,5746.27,2,3.0,1508.87
24/01/2020 02:00:00,15/06/2023 18:58:20,Gemini_BTCUSD_1h_17_12_17_to_10_03_23.csv,BTC_USD,HOUR,97281.49,48.35,24/01/2020 03:00:00,24/01/2020 05:00:00,24/01/2020 05:00:00,EXPIRED,LONG,8278.0,8308.0,8398.73,8237.76,4.114,1.44,0.49,5837.3,2,3.0,1450.5
27/10/2019 23:00:00,15/06/2023 18:58:20,Gemini_BTCUSD_1h_17_12_17_to_10_03_23.csv,BTC_USD,HOUR,98731.99,39.572,28/10/2019 00:00:00,28/10/2019 02:00:00,28/10/2019 00:00:00,TAKE_PROFIT_HIT,LONG,9547.0,9696.71,9696.71,9497.1,3.826,1.54,0.53,5924.32,2,3.0,5924.32
07/02/2020 09:00:00,15/06/2023 18:58:20,Gemini_BTCUSD_1h_17_12_17_to_10_03_23.csv,BTC_USD,HOUR,104656.31,14.954,07/02/2020 12:00:00,07/02/2020 12:00:00,07/02/2020 12:00:00,EXPIRED,LONG,9782.0,9745.0,10201.9,9642.03,1.398,4.12,1.45,6279.18,2,3.0,-553.3
29/08/2020 03:00:00,15/06/2023 18:58:20,Gemini_BTCUSD_1h_17_12_17_to_10_03_23.csv,BTC_USD,HOUR,104103.01,17.385,29/08/2020 07:00:00,29/08/2020 06:00:00,29/08/2020 06:00:00,EXPIRED,SHORT,11509.0,11533.0,11149.71,11628.76,1.922,3.22,1.03,6246.26,2,3.0,-417.24
23/11/2019 02:00:00,15/06/2023 18:58:20,Gemini_BTCUSD_1h_17_12_17_to_10_03_23.csv,BTC_USD,HOUR,103685.77,41.491,23/11/2019 05:00:00,23/11/2019 05:00:00,23/11/2019 05:00:00,STOP_LOSS_HIT,LONG,7265.0,7215.02,7414.93,7215.02,2.907,2.02,0.69,6220.75,2,3.0,-2073.72
20/11/2020 16:00:00,15/06/2023 18:58:20,Gemini_BTCUSD_1h_17_12_17_to_10_03_23.csv,BTC_USD,HOUR,101612.05,12.878,20/11/2020 17:00:00,20/11/2020 19:00:00,20/11/2020 18:00:00,STOP_LOSS_HIT,LONG,18704.0,18546.19,19177.42,18546.19,2.37,2.47,0.85,6096.7,2,3.0,-2032.28
23/04/2021 01:00:00,15/06/2023 18:58:20,Gemini_BTCUSD_1h_17_12_17_to_10_03_23.csv,BTC_USD,HOUR,99579.77,8.124,23/04/2021 05:00:00,23/04/2021 04:00:00,23/04/2021 02:00:00,STOP_LOSS_HIT,SHORT,51113.0,51358.14,50377.6,51358.14,4.17,1.46,0.48,5974.39,2,3.0,-1991.52
31/03/2020 08:00:00,15/06/2023 18:58:20,Gemini_BTCUSD_1h_17_12_17_to_10_03_23.csv,BTC_USD,HOUR,97588.25,50.446,31/03/2020 10:00:00,31/03/2020 11:00:00,31/03/2020 09:00:00,STOP_LOSS_HIT,LONG,6505.0,6466.31,6621.07,6466.31,3.363,1.75,0.6,5855.27,2,3.0,-1951.76
25/12/2020 12:00:00,15/06/2023 18:58:20,Gemini_BTCUSD_1h_17_12_17_to_10_03_23.csv,BTC_USD,HOUR,95636.49,4.069,25/12/2020 13:00:00,25/12/2020 15:00:00,25/12/2020 14:00:00,STOP_LOSS_HIT,LONG,24343.0,23872.96,25753.13,23872.96,1.036,5.48,1.97,5737.82,2,3.0,-1912.59
12/02/2023 09:00:00,15/06/2023 18:58:20,Gemini_BTCUSD_1h_17_12_17_to_10_03_23.csv,BTC_USD,HOUR,93723.9,15.584,12/02/2023 11:00:00,12/02/2023 12:00:00,12/02/2023 12:00:00,EXPIRED,SHORT,21916.0,21831.0,21555.16,22036.28,3.644,1.67,0.55,5623.33,2,3.0,1324.64
02/10/2022 03:00:00,15/06/2023 18:58:20,Gemini_BTCUSD_1h_17_12_17_to_10_03_23.csv,BTC_USD,HOUR,95048.54,11.361,02/10/2022 05:00:00,02/10/2022 06:00:00,02/10/2022 06:00:00,EXPIRED,LONG,19313.0,19281.0,19814.97,19145.68,2.308,2.53,0.87,5702.88,2,3.0,-363.55
06/05/2022 17:00:00,15/06/2023 18:58:20,Gemini_BTCUSD_1h_17_12_17_to_10_03_23.csv,BTC_USD,HOUR,94684.99,9.425,06/05/2022 19:00:00,06/05/2022 20:00:00,06/05/2022 19:00:00,STOP_LOSS_HIT,SHORT,35887.0,36087.93,35284.2,36087.93,3.572,1.71,0.56,5681.39,2,3.0,-1893.77
21/07/2018 14:00:00,15/06/2023 18:58:20,Gemini_BTCUSD_1h_17_12_17_to_10_03_23.csv,BTC_USD,HOUR,92791.22,20.627,21/07/2018 16:00:00,21/07/2018 17:00:00,21/07/2018 17:00:00,EXPIRED,LONG,7356.0,7412.0,7625.91,7266.03,1.635,3.54,1.24,5567.43,2,3.0,1155.11
11/03/2021 12:00:00,15/06/2023 18:58:20,Gemini_BTCUSD_1h_17_12_17_to_10_03_23.csv,BTC_USD,HOUR,93946.33,3.177,11/03/2021 13:00:00,11/03/2021 15:00:00,11/03/2021 15:00:00,EXPIRED,LONG,56268.0,56295.0,58042.52,55676.5,1.903,3.06,1.06,5637.65,2,3.0,85.78
10/09/2021 19:00:00,15/06/2023 18:58:20,Gemini_BTCUSD_1h_17_12_17_to_10_03_23.csv,BTC_USD,HOUR,94032.11,6.824,10/09/2021 20:00:00,10/09/2021 22:00:00,10/09/2021 20:00:00,STOP_LOSS_HIT,LONG,45648.0,45372.4,46474.81,45372.4,3.313,1.78,0.61,5642.15,2,3.0,-1880.69
20/04/2018 08:00:00,15/06/2023 18:58:20,Gemini_BTCUSD_1h_17_12_17_to_10_03_23.csv,BTC_USD,HOUR,92151.42,23.547,20/04/2018 12:00:00,20/04/2018 11:00:00,20/04/2018 11:00:00,EXPIRED,LONG,8302.0,8516.0,8536.81,8223.73,2.121,2.75,0.95,5529.07,2,3.0,5039.06
21/11/2018 09:00:00,15/06/2023 18:58:20,Gemini_BTCUSD_1h_17_12_17_to_10_03_23.csv,BTC_USD,HOUR,97190.48,24.825,21/11/2018 10:00:00,21/11/2018 12:00:00,21/11/2018 12:00:00,EXPIRED,LONG,4548.0,4544.0,4782.9,4469.7,1.162,4.91,1.75,5831.39,2,3.0,-99.3
26/06/2022 08:00:00,15/06/2023 18:58:20,Gemini_BTCUSD_1h_17_12_17_to_10_03_23.csv,BTC_USD,HOUR,97091.18,5.505,26/06/2022 09:00:00,26/06/2022 11:00:00,26/06/2022 11:00:00,EXPIRED,LONG,21426.0,21693.0,22484.3,21073.23,1.215,4.71,1.67,5825.94,2,3.0,1469.84
04/11/2020 13:00:00,15/06/2023 18:58:20,Gemini_BTCUSD_1h_17_12_17_to_10_03_23.csv,BTC_USD,HOUR,98561.02,7.549,04/11/2020 14:00:00,04/11/2020 16:00:00,04/11/2020 16:00:00,EXPIRED,LONG,13857.0,14045.0,14640.42,13595.86,1.061,5.35,1.92,5914.04,2,3.0,1419.21
03/07/2022 18:00:00,15/06/2023 18:58:20,Gemini_BTCUSD_1h_17_12_17_to_10_03_23.csv,BTC_USD,HOUR,99980.23,5.138,03/07/2022 19:00:00,03/07/2022 21:00:00,03/07/2022 21:00:00,EXPIRED,LONG,19210.0,19282.0,20377.56,18820.82,0.987,5.73,2.07,5998.92,2,3.0,369.94
27/06/2022 21:00:00,15/06/2023 18:58:20,Gemini_BTCUSD_1h_17_12_17_to_10_03_23.csv,BTC_USD,HOUR,100350.17,18.003,27/06/2022 23:00:00,28/06/2022 00:00:00,27/06/2022 23:00:00,STOP_LOSS_HIT,LONG,20791.0,20679.52,21125.46,20679.52,3.73,1.58,0.54,6021.28,2,3.0,-2006.97
12/12/2021 20:00:00,15/06/2023 18:58:20,Gemini_BTCUSD_1h_17_12_17_to_10_03_23.csv,BTC_USD,HOUR,98343.2,2.196,12/12/2021 21:00:00,12/12/2021 23:00:00,12/12/2021 23:00:00,EXPIRED,LONG,50294.0,50110.0,52981.32,49398.23,1.123,5.07,1.81,5901.35,2,3.0,-404.06
20/03/2018 16:00:00,15/06/2023 18:58:20,Gemini_BTCUSD_1h_17_12_17_to_10_03_23.csv,BTC_USD,HOUR,97939.14,15.355,20/03/2018 20:00:00,20/03/2018 19:00:00,20/03/2018 19:00:00,EXPIRED,LONG,8829.0,8950.0,9211.72,8701.43,1.384,4.15,1.47,5876.67,2,3.0,1857.96
31/07/2019 07:00:00,15/06/2023 18:58:20,Gemini_BTCUSD_1h_17_12_17_to_10_03_23.csv,BTC_USD,HOUR,99797.1,13.209,31/07/2019 08:00:00,31/07/2019 10:00:00,31/07/2019 10:00:00,EXPIRED,LONG,9736.0,9776.0,10189.3,9584.9,1.289,4.45,1.58,5987.64,2,3.0,528.36
07/07/2022 15:00:00,15/06/2023 18:58:20,Gemini_BTCUSD_1h_17_12_17_to_10_03_23.csv,BTC_USD,HOUR,100325.46,11.676,07/07/2022 16:00:00,07/07/2022 18:00:00,07/07/2022 16:00:00,STOP_LOSS_HIT,SHORT,20876.0,21047.85,20360.46,21047.85,2.43,2.53,0.82,6019.45,2,3.0,-2006.52
25/10/2022 13:00:00,15/06/2023 18:58:20,Gemini_BTCUSD_1h_17_12_17_to_10_03_23.csv,BTC_USD,HOUR,98318.94,5.431,25/10/2022 15:00:00,25/10/2022 16:00:00,25/10/2022 16:00:00,EXPIRED,LONG,19480.0,19816.0,20566.2,19117.94,1.076,5.28,1.89,5899.15,2,3.0,1824.82
07/03/2021 10:00:00,15/06/2023 18:58:20,Gemini_BTCUSD_1h_17_12_17_to_10_03_23.csv,BTC_USD,HOUR,100143.76,2.178,07/03/2021 11:00:00,07/03/2021 13:00:00,07/03/2021 13:00:00,EXPIRED,LONG,50629.0,50822.0,53388.25,49709.25,1.101,5.17,1.85,6009.65,2,3.0,420.35
05/03/2021 10:00:00,15/06/2023 18:58:20,Gemini_BTCUSD_1h_17_12_17_to_10_03_23.csv,BTC_USD,HOUR,100564.11,7.018,05/03/2021 14:00:00,05/03/2021 13:00:00,05/03/2021 13:00:00,TAKE_PROFIT_HIT,LONG,47066.0,47925.83,47925.83,46779.39,3.285,1.79,0.61,6034.29,2,3.0,6034.29
25/06/2018 09:00:00,15/06/2023 18:58:20,Gemini_BTCUSD_1h_17_12_17_to_10_03_23.csv,BTC_USD,HOUR,106598.4,35.759,25/06/2018 12:00:00,25/06/2018 12:00:00,25/06/2018 11:00:00,STOP_LOSS_HIT,SHORT,6160.0,6219.62,5981.15,6219.62,2.066,2.99,0.96,6395.5,2,3.0,-2131.95
02/02/2018 00:00:00,15/06/2023 18:58:20,Gemini_BTCUSD_1h_17_12_17_to_10_03_23.csv,BTC_USD,HOUR,104466.45,46.419,02/02/2018 04:00:00,02/02/2018 03:00:00,02/02/2018 01:00:00,STOP_LOSS_HIT,SHORT,8704.0,8749.01,8568.96,8749.01,3.868,1.58,0.51,6268.42,2,3.0,-2089.32
28/01/2021 12:00:00,15/06/2023 18:58:20,Gemini_BTCUSD_1h_17_12_17_to_10_03_23.csv,BTC_USD,HOUR,102377.13,11.621,28/01/2021 16:00:00,28/01/2021 15:00:00,28/01/2021 13:00:00,STOP_LOSS_HIT,LONG,31516.0,31339.8,32044.62,31339.8,3.577,1.65,0.56,6143.09,2,3.0,-2047.62
26/07/2020 13:00:00,15/06/2023 18:58:20,Gemini_BTCUSD_1h_17_12_17_to_10_03_23.csv,BTC_USD,HOUR,100329.51,11.611,26/07/2020 14:00:00,26/07/2020 16:00:00,26/07/2020 16:00:00,EXPIRED,LONG,9899.0,9907.0,10417.48,9726.18,1.146,4.98,1.78,6020.07,2,3.0,92.89
11/02/2023 21:00:00,15/06/2023 18:58:20,Gemini_BTCUSD_1h_17_12_17_to_10_03_23.csv,BTC_USD,HOUR,100422.4,11.427,12/02/2023 00:00:00,12/02/2023 00:00:00,12/02/2023 00:00:00,EXPIRED,SHORT,21829.0,21822.0,21301.7,22004.77,2.484,2.48,0.8,6025.46,2,3.0,79.99
01/01/2019 14:00:00,15/06/2023 18:58:20,Gemini_BTCUSD_1h_17_12_17_to_10_03_23.csv,BTC_USD,HOUR,100502.39,28.195,01/01/2019 18:00:00,01/01/2019 17:00:00,01/01/2019 17:00:00,EXPIRED,LONG,3696.0,3690.0,3909.88,3624.71,1.037,5.47,1.97,6030.35,2,3.0,-169.17
19/10/2020 09:00:00,15/06/2023 18:58:20,Gemini_BTCUSD_1h_17_12_17_to_10_03_23.csv,BTC_USD,HOUR,100333.22,20.228,19/10/2020 10:00:00,19/10/2020 12:00:00,19/10/2020 12:00:00,EXPIRED,LONG,11488.0,11521.0,11785.6,11388.8,2.316,2.53,0.87,6019.85,2,3.0,667.52
24/12/2021 10:00:00,15/06/2023 18:58:20,Gemini_BTCUSD_1h_17_12_17_to_10_03_23.csv,BTC_USD,HOUR,101000.74,2.228,24/12/2021 12:00:00,24/12/2021 13:00:00,24/12/2021 13:00:00,EXPIRED,LONG,51217.0,51079.0,53936.51,50310.5,1.13,5.04,1.8,6059.07,2,3.0,-307.46
29/09/2022 22:00:00,15/06/2023 18:58:20,Gemini_BTCUSD_1h_17_12_17_to_10_03_23.csv,BTC_USD,HOUR,100693.28,13.753,30/09/2022 00:00:00,30/09/2022 01:00:00,30/09/2022 01:00:00,EXPIRED,LONG,19460.0,19511.0,19899.31,19313.57,2.658,2.21,0.76,6041.83,2,3.0,701.4
25/05/2020 21:00:00,15/06/2023 18:58:20,Gemini_BTCUSD_1h_17_12_17_to_10_03_23.csv,BTC_USD,HOUR,101394.68,14.348,25/05/2020 22:00:00,26/05/2020 00:00:00,26/05/2020 00:00:00,EXPIRED,LONG,8898.0,8863.0,9322.02,8756.66,1.259,4.55,1.61,6083.84,2,3.0,-502.18
15/08/2020 06:00:00,15/06/2023 18:58:20,Gemini_BTCUSD_1h_17_12_17_to_10_03_23.csv,BTC_USD,HOUR,100892.5,19.181,15/08/2020 07:00:00,15/08/2020 09:00:00,15/08/2020 09:00:00,EXPIRED,LONG,11904.0,11911.0,12219.59,11798.8,2.263,2.58,0.89,6053.33,2,3.0,134.27
15/02/2019 05:00:00,15/06/2023 18:58:20,Gemini_BTCUSD_1h_17_12_17_to_10_03_23.csv,BTC_USD,HOUR,101026.77,32.758,15/02/2019 06:00:00,15/02/2019 08:00:00,15/02/2019 08:00:00,EXPIRED,LONG,3576.0,3573.0,3761.05,3514.32,1.16,4.92,1.76,6061.87,2,3.0,-98.27
17/11/2019 17:00:00,15/06/2023 18:58:20,Gemini_BTCUSD_1h_17_12_17_to_10_03_23.csv,BTC_USD,HOUR,100928.5,20.2,17/11/2019 19:00:00,17/11/2019 20:00:00,17/11/2019 20:00:00,EXPIRED,SHORT,8547.0,8530.0,8247.23,8646.93,1.711,3.63,1.16,6055.35,2,3.0,343.4
19/06/2018 13:00:00,15/06/2023 18:58:20,Gemini_BTCUSD_1h_17_12_17_to_10_03_23.csv,BTC_USD,HOUR,101271.9,15.444,19/06/2018 14:00:00,19/06/2018 16:00:00,19/06/2018 16:00:00,EXPIRED,LONG,6760.0,6706.0,7153.46,6628.85,1.031,5.5,1.98,6076.6,2,3.0,-833.98
21/08/2022 10:00:00,15/06/2023 18:58:20,Gemini_BTCUSD_1h_17_12_17_to_10_03_23.csv,BTC_USD,HOUR,100437.92,5.451,21/08/2022 11:00:00,21/08/2022 13:00:00,21/08/2022 13:00:00,EXPIRED,LONG,21387.0,21410.0,22492.52,21018.49,1.161,4.92,1.75,6026.19,2,3.0,125.37
10/05/2019 06:00:00,15/06/2023 18:58:20,Gemini_BTCUSD_1h_17_12_17_to_10_03_23.csv,BTC_USD,HOUR,100563.29,31.411,10/05/2019 07:00:00,10/05/2019 09:00:00,10/05/2019 09:00:00,EXPIRED,LONG,6287.0,6294.0,6479.08,6222.97,1.964,2.96,1.03,6033.42,2,3.0,219.88
01/11/2018 21:00:00,15/06/2023 18:58:20,Gemini_BTCUSD_1h_17_12_17_to_10_03_23.csv,BTC_USD,HOUR,100783.17,17.215,01/11/2018 22:00:00,02/11/2018 00:00:00,02/11/2018 00:00:00,EXPIRED,LONG,6340.0,6376.0,6691.28,6222.91,1.083,5.25,1.88,6047.29,2,3.0,619.74
25/05/2021 06:00:00,15/06/2023 18:58:20,Gemini_BTCUSD_1h_17_12_17_to_10_03_23.csv,BTC_USD,HOUR,101402.91,10.456,25/05/2021 10:00:00,25/05/2021 09:00:00,25/05/2021 07:00:00,STOP_LOSS_HIT,SHORT,38967.0,39160.97,38385.1,39160.97,4.018,1.52,0.5,6084.35,2,3.0,-2028.15
28/10/2022 14:00:00,15/06/2023 18:58:20,Gemini_BTCUSD_1h_17_12_17_to_10_03_23.csv,BTC_USD,HOUR,99374.76,10.916,28/10/2022 15:00:00,28/10/2022 17:00:00,28/10/2022 17:00:00,EXPIRED,LONG,20508.0,20638.0,21054.22,20325.93,2.253,2.59,0.9,5962.54,2,3.0,1419.08
05/06/2021 13:00:00,15/06/2023 18:58:20,Gemini_BTCUSD_1h_17_12_17_to_10_03_23.csv,BTC_USD,HOUR,100793.84,11.489,05/06/2021 15:00:00,05/06/2021 16:00:00,05/06/2021 14:00:00,STOP_LOSS_HIT,SHORT,35755.0,35930.47,35228.58,35930.47,4.076,1.49,0.49,6048.04,2,3.0,-2015.97
26/11/2021 23:00:00,15/06/2023 18:58:20,Gemini_BTCUSD_1h_17_12_17_to_10_03_23.csv,BTC_USD,HOUR,98777.87,4.362,27/11/2021 01:00:00,27/11/2021 02:00:00,27/11/2021 00:00:00,STOP_LOSS_HIT,SHORT,53810.0,54262.93,52451.22,54262.93,2.376,2.59,0.83,5927.0,2,3.0,-1975.68
07/03/2019 01:00:00,15/06/2023 18:58:20,Gemini_BTCUSD_1h_17_12_17_to_10_03_23.csv,BTC_USD,HOUR,96802.19,37.85,07/03/2019 05:00:00,07/03/2019 04:00:00,07/03/2019 04:00:00,EXPIRED,LONG,3869.0,3885.0,4022.46,3817.85,1.513,3.82,1.34,5808.46,2,3.0,605.6
08/12/2018 18:00:00,15/06/2023 18:58:20,Gemini_BTCUSD_1h_17_12_17_to_10_03_23.csv,BTC_USD,HOUR,97407.79,39.261,08/12/2018 19:00:00,08/12/2018 21:00:00,08/12/2018 19:00:00,STOP_LOSS_HIT,LONG,3387.0,3337.38,3535.87,3337.38,1.365,4.21,1.49,5844.79,2,3.0,-1948.13
23/05/2018 15:00:00,15/06/2023 18:58:20,Gemini_BTCUSD_1h_17_12_17_to_10_03_23.csv,BTC_USD,HOUR,95459.66,17.843,23/05/2018 16:00:00,23/05/2018 18:00:00,23/05/2018 16:00:00,STOP_LOSS_HIT,LONG,7707.0,7600.0,8028.0,7600.0,1.441,4.0,1.41,5727.6,2,3.0,-1909.2
16/02/2023 11:00:00,15/06/2023 18:58:20,Gemini_BTCUSD_1h_17_12_17_to_10_03_23.csv,BTC_USD,HOUR,93550.46,15.929,16/02/2023 15:00:00,16/02/2023 14:00:00,16/02/2023 14:00:00,EXPIRED,SHORT,24573.0,24437.0,24220.61,24690.46,4.184,1.45,0.48,5613.22,2,3.0,2166.34
11/08/2021 09:00:00,15/06/2023 18:58:20,Gemini_BTCUSD_1h_17_12_17_to_10_03_23.csv,BTC_USD,HOUR,95716.8,3.249,11/08/2021 11:00:00,11/08/2021 12:00:00,11/08/2021 12:00:00,EXPIRED,LONG,46121.0,45996.0,47888.81,45531.73,1.566,3.69,1.29,5743.61,2,3.0,-406.12
05/12/2020 04:00:00,15/06/2023 18:58:20,Gemini_BTCUSD_1h_17_12_17_to_10_03_23.csv,BTC_USD,HOUR,95310.68,18.248,05/12/2020 06:00:00,05/12/2020 07:00:00,05/12/2020 07:00:00,EXPIRED,LONG,18900.0,18937.0,19213.4,18795.54,3.619,1.63,0.56,5718.92,2,3.0,675.18
22/06/2020 12:00:00,15/06/2023 18:58:20,Gemini_BTCUSD_1h_17_12_17_to_10_03_23.csv,BTC_USD,HOUR,95985.86,13.597,22/06/2020 13:00:00,22/06/2020 15:00:00,22/06/2020 15:00:00,EXPIRED,LONG,9494.0,9498.0,9917.56,9352.81,1.345,4.27,1.51,5759.15,2,3.0,54.39
24/11/2021 00:00:00,15/06/2023 18:58:20,Gemini_BTCUSD_1h_17_12_17_to_10_03_23.csv,BTC_USD,HOUR,96040.25,6.241,24/11/2021 02:00:00,24/11/2021 03:00:00,24/11/2021 01:00:00,STOP_LOSS_HIT,LONG,57533.0,57225.23,58456.32,57225.23,3.739,1.58,0.54,5762.44,2,3.0,-1920.79
27/08/2022 23:00:00,15/06/2023 18:58:20,Gemini_BTCUSD_1h_17_12_17_to_10_03_23.csv,BTC_USD,HOUR,94119.46,12.073,28/08/2022 00:00:00,28/08/2022 02:00:00,28/08/2022 02:00:00,EXPIRED,SHORT,20035.0,20010.0,19567.25,20190.92,2.57,2.39,0.77,5647.15,2,3.0,301.83
07/10/2021 23:00:00,15/06/2023 18:58:20,Gemini_BTCUSD_1h_17_12_17_to_10_03_23.csv,BTC_USD,HOUR,94421.29,1.977,08/10/2021 00:00:00,08/10/2021 02:00:00,08/10/2021 02:00:00,EXPIRED,LONG,53791.0,53859.0,56656.46,52835.85,1.126,5.06,1.81,5665.01,2,3.0,134.44
24/03/2020 04:00:00,15/06/2023 18:58:20,Gemini_BTCUSD_1h_17_12_17_to_10_03_23.csv,BTC_USD,HOUR,94555.73,50.229,24/03/2020 06:00:00,24/03/2020 07:00:00,24/03/2020 05:00:00,STOP_LOSS_HIT,SHORT,6451.0,6488.65,6338.06,6488.65,3.427,1.78,0.58,5672.86,2,3.0,-1891.12
22/12/2021 05:00:00,15/06/2023 18:58:20,Gemini_BTCUSD_1h_17_12_17_to_10_03_23.csv,BTC_USD,HOUR,92664.61,2.092,22/12/2021 06:00:00,22/12/2021 08:00:00,22/12/2021 08:00:00,EXPIRED,LONG,48977.0,49318.0,51635.31,48090.9,1.106,5.15,1.84,5561.18,2,3.0,713.37
14/04/2018 12:00:00,15/06/2023 18:58:20,Gemini_BTCUSD_1h_17_12_17_to_10_03_23.csv,BTC_USD,HOUR,93377.98,25.989,14/04/2018 14:00:00,14/04/2018 15:00:00,14/04/2018 13:00:00,STOP_LOSS_HIT,SHORT,7899.0,7970.86,7683.43,7970.86,2.198,2.81,0.9,5602.45,2,3.0,-1867.57
01/04/2021 10:00:00,15/06/2023 18:58:20,Gemini_BTCUSD_1h_17_12_17_to_10_03_23.csv,BTC_USD,HOUR,91510.41,5.219,01/04/2021 14:00:00,01/04/2021 13:00:00,01/04/2021 11:00:00,STOP_LOSS_HIT,LONG,58650.0,58299.33,59702.03,58299.33,3.345,1.76,0.6,5490.54,2,3.0,-1830.15
10/02/2023 15:00:00,15/06/2023 18:58:20,Gemini_BTCUSD_1h_17_12_17_to_10_03_23.csv,BTC_USD,HOUR,89680.26,4.219,10/02/2023 19:00:00,10/02/2023 18:00:00,10/02/2023 18:00:00,EXPIRED,LONG,21657.0,21708.0,22932.25,21231.92,1.019,5.56,2.0,5380.28,2,3.0,215.17
31/01/2019 02:00:00,15/06/2023 18:58:20,Gemini_BTCUSD_1h_17_12_17_to_10_03_23.csv,BTC_USD,HOUR,89895.43,103.865,31/01/2019 04:00:00,31/01/2019 05:00:00,31/01/2019 05:00:00,EXPIRED,LONG,3451.0,3444.0,3502.92,3433.69,3.987,1.48,0.5,5392.67,2,3.0,-727.05
16/06/2020 08:00:00,15/06/2023 18:58:20,Gemini_BTCUSD_1h_17_12_17_to_10_03_23.csv,BTC_USD,HOUR,89168.38,20.268,16/06/2020 10:00:00,16/06/2020 11:00:00,16/06/2020 11:00:00,EXPIRED,SHORT,9493.0,9513.0,9229.04,9580.99,2.158,2.86,0.92,5349.94,2,3.0,-405.36
29/06/2020 12:00:00,15/06/2023 18:58:20,Gemini_BTCUSD_1h_17_12_17_to_10_03_23.csv,BTC_USD,HOUR,88763.02,20.507,29/06/2020 13:00:00,29/06/2020 15:00:00,29/06/2020 15:00:00,EXPIRED,LONG,9097.0,9126.0,9356.71,9010.43,2.102,2.78,0.96,5325.87,2,3.0,594.7
23/04/2019 06:00:00,15/06/2023 18:58:20,Gemini_BTCUSD_1h_17_12_17_to_10_03_23.csv,BTC_USD,HOUR,89357.72,21.907,23/04/2019 08:00:00,23/04/2019 09:00:00,23/04/2019 09:00:00,EXPIRED,LONG,5537.0,5536.0,5781.73,5455.42,1.357,4.23,1.5,5361.3,2,3.0,-21.91
23/05/2019 15:00:00,15/06/2023 18:58:20,Gemini_BTCUSD_1h_17_12_17_to_10_03_23.csv,BTC_USD,HOUR,89335.81,17.285,23/05/2019 16:00:00,23/05/2019 18:00:00,23/05/2019 18:00:00,EXPIRED,LONG,7777.0,7776.0,8087.12,7673.63,1.505,3.83,1.35,5360.42,2,3.0,-17.28
12/06/2021 23:00:00,15/06/2023 18:58:20,Gemini_BTCUSD_1h_17_12_17_to_10_03_23.csv,BTC_USD,HOUR,89318.53,5.821,13/06/2021 03:00:00,13/06/2021 02:00:00,13/06/2021 02:00:00,EXPIRED,LONG,35542.0,35475.0,36462.62,35235.13,2.316,2.52,0.87,5358.93,2,3.0,-390.01
29/11/2022 13:00:00,15/06/2023 18:58:20,Gemini_BTCUSD_1h_17_12_17_to_10_03_23.csv,BTC_USD,HOUR,88928.52,7.54,29/11/2022 17:00:00,29/11/2022 16:00:00,29/11/2022 16:00:00,EXPIRED,LONG,16401.0,16411.0,17108.67,16165.11,1.391,4.14,1.46,5335.83,2,3.0,75.4
27/09/2020 15:00:00,15/06/2023 18:58:20,Gemini_BTCUSD_1h_17_12_17_to_10_03_23.csv,BTC_USD,HOUR,89003.92,12.76,27/09/2020 16:00:00,27/09/2020 18:00:00,27/09/2020 18:00:00,EXPIRED,LONG,10756.0,10719.0,11174.54,10616.49,1.542,3.75,1.31,5340.57,2,3.0,-472.12
16/01/2020 23:00:00,15/06/2023 18:58:20,Gemini_BTCUSD_1h_17_12_17_to_10_03_23.csv,BTC_USD,HOUR,88531.8,38.325,17/01/2020 02:00:00,17/01/2020 02:00:00,17/01/2020 02:00:00,EXPIRED,LONG,8715.0,8733.0,8853.59,8668.8,3.773,1.57,0.53,5311.46,2,3.0,689.85
30/04/2019 05:00:00,15/06/2023 18:58:20,Gemini_BTCUSD_1h_17_12_17_to_10_03_23.csv,BTC_USD,HOUR,89221.65,67.059,30/04/2019 06:00:00,30/04/2019 08:00:00,30/04/2019 08:00:00,EXPIRED,LONG,5139.0,5160.0,5218.82,5112.39,3.862,1.53,0.52,5352.65,2,3.0,1408.24
13/11/2020 12:00:00,15/06/2023 18:58:20,Gemini_BTCUSD_1h_17_12_17_to_10_03_23.csv,BTC_USD,HOUR,90629.89,23.0,13/11/2020 15:00:00,13/11/2020 15:00:00,13/11/2020 15:00:00,EXPIRED,SHORT,16272.0,16131.0,16035.57,16350.81,4.129,1.47,0.48,5437.89,2,3.0,3243.0
15/10/2021 05:00:00,15/06/2023 18:58:20,Gemini_BTCUSD_1h_17_12_17_to_10_03_23.csv,BTC_USD,HOUR,93872.89,2.988,15/10/2021 06:00:00,15/10/2021 08:00:00,15/10/2021 08:00:00,STOP_LOSS_HIT,LONG,59544.0,58915.64,61429.1,58915.64,1.895,3.07,1.07,5632.68,2,3.0,-1877.54
05/11/2019 05:00:00,15/06/2023 18:58:20,Gemini_BTCUSD_1h_17_12_17_to_10_03_23.csv,BTC_USD,HOUR,91995.35,23.898,05/11/2019 06:00:00,05/11/2019 08:00:00,05/11/2019 06:00:00,STOP_LOSS_HIT,LONG,9404.0,9327.01,9634.99,9327.01,2.443,2.4,0.83,5520.2,2,3.0,-1839.91
09/01/2018 05:00:00,15/06/2023 18:58:21,Gemini_BTCUSD_1h_17_12_17_to_10_03_23.csv,BTC_USD,HOUR,90155.44,14.357,09/01/2018 06:00:00,09/01/2018 08:00:00,09/01/2018 06:00:00,STOP_LOSS_HIT,LONG,15050.0,14924.41,15426.76,14924.41,2.397,2.44,0.84,5409.14,2,3.0,-1803.1
28/09/2019 00:00:00,15/06/2023 18:58:21,Gemini_BTCUSD_1h_17_12_17_to_10_03_23.csv,BTC_USD,HOUR,88352.34,12.208,28/09/2019 01:00:00,28/09/2019 03:00:00,28/09/2019 03:00:00,EXPIRED,LONG,8221.0,8185.0,8655.25,8076.25,1.136,5.02,1.79,5301.32,2,3.0,-439.49
18/08/2018 03:00:00,15/06/2023 18:58:21,Gemini_BTCUSD_1h_17_12_17_to_10_03_23.csv,BTC_USD,HOUR,87912.85,17.94,18/08/2018 07:00:00,18/08/2018 06:00:00,18/08/2018 06:00:00,EXPIRED,LONG,6526.0,6473.0,6820.02,6427.99,1.332,4.31,1.52,5274.72,2,3.0,-950.82
21/04/2022 05:00:00,15/06/2023 18:58:21,Gemini_BTCUSD_1h_17_12_17_to_10_03_23.csv,BTC_USD,HOUR,86962.03,7.177,21/04/2022 06:00:00,21/04/2022 08:00:00,21/04/2022 08:00:00,EXPIRED,LONG,41481.0,41950.0,42207.99,41238.67,3.423,1.72,0.59,5217.61,2,3.0,3366.01
16/11/2022 21:00:00,15/06/2023 18:58:21,Gemini_BTCUSD_1h_17_12_17_to_10_03_23.csv,BTC_USD,HOUR,90328.04,6.546,16/11/2022 22:00:00,17/11/2022 00:00:00,17/11/2022 00:00:00,EXPIRED,LONG,16520.0,16665.0,17347.9,16244.03,1.197,4.77,1.7,5419.43,2,3.0,949.17
04/09/2022 01:00:00,15/06/2023 18:58:21,Gemini_BTCUSD_1h_17_12_17_to_10_03_23.csv,BTC_USD,HOUR,91277.21,4.888,04/09/2022 03:00:00,04/09/2022 04:00:00,04/09/2022 04:00:00,EXPIRED,LONG,19786.0,19804.0,20906.36,19412.55,1.06,5.36,1.92,5476.32,2,3.0,87.98
07/09/2022 21:00:00,15/06/2023 18:58:21,Gemini_BTCUSD_1h_17_12_17_to_10_03_23.csv,BTC_USD,HOUR,91365.19,6.532,07/09/2022 22:00:00,08/09/2022 00:00:00,08/09/2022 00:00:00,EXPIRED,LONG,19369.0,19306.0,20208.28,19089.24,1.385,4.15,1.47,5482.18,2,3.0,-411.52
04/02/2022 00:00:00,15/06/2023 18:58:21,Gemini_BTCUSD_1h_17_12_17_to_10_03_23.csv,BTC_USD,HOUR,90953.67,4.181,04/02/2022 01:00:00,04/02/2022 03:00:00,04/02/2022 03:00:00,EXPIRED,LONG,37215.0,37331.0,38520.35,36779.88,1.711,3.39,1.18,5457.67,2,3.0,485.0
20/02/2018 07:00:00,15/06/2023 18:58:21,Gemini_BTCUSD_1h_17_12_17_to_10_03_23.csv,BTC_USD,HOUR,91438.67,30.098,20/02/2018 08:00:00,20/02/2018 10:00:00,20/02/2018 08:00:00,STOP_LOSS_HIT,LONG,11550.0,11489.24,11732.28,11489.24,3.802,1.55,0.53,5486.26,2,3.0,-1828.75
28/11/2021 08:00:00,15/06/2023 18:58:21,Gemini_BTCUSD_1h_17_12_17_to_10_03_23.csv,BTC_USD,HOUR,89609.92,5.642,28/11/2021 11:00:00,28/11/2021 11:00:00,28/11/2021 11:00:00,EXPIRED,LONG,54429.0,54531.0,55381.94,54111.36,3.427,1.72,0.59,5376.49,2,3.0,575.48
28/12/2019 03:00:00,15/06/2023 18:58:21,Gemini_BTCUSD_1h_17_12_17_to_10_03_23.csv,BTC_USD,HOUR,90185.4,41.388,28/12/2019 07:00:00,28/12/2019 06:00:00,28/12/2019 05:00:00,STOP_LOSS_HIT,SHORT,7277.0,7320.58,7146.28,7320.58,3.34,1.83,0.6,5410.24,2,3.0,-1803.69
16/10/2022 11:00:00,15/06/2023 18:58:21,Gemini_BTCUSD_1h_17_12_17_to_10_03_23.csv,BTC_USD,HOUR,88381.71,15.712,16/10/2022 13:00:00,16/10/2022 14:00:00,16/10/2022 14:00:00,EXPIRED,LONG,19144.0,19132.0,19481.5,19031.5,3.403,1.73,0.59,5302.8,2,3.0,-188.54
11/07/2021 10:00:00,15/06/2023 18:58:21,Gemini_BTCUSD_1h_17_12_17_to_10_03_23.csv,BTC_USD,HOUR,88193.17,9.076,11/07/2021 13:00:00,11/07/2021 13:00:00,11/07/2021 13:00:00,EXPIRED,LONG,33761.0,33922.0,34344.02,33566.66,3.474,1.7,0.58,5291.49,2,3.0,1461.24
24/01/2018 05:00:00,15/06/2023 18:58:21,Gemini_BTCUSD_1h_17_12_17_to_10_03_23.csv,BTC_USD,HOUR,89654.41,12.484,24/01/2018 06:00:00,24/01/2018 08:00:00,24/01/2018 06:00:00,TAKE_PROFIT_HIT,LONG,10651.0,11081.9,11081.9,10507.37,1.483,3.89,1.37,5379.36,2,3.0,5379.36
17/02/2018 06:00:00,15/06/2023 18:58:21,Gemini_BTCUSD_1h_17_12_17_to_10_03_23.csv,BTC_USD,HOUR,95033.77,12.157,17/02/2018 08:00:00,17/02/2018 09:00:00,17/02/2018 09:00:00,EXPIRED,LONG,10791.0,10700.0,11260.01,10634.66,1.38,4.17,1.47,5701.75,2,3.0,-1106.29
09/12/2022 04:00:00,15/06/2023 18:58:21,Gemini_BTCUSD_1h_17_12_17_to_10_03_23.csv,BTC_USD,HOUR,93927.48,9.608,09/12/2022 05:00:00,09/12/2022 07:00:00,09/12/2022 07:00:00,EXPIRED,LONG,17221.0,17214.0,17807.59,17025.47,1.762,3.29,1.15,5635.96,2,3.0,-67.26
11/04/2020 04:00:00,15/06/2023 18:58:21,Gemini_BTCUSD_1h_17_12_17_to_10_03_23.csv,BTC_USD,HOUR,93860.22,50.914,11/04/2020 07:00:00,11/04/2020 07:00:00,11/04/2020 07:00:00,EXPIRED,SHORT,6923.0,6892.0,6812.38,6959.87,3.755,1.62,0.53,5632.11,2,3.0,1578.33
08/09/2019 23:00:00,15/06/2023 18:58:21,Gemini_BTCUSD_1h_17_12_17_to_10_03_23.csv,BTC_USD,HOUR,95438.55,16.869,09/09/2019 03:00:00,09/09/2019 02:00:00,09/09/2019 02:00:00,EXPIRED,LONG,10407.0,10316.0,10746.46,10293.85,1.839,3.16,1.1,5726.35,2,3.0,-1535.08
25/09/2022 10:00:00,15/06/2023 18:58:21,Gemini_BTCUSD_1h_17_12_17_to_10_03_23.csv,BTC_USD,HOUR,93903.47,11.839,25/09/2022 13:00:00,25/09/2022 13:00:00,25/09/2022 13:00:00,EXPIRED,SHORT,19075.0,18929.0,18599.11,19233.63,2.405,2.56,0.82,5634.06,2,3.0,1728.49
19/01/2021 09:00:00,15/06/2023 18:58:21,Gemini_BTCUSD_1h_17_12_17_to_10_03_23.csv,BTC_USD,HOUR,95631.96,8.743,19/01/2021 10:00:00,19/01/2021 12:00:00,19/01/2021 10:00:00,STOP_LOSS_HIT,LONG,37086.0,36867.23,37742.31,36867.23,3.391,1.74,0.59,5738.12,2,3.0,-1912.71
11/04/2018 09:00:00,15/06/2023 18:58:21,Gemini_BTCUSD_1h_17_12_17_to_10_03_23.csv,BTC_USD,HOUR,93719.25,32.901,11/04/2018 10:00:00,11/04/2018 12:00:00,11/04/2018 12:00:00,EXPIRED,LONG,6850.0,6862.0,7020.9,6793.03,2.405,2.43,0.84,5622.78,2,3.0,394.81
05/05/2018 01:00:00,15/06/2023 18:58:21,Gemini_BTCUSD_1h_17_12_17_to_10_03_23.csv,BTC_USD,HOUR,94114.06,11.325,05/05/2018 02:00:00,05/05/2018 04:00:00,05/05/2018 04:00:00,EXPIRED,LONG,9780.0,9846.0,10278.6,9613.8,1.177,4.85,1.73,5646.65,2,3.0,747.45
12/05/2021 00:00:00,15/06/2023 18:58:21,Gemini_BTCUSD_1h_17_12_17_to_10_03_23.csv,BTC_USD,HOUR,94861.51,5.794,12/05/2021 03:00:00,12/05/2021 03:00:00,12/05/2021 01:00:00,STOP_LOSS_HIT,LONG,57400.0,57072.53,58382.41,57072.53,3.506,1.68,0.57,5692.08,2,3.0,-1897.36
12/12/2021 17:00:00,15/06/2023 18:58:21,Gemini_BTCUSD_1h_17_12_17_to_10_03_23.csv,BTC_USD,HOUR,92964.15,2.847,12/12/2021 19:00:00,12/12/2021 20:00:00,12/12/2021 20:00:00,EXPIRED,LONG,50305.0,50294.0,52264.13,49651.96,1.541,3.75,1.32,5577.64,2,3.0,-31.32
12/01/2018 23:00:00,15/06/2023 18:58:21,Gemini_BTCUSD_1h_17_12_17_to_10_03_23.csv,BTC_USD,HOUR,92932.83,24.647,13/01/2018 00:00:00,13/01/2018 02:00:00,13/01/2018 00:00:00,TAKE_PROFIT_HIT,LONG,13815.0,14041.23,14041.23,13739.59,3.664,1.61,0.55,5575.89,2,3.0,5575.89
03/01/2023 01:00:00,15/06/2023 18:58:21,Gemini_BTCUSD_1h_17_12_17_to_10_03_23.csv,BTC_USD,HOUR,98508.72,23.149,03/01/2023 02:00:00,03/01/2023 04:00:00,03/01/2023 04:00:00,EXPIRED,LONG,16666.0,16680.0,16921.34,16580.89,3.916,1.51,0.51,5910.87,2,3.0,324.09
24/07/2018 19:00:00,15/06/2023 18:58:21,Gemini_BTCUSD_1h_17_12_17_to_10_03_23.csv,BTC_USD,HOUR,98832.81,51.867,24/07/2018 22:00:00,24/07/2018 22:00:00,24/07/2018 20:00:00,STOP_LOSS_HIT,LONG,8258.0,8219.89,8372.34,8219.89,4.334,1.37,0.46,5930.47,2,3.0,-1976.65
16/04/2022 22:00:00,15/06/2023 18:58:21,Gemini_BTCUSD_1h_17_12_17_to_10_03_23.csv,BTC_USD,HOUR,96856.16,3.076,16/04/2022 23:00:00,17/04/2022 01:00:00,17/04/2022 01:00:00,EXPIRED,LONG,40432.0,40404.0,42321.53,39802.16,1.284,4.46,1.58,5812.19,2,3.0,-86.13
19/03/2022 19:00:00,15/06/2023 18:58:21,Gemini_BTCUSD_1h_17_12_17_to_10_03_23.csv,BTC_USD,HOUR,96770.03,3.067,19/03/2022 20:00:00,19/03/2022 22:00:00,19/03/2022 22:00:00,EXPIRED,LONG,42061.0,41979.0,43953.83,41430.06,1.333,4.31,1.52,5805.31,2,3.0,-251.49
16/05/2020 01:00:00,15/06/2023 18:58:21,Gemini_BTCUSD_1h_17_12_17_to_10_03_23.csv,BTC_USD,HOUR,96518.54,35.887,16/05/2020 02:00:00,16/05/2020 04:00:00,16/05/2020 04:00:00,EXPIRED,LONG,9408.0,9500.0,9569.37,9354.21,3.498,1.69,0.58,5791.09,2,3.0,3301.6
23/05/2019 21:00:00,15/06/2023 18:58:21,Gemini_BTCUSD_1h_17_12_17_to_10_03_23.csv,BTC_USD,HOUR,99820.14,21.135,23/05/2019 22:00:00,24/05/2019 00:00:00,24/05/2019 00:00:00,EXPIRED,LONG,7922.0,7877.0,8205.37,7827.54,1.677,3.45,1.21,5989.02,2,3.0,-951.07
20/07/2022 06:00:00,15/06/2023 18:58:21,Gemini_BTCUSD_1h_17_12_17_to_10_03_23.csv,BTC_USD,HOUR,98869.07,10.229,20/07/2022 08:00:00,20/07/2022 09:00:00,20/07/2022 07:00:00,STOP_LOSS_HIT,LONG,23791.0,23597.68,24370.97,23597.68,2.461,2.38,0.82,5932.51,2,3.0,-1977.47
20/01/2020 17:00:00,15/06/2023 18:58:21,Gemini_BTCUSD_1h_17_12_17_to_10_03_23.csv,BTC_USD,HOUR,96891.6,13.237,20/01/2020 18:00:00,20/01/2020 20:00:00,20/01/2020 20:00:00,EXPIRED,LONG,8635.0,8657.0,9074.18,8488.61,1.18,4.84,1.72,5813.43,2,3.0,291.21
01/01/2022 20:00:00,15/06/2023 18:58:21,Gemini_BTCUSD_1h_17_12_17_to_10_03_23.csv,BTC_USD,HOUR,97182.81,4.132,01/01/2022 21:00:00,01/01/2022 23:00:00,01/01/2022 23:00:00,EXPIRED,LONG,47425.0,47746.0,48836.2,46954.6,2.016,2.89,1.0,5831.08,2,3.0,1326.37
08/07/2021 16:00:00,15/06/2023 18:58:21,Gemini_BTCUSD_1h_17_12_17_to_10_03_23.csv,BTC_USD,HOUR,98509.18,11.047,08/07/2021 20:00:00,08/07/2021 19:00:00,08/07/2021 19:00:00,STOP_LOSS_HIT,SHORT,32933.0,33111.35,32397.97,33111.35,3.693,1.65,0.54,5910.48,2,3.0,-1970.23
10/09/2018 20:00:00,15/06/2023 18:58:21,Gemini_BTCUSD_1h_17_12_17_to_10_03_23.csv,BTC_USD,HOUR,96538.95,20.692,10/09/2018 22:00:00,10/09/2018 23:00:00,10/09/2018 23:00:00,EXPIRED,LONG,6300.0,6300.0,6579.92,6206.69,1.35,4.25,1.5,5792.1,2,3.0,0.0
05/10/2018 12:00:00,15/06/2023 18:58:21,Gemini_BTCUSD_1h_17_12_17_to_10_03_23.csv,BTC_USD,HOUR,96538.95,15.562,05/10/2018 16:00:00,05/10/2018 15:00:00,05/10/2018 15:00:00,EXPIRED,LONG,6536.0,6547.0,6908.22,6411.93,1.054,5.39,1.93,5792.49,2,3.0,171.18
07/02/2020 10:00:00,15/06/2023 18:58:21,Gemini_BTCUSD_1h_17_12_17_to_10_03_23.csv,BTC_USD,HOUR,96710.13,12.323,07/02/2020 12:00:00,07/02/2020 13:00:00,07/02/2020 13:00:00,EXPIRED,LONG,9802.0,9771.0,10272.89,9645.04,1.249,4.58,1.63,5802.78,2,3.0,-382.01
15/08/2022 21:00:00,15/06/2023 18:58:21,Gemini_BTCUSD_1h_17_12_17_to_10_03_23.csv,BTC_USD,HOUR,96328.12,12.91,16/08/2022 01:00:00,16/08/2022 00:00:00,15/08/2022 23:00:00,STOP_LOSS_HIT,LONG,24030.0,23880.77,24477.68,23880.77,3.221,1.83,0.62,5779.55,2,3.0,-1926.56
05/09/2020 18:00:00,15/06/2023 18:58:21,Gemini_BTCUSD_1h_17_12_17_to_10_03_23.csv,BTC_USD,HOUR,94401.56,16.048,05/09/2020 20:00:00,05/09/2020 21:00:00,05/09/2020 21:00:00,EXPIRED,SHORT,10152.0,10084.0,9799.06,10269.65,1.726,3.6,1.15,5663.98,2,3.0,1091.26
04/07/2021 08:00:00,15/06/2023 18:58:21,Gemini_BTCUSD_1h_17_12_17_to_10_03_23.csv,BTC_USD,HOUR,95492.82,5.083,04/07/2021 09:00:00,04/07/2021 11:00:00,04/07/2021 11:00:00,EXPIRED,LONG,35545.0,35530.0,36672.31,35169.23,1.892,3.07,1.07,5730.12,2,3.0,-76.24
13/09/2018 13:00:00,15/06/2023 18:58:21,Gemini_BTCUSD_1h_17_12_17_to_10_03_23.csv,BTC_USD,HOUR,95416.58,17.495,13/09/2018 14:00:00,13/09/2018 16:00:00,13/09/2018 16:00:00,EXPIRED,LONG,6495.0,6508.0,6822.24,6385.92,1.191,4.8,1.71,5725.06,2,3.0,227.44
27/12/2017 05:00:00,15/06/2023 18:58:21,Gemini_BTCUSD_1h_17_12_17_to_10_03_23.csv,BTC_USD,HOUR,95644.02,12.365,27/12/2017 06:00:00,27/12/2017 08:00:00,27/12/2017 06:00:00,STOP_LOSS_HIT,LONG,16418.0,16263.3,16882.1,16263.3,2.123,2.75,0.95,5738.6,2,3.0,-1912.87
19/07/2021 01:00:00,15/06/2023 18:58:21,Gemini_BTCUSD_1h_17_12_17_to_10_03_23.csv,BTC_USD,HOUR,93731.15,11.974,19/07/2021 03:00:00,19/07/2021 04:00:00,19/07/2021 04:00:00,EXPIRED,LONG,31603.0,31752.0,32072.67,31446.44,4.037,1.46,0.5,5623.83,2,3.0,1784.13
07/10/2020 09:00:00,15/06/2023 18:58:21,Gemini_BTCUSD_1h_17_12_17_to_10_03_23.csv,BTC_USD,HOUR,95515.28,12.724,07/10/2020 13:00:00,07/10/2020 12:00:00,07/10/2020 12:00:00,EXPIRED,LONG,10594.0,10633.0,11044.42,10443.86,1.411,4.08,1.44,5731.14,2,3.0,496.24
23/06/2022 01:00:00,15/06/2023 18:58:21,Gemini_BTCUSD_1h_17_12_17_to_10_03_23.csv,BTC_USD,HOUR,96011.52,9.643,23/06/2022 02:00:00,23/06/2022 04:00:00,23/06/2022 04:00:00,STOP_LOSS_HIT,LONG,20353.0,20153.87,20950.41,20153.87,2.044,2.85,0.99,5760.82,2,3.0,-1920.21
10/01/2019 05:00:00,15/06/2023 18:58:21,Gemini_BTCUSD_1h_17_12_17_to_10_03_23.csv,BTC_USD,HOUR,94091.31,53.144,10/01/2019 07:00:00,10/01/2019 08:00:00,10/01/2019 06:00:00,TAKE_PROFIT_HIT,SHORT,4027.0,3920.77,3920.77,4062.41,2.275,2.71,0.87,5645.49,2,3.0,5645.49
05/09/2021 09:00:00,15/06/2023 18:58:21,Gemini_BTCUSD_1h_17_12_17_to_10_03_23.csv,BTC_USD,HOUR,99736.8,2.982,05/09/2021 10:00:00,05/09/2021 12:00:00,05/09/2021 12:00:00,EXPIRED,LONG,50185.0,50128.0,52191.8,49516.07,1.5,3.85,1.35,5984.28,2,3.0,-169.97
22/03/2022 14:00:00,15/06/2023 18:58:21,Gemini_BTCUSD_1h_17_12_17_to_10_03_23.csv,BTC_USD,HOUR,99566.83,4.673,22/03/2022 18:00:00,22/03/2022 17:00:00,22/03/2022 17:00:00,EXPIRED,LONG,42796.0,42631.0,44074.42,42369.87,2.009,2.9,1.01,5974.06,2,3.0,-771.04
22/07/2019 07:00:00,15/06/2023 18:58:21,Gemini_BTCUSD_1h_17_12_17_to_10_03_23.csv,BTC_USD,HOUR,98795.79,31.309,22/07/2019 09:00:00,22/07/2019 10:00:00,22/07/2019 10:00:00,TAKE_PROFIT_HIT,SHORT,10600.0,10410.67,10410.67,10663.11,3.359,1.82,0.59,5927.73,2,3.0,5927.73
31/10/2020 01:00:00,15/06/2023 18:58:21,Gemini_BTCUSD_1h_17_12_17_to_10_03_23.csv,BTC_USD,HOUR,104723.52,12.652,31/10/2020 02:00:00,31/10/2020 04:00:00,31/10/2020 03:00:00,STOP_LOSS_HIT,LONG,13651.0,13485.46,14147.63,13485.46,1.649,3.51,1.23,6283.36,2,3.0,-2094.41
02/11/2019 15:00:00,15/06/2023 18:58:21,Gemini_BTCUSD_1h_17_12_17_to_10_03_23.csv,BTC_USD,HOUR,102629.11,11.952,02/11/2019 17:00:00,02/11/2019 18:00:00,02/11/2019 18:00:00,EXPIRED,LONG,9336.0,9307.0,9851.19,9164.27,1.087,5.23,1.87,6157.55,2,3.0,-346.61
28/07/2018 19:00:00,15/06/2023 18:58:21,Gemini_BTCUSD_1h_17_12_17_to_10_03_23.csv,BTC_USD,HOUR,102282.5,30.252,28/07/2018 23:00:00,28/07/2018 22:00:00,28/07/2018 22:00:00,EXPIRED,SHORT,8191.0,8177.0,7988.15,8258.62,2.423,2.54,0.82,6136.62,2,3.0,423.53
19/04/2022 03:00:00,15/06/2023 18:58:21,Gemini_BTCUSD_1h_17_12_17_to_10_03_23.csv,BTC_USD,HOUR,102706.03,10.03,19/04/2022 04:00:00,19/04/2022 06:00:00,19/04/2022 06:00:00,EXPIRED,LONG,40709.0,40726.0,41323.4,40504.2,3.976,1.49,0.51,6162.43,2,3.0,170.51
08/09/2022 22:00:00,15/06/2023 18:58:21,Gemini_BTCUSD_1h_17_12_17_to_10_03_23.csv,BTC_USD,HOUR,102876.54,7.504,09/09/2022 00:00:00,09/09/2022 01:00:00,09/09/2022 01:00:00,EXPIRED,LONG,19310.0,19345.0,20132.53,19035.82,1.409,4.09,1.44,6172.27,2,3.0,262.64
12/04/2022 10:00:00,15/06/2023 18:58:21,Gemini_BTCUSD_1h_17_12_17_to_10_03_23.csv,BTC_USD,HOUR,103139.18,5.979,12/04/2022 11:00:00,12/04/2022 13:00:00,12/04/2022 13:00:00,EXPIRED,LONG,40161.0,40416.0,41196.08,39815.97,2.328,2.51,0.87,6188.74,2,3.0,1524.65
28/12/2019 22:00:00,15/06/2023 18:58:21,Gemini_BTCUSD_1h_17_12_17_to_10_03_23.csv,BTC_USD,HOUR,104663.83,56.821,28/12/2019 23:00:00,29/12/2019 01:00:00,29/12/2019 01:00:00,EXPIRED,LONG,7306.0,7278.0,7416.52,7269.16,3.966,1.49,0.51,6279.86,2,3.0,-1590.99
13/02/2021 16:00:00,15/06/2023 18:58:21,Gemini_BTCUSD_1h_17_12_17_to_10_03_23.csv,BTC_USD,HOUR,103072.84,3.053,13/02/2021 17:00:00,13/02/2021 19:00:00,13/02/2021 19:00:00,EXPIRED,LONG,47205.0,46940.0,49230.7,46529.77,1.398,4.11,1.45,6184.46,2,3.0,-809.04
17/06/2019 02:00:00,15/06/2023 18:58:21,Gemini_BTCUSD_1h_17_12_17_to_10_03_23.csv,BTC_USD,HOUR,102263.8,43.095,17/06/2019 04:00:00,17/06/2019 05:00:00,17/06/2019 04:00:00,TAKE_PROFIT_HIT,LONG,9100.0,9242.38,9242.38,9052.54,3.835,1.54,0.52,6135.87,2,3.0,6135.87
02/10/2019 13:00:00,15/06/2023 18:58:21,Gemini_BTCUSD_1h_17_12_17_to_10_03_23.csv,BTC_USD,HOUR,108399.67,14.861,02/10/2019 15:00:00,02/10/2019 16:00:00,02/10/2019 16:00:00,EXPIRED,LONG,8226.0,8237.0,8663.64,8080.12,1.128,5.05,1.81,6503.77,2,3.0,163.47
11/02/2021 12:00:00,15/06/2023 18:58:21,Gemini_BTCUSD_1h_17_12_17_to_10_03_23.csv,BTC_USD,HOUR,108563.14,3.036,11/02/2021 13:00:00,11/02/2021 15:00:00,11/02/2021 15:00:00,EXPIRED,LONG,46560.0,48034.0,48705.62,45844.8,1.302,4.41,1.56,6514.1,2,3.0,4475.06
29/05/2022 00:00:00,15/06/2023 18:58:21,Gemini_BTCUSD_1h_17_12_17_to_10_03_23.csv,BTC_USD,HOUR,113038.2,14.86,29/05/2022 02:00:00,29/05/2022 03:00:00,29/05/2022 02:00:00,STOP_LOSS_HIT,LONG,29001.0,28848.86,29457.43,28848.86,3.812,1.55,0.53,6782.55,2,3.0,-2260.8
08/09/2018 07:00:00,15/06/2023 18:58:21,Gemini_BTCUSD_1h_17_12_17_to_10_03_23.csv,BTC_USD,HOUR,110777.4,64.991,08/09/2018 08:00:00,08/09/2018 10:00:00,08/09/2018 10:00:00,EXPIRED,LONG,6446.0,6452.0,6548.28,6411.91,3.782,1.56,0.53,6647.28,2,3.0,389.95
02/06/2021 12:00:00,15/06/2023 18:58:21,Gemini_BTCUSD_1h_17_12_17_to_10_03_23.csv,BTC_USD,HOUR,111167.35,8.662,02/06/2021 16:00:00,02/06/2021 15:00:00,02/06/2021 14:00:00,TAKE_PROFIT_HIT,LONG,37295.0,38065.08,38065.08,37038.31,2.906,2.02,0.69,6670.43,2,3.0,6670.43
14/04/2019 11:00:00,15/06/2023 18:58:21,Gemini_BTCUSD_1h_17_12_17_to_10_03_23.csv,BTC_USD,HOUR,117837.78,54.643,14/04/2019 13:00:00,14/04/2019 14:00:00,14/04/2019 14:00:00,EXPIRED,SHORT,5074.0,5075.0,4944.61,5117.13,2.353,2.62,0.84,7070.26,2,3.0,-54.64
31/07/2019 17:00:00,15/06/2023 18:58:21,Gemini_BTCUSD_1h_17_12_17_to_10_03_23.csv,BTC_USD,HOUR,117783.14,16.694,31/07/2019 18:00:00,31/07/2019 20:00:00,31/07/2019 20:00:00,EXPIRED,LONG,10031.0,10024.0,10454.32,9889.89,1.422,4.05,1.43,7066.9,2,3.0,-116.86
