Open,Last update,Platform,Symbol,Timeframe,Account balance at open,Size,Expected close,Expiry,Close,Status,Side,Opening price,Closing price,Take profit,Stop loss,Leverage,TP price %,SL price %,Expected profit,Risk %,R/R ratio,PnL
08/11/2020 07:00:00,16/06/2023 15:50:22,Gemini_BTCUSD_1h_17_12_17_to_10_03_23.csv,BTC_USD,HOUR,100000.0,0.134,08/11/2020 09:00:00,08/11/2020 10:00:00,08/11/2020 10:00:00,EXPIRED,LONG,14956.0,15170.0,15306.14,0.0,0.02,2.29,0.0,46.92,2,0.0,28.68
08/04/2019 16:00:00,16/06/2023 15:50:22,Gemini_BTCUSD_1h_17_12_17_to_10_03_23.csv,BTC_USD,HOUR,100028.68,0.384,08/04/2019 17:00:00,08/04/2019 19:00:00,08/04/2019 19:00:00,EXPIRED,LONG,5215.0,5206.0,5453.48,0.0,0.02,4.37,0.0,91.58,2,0.0,-3.46
15/11/2020 09:00:00,16/06/2023 15:50:22,Gemini_BTCUSD_1h_17_12_17_to_10_03_23.csv,BTC_USD,HOUR,100025.22,0.124,15/11/2020 10:00:00,15/11/2020 12:00:00,15/11/2020 12:00:00,EXPIRED,LONG,16089.0,15997.0,17193.55,0.0,0.02,6.42,0.0,136.96,2,0.1,-11.41
26/04/2020 05:00:00,16/06/2023 15:50:22,Gemini_BTCUSD_1h_17_12_17_to_10_03_23.csv,BTC_USD,HOUR,100013.81,0.265,26/04/2020 06:00:00,26/04/2020 08:00:00,26/04/2020 08:00:00,EXPIRED,LONG,7540.0,7559.0,7823.05,0.0,0.02,3.62,0.0,75.01,2,0.0,5.04
09/02/2018 08:00:00,16/06/2023 15:50:22,Gemini_BTCUSD_1h_17_12_17_to_10_03_23.csv,BTC_USD,HOUR,100018.85,0.248,09/02/2018 10:00:00,09/02/2018 11:00:00,09/02/2018 11:00:00,EXPIRED,LONG,8066.0,8259.0,8677.01,0.0,0.02,7.04,0.0,151.53,2,0.1,47.86
25/05/2022 18:00:00,16/06/2023 15:50:22,Gemini_BTCUSD_1h_17_12_17_to_10_03_23.csv,BTC_USD,HOUR,100066.71,0.067,25/05/2022 21:00:00,25/05/2022 21:00:00,25/05/2022 21:00:00,EXPIRED,LONG,29866.0,29800.0,31271.91,0.0,0.02,4.5,0.0,94.2,2,0.0,-4.42
03/06/2021 23:00:00,16/06/2023 15:50:22,Gemini_BTCUSD_1h_17_12_17_to_10_03_23.csv,BTC_USD,HOUR,100062.29,0.051,04/06/2021 00:00:00,04/06/2021 02:00:00,04/06/2021 02:00:00,EXPIRED,LONG,39252.0,37795.0,42875.39,0.0,0.02,8.45,0.0,184.79,2,0.1,-74.31
13/03/2018 20:00:00,16/06/2023 15:50:22,Gemini_BTCUSD_1h_17_12_17_to_10_03_23.csv,BTC_USD,HOUR,99987.98,0.221,13/03/2018 21:00:00,13/03/2018 23:00:00,13/03/2018 23:00:00,EXPIRED,LONG,9067.0,9147.0,9289.85,0.0,0.02,2.4,0.0,49.25,2,0.0,17.68
23/11/2019 19:00:00,16/06/2023 15:50:22,Gemini_BTCUSD_1h_17_12_17_to_10_03_23.csv,BTC_USD,HOUR,100005.66,0.274,23/11/2019 23:00:00,23/11/2019 22:00:00,23/11/2019 22:00:00,EXPIRED,LONG,7291.0,7317.0,7473.03,0.0,0.02,2.44,0.0,49.88,2,0.0,7.12
14/10/2020 00:00:00,16/06/2023 15:50:22,Gemini_BTCUSD_1h_17_12_17_to_10_03_23.csv,BTC_USD,HOUR,100012.78,0.174,14/10/2020 04:00:00,14/10/2020 03:00:00,14/10/2020 03:00:00,EXPIRED,LONG,11486.0,11400.0,12195.43,0.0,0.02,5.82,0.0,123.44,2,0.1,-14.96
17/07/2020 19:00:00,16/06/2023 15:50:22,Gemini_BTCUSD_1h_17_12_17_to_10_03_23.csv,BTC_USD,HOUR,99997.82,0.218,17/07/2020 20:00:00,17/07/2020 22:00:00,17/07/2020 22:00:00,EXPIRED,LONG,9167.0,9165.0,9399.01,0.0,0.02,2.47,0.0,50.58,2,0.0,-0.44
30/08/2021 16:00:00,16/06/2023 15:50:22,Gemini_BTCUSD_1h_17_12_17_to_10_03_23.csv,BTC_USD,HOUR,99997.38,0.041,30/08/2021 17:00:00,30/08/2021 19:00:00,30/08/2021 19:00:00,EXPIRED,LONG,48201.0,48643.0,50435.84,0.0,0.02,4.43,0.0,91.63,2,0.0,18.12
10/05/2018 16:00:00,16/06/2023 15:50:22,Gemini_BTCUSD_1h_17_12_17_to_10_03_23.csv,BTC_USD,HOUR,100015.5,0.214,10/05/2018 17:00:00,10/05/2018 19:00:00,10/05/2018 19:00:00,EXPIRED,LONG,9344.0,9093.0,10098.38,0.0,0.02,7.47,0.0,161.44,2,0.1,-53.71
29/06/2018 16:00:00,16/06/2023 15:50:22,Gemini_BTCUSD_1h_17_12_17_to_10_03_23.csv,BTC_USD,HOUR,99961.79,0.34,29/06/2018 17:00:00,29/06/2018 19:00:00,29/06/2018 19:00:00,EXPIRED,LONG,5875.0,5880.0,6240.6,0.0,0.02,5.86,0.0,124.3,2,0.1,1.7
08/04/2018 12:00:00,16/06/2023 15:50:22,Gemini_BTCUSD_1h_17_12_17_to_10_03_23.csv,BTC_USD,HOUR,99963.49,0.282,08/04/2018 13:00:00,08/04/2018 15:00:00,08/04/2018 15:00:00,EXPIRED,LONG,7081.0,7039.0,7654.05,0.0,0.02,7.49,0.0,161.6,2,0.1,-11.84
11/09/2022 19:00:00,16/06/2023 15:50:22,Gemini_BTCUSD_1h_17_12_17_to_10_03_23.csv,BTC_USD,HOUR,99951.65,0.092,11/09/2022 20:00:00,11/09/2022 22:00:00,11/09/2022 22:00:00,EXPIRED,LONG,21631.0,21634.0,22487.89,0.0,0.02,3.81,0.0,78.83,2,0.0,0.28
21/08/2021 21:00:00,16/06/2023 15:50:22,Gemini_BTCUSD_1h_17_12_17_to_10_03_23.csv,BTC_USD,HOUR,99951.93,0.041,22/08/2021 01:00:00,22/08/2021 00:00:00,22/08/2021 00:00:00,EXPIRED,LONG,49200.0,48994.0,50324.03,0.0,0.02,2.23,0.0,46.09,2,0.0,-8.45
12/06/2019 19:00:00,16/06/2023 15:50:22,Gemini_BTCUSD_1h_17_12_17_to_10_03_23.csv,BTC_USD,HOUR,99943.48,0.245,12/06/2019 20:00:00,12/06/2019 22:00:00,12/06/2019 22:00:00,EXPIRED,LONG,8172.0,8160.0,8487.81,0.0,0.02,3.72,0.0,77.37,2,0.0,-2.94
15/09/2022 00:00:00,16/06/2023 15:50:22,Gemini_BTCUSD_1h_17_12_17_to_10_03_23.csv,BTC_USD,HOUR,99940.54,0.099,15/09/2022 02:00:00,15/09/2022 03:00:00,15/09/2022 03:00:00,EXPIRED,LONG,20159.0,20025.0,21704.87,0.0,0.02,7.12,0.0,153.04,2,0.1,-13.27
23/07/2018 06:00:00,16/06/2023 15:50:22,Gemini_BTCUSD_1h_17_12_17_to_10_03_23.csv,BTC_USD,HOUR,99927.27,0.261,23/07/2018 08:00:00,23/07/2018 09:00:00,23/07/2018 09:00:00,EXPIRED,LONG,7670.0,7708.0,7841.51,0.0,0.02,2.19,0.0,44.76,2,0.0,9.92
10/08/2022 10:00:00,16/06/2023 15:50:22,Gemini_BTCUSD_1h_17_12_17_to_10_03_23.csv,BTC_USD,HOUR,99937.19,0.087,10/08/2022 11:00:00,10/08/2022 13:00:00,10/08/2022 12:00:00,TAKE_PROFIT_HIT,LONG,23072.0,23621.57,23621.57,0.0,0.02,2.33,0.0,47.81,2,0.0,47.81
26/05/2020 09:00:00,16/06/2023 15:50:22,Gemini_BTCUSD_1h_17_12_17_to_10_03_23.csv,BTC_USD,HOUR,99985.0,0.225,26/05/2020 12:00:00,26/05/2020 12:00:00,26/05/2020 12:00:00,EXPIRED,LONG,8892.0,8805.0,9377.89,0.0,0.02,5.18,0.0,109.33,2,0.1,-19.57
09/12/2018 13:00:00,16/06/2023 15:50:22,Gemini_BTCUSD_1h_17_12_17_to_10_03_23.csv,BTC_USD,HOUR,99965.43,0.576,09/12/2018 15:00:00,09/12/2018 16:00:00,09/12/2018 16:00:00,EXPIRED,LONG,3469.0,3578.0,3696.5,0.0,0.02,6.15,0.0,131.04,2,0.1,62.78
08/12/2019 10:00:00,16/06/2023 15:50:22,Gemini_BTCUSD_1h_17_12_17_to_10_03_23.csv,BTC_USD,HOUR,100028.21,0.267,08/12/2019 11:00:00,08/12/2019 13:00:00,08/12/2019 13:00:00,EXPIRED,LONG,7500.0,7533.0,7904.76,0.0,0.02,5.12,0.0,108.07,2,0.1,8.81
23/06/2018 17:00:00,16/06/2023 15:50:22,Gemini_BTCUSD_1h_17_12_17_to_10_03_23.csv,BTC_USD,HOUR,100037.02,0.326,23/06/2018 18:00:00,23/06/2018 20:00:00,23/06/2018 20:00:00,EXPIRED,LONG,6145.0,6140.0,6299.2,0.0,0.02,2.45,0.0,50.27,2,0.0,-1.63
27/06/2020 08:00:00,16/06/2023 15:50:22,Gemini_BTCUSD_1h_17_12_17_to_10_03_23.csv,BTC_USD,HOUR,100035.39,0.219,27/06/2020 09:00:00,27/06/2020 11:00:00,27/06/2020 11:00:00,EXPIRED,LONG,9153.0,9153.0,9393.28,0.0,0.02,2.56,0.0,52.62,2,0.0,0.0
26/05/2019 00:00:00,16/06/2023 15:50:22,Gemini_BTCUSD_1h_17_12_17_to_10_03_23.csv,BTC_USD,HOUR,100035.39,0.248,26/05/2019 01:00:00,26/05/2019 03:00:00,26/05/2019 03:00:00,EXPIRED,LONG,8061.0,8011.0,8379.07,0.0,0.02,3.8,0.0,78.88,2,0.0,-12.4
19/10/2019 00:00:00,16/06/2023 15:50:22,Gemini_BTCUSD_1h_17_12_17_to_10_03_23.csv,BTC_USD,HOUR,100022.99,0.252,19/10/2019 02:00:00,19/10/2019 03:00:00,19/10/2019 03:00:00,EXPIRED,LONG,7940.0,7953.0,8258.11,0.0,0.02,3.85,0.0,80.16,2,0.0,3.28
26/09/2022 23:00:00,16/06/2023 15:50:22,Gemini_BTCUSD_1h_17_12_17_to_10_03_23.csv,BTC_USD,HOUR,100026.27,0.104,27/09/2022 03:00:00,27/09/2022 02:00:00,27/09/2022 02:00:00,TAKE_PROFIT_HIT,LONG,19229.0,19909.53,19909.53,0.0,0.02,3.42,0.0,70.78,2,0.0,70.78
06/11/2020 14:00:00,16/06/2023 15:50:22,Gemini_BTCUSD_1h_17_12_17_to_10_03_23.csv,BTC_USD,HOUR,100097.05,0.129,06/11/2020 17:00:00,06/11/2020 17:00:00,06/11/2020 17:00:00,EXPIRED,LONG,15471.0,15491.0,15831.05,0.0,0.02,2.27,0.0,46.45,2,0.0,2.58
01/10/2019 23:00:00,16/06/2023 15:50:22,Gemini_BTCUSD_1h_17_12_17_to_10_03_23.csv,BTC_USD,HOUR,100099.63,0.24,02/10/2019 03:00:00,02/10/2019 02:00:00,02/10/2019 02:00:00,EXPIRED,LONG,8331.0,8272.0,8519.6,0.0,0.02,2.21,0.0,45.26,2,0.0,-14.16
15/09/2022 01:00:00,16/06/2023 15:50:22,Gemini_BTCUSD_1h_17_12_17_to_10_03_23.csv,BTC_USD,HOUR,100085.47,0.099,15/09/2022 05:00:00,15/09/2022 04:00:00,15/09/2022 04:00:00,EXPIRED,LONG,20200.0,20047.0,21392.93,0.0,0.02,5.58,0.0,118.1,2,0.1,-15.15
21/01/2022 18:00:00,16/06/2023 15:50:22,Gemini_BTCUSD_1h_17_12_17_to_10_03_23.csv,BTC_USD,HOUR,100070.32,0.052,21/01/2022 19:00:00,21/01/2022 21:00:00,21/01/2022 21:00:00,EXPIRED,LONG,38303.0,36701.0,40244.0,0.0,0.02,4.82,0.0,100.93,2,0.1,-83.3
11/10/2022 10:00:00,16/06/2023 15:50:22,Gemini_BTCUSD_1h_17_12_17_to_10_03_23.csv,BTC_USD,HOUR,99987.02,0.105,11/10/2022 11:00:00,11/10/2022 13:00:00,11/10/2022 13:00:00,EXPIRED,LONG,19085.0,18987.0,20642.17,0.0,0.02,7.54,0.0,163.5,2,0.1,-10.29
29/01/2018 21:00:00,16/06/2023 15:50:22,Gemini_BTCUSD_1h_17_12_17_to_10_03_23.csv,BTC_USD,HOUR,99976.73,0.179,30/01/2018 00:00:00,30/01/2018 00:00:00,30/01/2018 00:00:00,EXPIRED,LONG,11192.0,11140.0,11462.24,0.0,0.02,2.36,0.0,48.37,2,0.0,-9.31
27/07/2022 03:00:00,16/06/2023 15:50:22,Gemini_BTCUSD_1h_17_12_17_to_10_03_23.csv,BTC_USD,HOUR,99967.42,0.095,27/07/2022 05:00:00,27/07/2022 06:00:00,27/07/2022 06:00:00,EXPIRED,LONG,21077.0,21253.0,21961.73,0.0,0.02,4.03,0.0,84.05,2,0.0,16.72
04/10/2021 18:00:00,16/06/2023 15:50:22,Gemini_BTCUSD_1h_17_12_17_to_10_03_23.csv,BTC_USD,HOUR,99984.14,0.041,04/10/2021 19:00:00,04/10/2021 21:00:00,04/10/2021 21:00:00,EXPIRED,LONG,49330.0,48933.0,53156.64,0.0,0.02,7.2,0.0,156.89,2,0.1,-16.28
28/09/2019 18:00:00,16/06/2023 15:50:22,Gemini_BTCUSD_1h_17_12_17_to_10_03_23.csv,BTC_USD,HOUR,99967.86,0.245,28/09/2019 21:00:00,28/09/2019 21:00:00,28/09/2019 21:00:00,EXPIRED,LONG,8152.0,8141.0,8533.79,0.0,0.02,4.47,0.0,93.54,2,0.0,-2.69
21/09/2020 02:00:00,16/06/2023 15:50:22,Gemini_BTCUSD_1h_17_12_17_to_10_03_23.csv,BTC_USD,HOUR,99965.17,0.183,21/09/2020 04:00:00,21/09/2020 05:00:00,21/09/2020 05:00:00,EXPIRED,LONG,10947.0,10959.0,11861.94,0.0,0.02,7.71,0.0,167.43,2,0.1,2.2
02/08/2018 21:00:00,16/06/2023 15:50:22,Gemini_BTCUSD_1h_17_12_17_to_10_03_23.csv,BTC_USD,HOUR,99967.37,0.266,02/08/2018 22:00:00,03/08/2018 00:00:00,03/08/2018 00:00:00,EXPIRED,LONG,7515.0,7377.0,7970.48,0.0,0.02,5.71,0.0,121.16,2,0.1,-36.71
02/10/2018 04:00:00,16/06/2023 15:50:22,Gemini_BTCUSD_1h_17_12_17_to_10_03_23.csv,BTC_USD,HOUR,99930.66,0.304,02/10/2018 05:00:00,02/10/2018 07:00:00,02/10/2018 07:00:00,EXPIRED,LONG,6578.0,6560.0,6943.1,0.0,0.02,5.26,0.0,110.99,2,0.1,-5.47
05/01/2019 14:00:00,16/06/2023 15:50:22,Gemini_BTCUSD_1h_17_12_17_to_10_03_23.csv,BTC_USD,HOUR,99925.19,0.522,05/01/2019 15:00:00,05/01/2019 17:00:00,05/01/2019 17:00:00,EXPIRED,LONG,3827.0,3833.0,3926.71,0.0,0.02,2.54,0.0,52.05,2,0.0,3.13
26/06/2022 08:00:00,16/06/2023 15:50:22,Gemini_BTCUSD_1h_17_12_17_to_10_03_23.csv,BTC_USD,HOUR,99928.32,0.093,26/06/2022 09:00:00,26/06/2022 11:00:00,26/06/2022 11:00:00,EXPIRED,LONG,21426.0,21693.0,23013.45,0.0,0.02,6.9,0.0,147.63,2,0.1,24.83
07/07/2021 19:00:00,16/06/2023 15:50:22,Gemini_BTCUSD_1h_17_12_17_to_10_03_23.csv,BTC_USD,HOUR,99953.15,0.058,07/07/2021 23:00:00,07/07/2021 22:00:00,07/07/2021 22:00:00,EXPIRED,LONG,34641.0,34168.0,36511.48,0.0,0.02,5.12,0.0,108.49,2,0.1,-27.43
15/11/2022 16:00:00,16/06/2023 15:50:22,Gemini_BTCUSD_1h_17_12_17_to_10_03_23.csv,BTC_USD,HOUR,99925.72,0.118,15/11/2022 18:00:00,15/11/2022 19:00:00,15/11/2022 19:00:00,EXPIRED,LONG,17001.0,16865.0,18499.42,0.0,0.02,8.1,0.0,176.81,2,0.1,-16.05
23/02/2022 10:00:00,16/06/2023 15:50:22,Gemini_BTCUSD_1h_17_12_17_to_10_03_23.csv,BTC_USD,HOUR,99909.67,0.051,23/02/2022 11:00:00,23/02/2022 13:00:00,23/02/2022 13:00:00,EXPIRED,LONG,38892.0,39016.0,40804.78,0.0,0.02,4.69,0.0,97.55,2,0.0,6.32
24/01/2022 16:00:00,16/06/2023 15:50:22,Gemini_BTCUSD_1h_17_12_17_to_10_03_23.csv,BTC_USD,HOUR,99915.99,0.058,24/01/2022 19:00:00,24/01/2022 19:00:00,24/01/2022 17:00:00,TAKE_PROFIT_HIT,LONG,34552.0,35351.66,35351.66,0.0,0.02,2.26,0.0,46.38,2,0.0,46.38
18/04/2018 03:00:00,16/06/2023 15:50:22,Gemini_BTCUSD_1h_17_12_17_to_10_03_23.csv,BTC_USD,HOUR,99962.37,0.252,18/04/2018 05:00:00,18/04/2018 06:00:00,18/04/2018 06:00:00,TAKE_PROFIT_HIT,LONG,7935.0,8112.45,8112.45,0.0,0.02,2.19,0.0,44.72,2,0.0,44.72
16/04/2018 01:00:00,16/06/2023 15:50:22,Gemini_BTCUSD_1h_17_12_17_to_10_03_23.csv,BTC_USD,HOUR,100007.09,0.24,16/04/2018 02:00:00,16/04/2018 04:00:00,16/04/2018 04:00:00,EXPIRED,LONG,8340.0,8142.0,9063.48,0.0,0.02,7.98,0.0,173.64,2,0.1,-47.52
25/04/2022 18:00:00,16/06/2023 15:50:22,Gemini_BTCUSD_1h_17_12_17_to_10_03_23.csv,BTC_USD,HOUR,99959.57,0.05,25/04/2022 19:00:00,25/04/2022 21:00:00,25/04/2022 21:00:00,EXPIRED,LONG,39879.0,40221.0,42868.64,0.0,0.02,6.97,0.0,149.48,2,0.1,17.1
01/09/2020 08:00:00,16/06/2023 15:50:22,Gemini_BTCUSD_1h_17_12_17_to_10_03_23.csv,BTC_USD,HOUR,99976.67,0.168,01/09/2020 10:00:00,01/09/2020 11:00:00,01/09/2020 11:00:00,EXPIRED,LONG,11925.0,11883.0,12202.53,0.0,0.02,2.27,0.0,46.63,2,0.0,-7.06
09/08/2022 22:00:00,16/06/2023 15:50:22,Gemini_BTCUSD_1h_17_12_17_to_10_03_23.csv,BTC_USD,HOUR,99969.61,0.086,09/08/2022 23:00:00,10/08/2022 01:00:00,10/08/2022 01:00:00,EXPIRED,LONG,23186.0,22902.0,24734.37,0.0,0.02,6.26,0.0,133.16,2,0.1,-24.42
18/10/2020 17:00:00,16/06/2023 15:50:22,Gemini_BTCUSD_1h_17_12_17_to_10_03_23.csv,BTC_USD,HOUR,99945.19,0.174,18/10/2020 18:00:00,18/10/2020 20:00:00,18/10/2020 20:00:00,EXPIRED,LONG,11474.0,11448.0,12402.64,0.0,0.02,7.49,0.0,161.58,2,0.1,-4.52
24/03/2020 02:00:00,16/06/2023 15:50:22,Gemini_BTCUSD_1h_17_12_17_to_10_03_23.csv,BTC_USD,HOUR,99940.67,0.301,24/03/2020 04:00:00,24/03/2020 05:00:00,24/03/2020 05:00:00,EXPIRED,LONG,6637.0,6518.0,7043.04,0.0,0.02,5.77,0.0,122.22,2,0.1,-35.82
07/02/2022 12:00:00,16/06/2023 15:50:22,Gemini_BTCUSD_1h_17_12_17_to_10_03_23.csv,BTC_USD,HOUR,99904.85,0.047,07/02/2022 14:00:00,07/02/2022 15:00:00,07/02/2022 15:00:00,TAKE_PROFIT_HIT,LONG,42686.0,43646.63,43646.63,0.0,0.02,2.2,0.0,45.15,2,0.0,45.15
23/01/2019 04:00:00,16/06/2023 15:50:22,Gemini_BTCUSD_1h_17_12_17_to_10_03_23.csv,BTC_USD,HOUR,99950.0,0.559,23/01/2019 05:00:00,23/01/2019 07:00:00,23/01/2019 07:00:00,EXPIRED,LONG,3575.0,3568.0,3882.84,0.0,0.02,7.93,0.0,172.08,2,0.1,-3.91
02/08/2018 18:00:00,16/06/2023 15:50:22,Gemini_BTCUSD_1h_17_12_17_to_10_03_23.csv,BTC_USD,HOUR,99946.09,0.266,02/08/2018 19:00:00,02/08/2018 21:00:00,02/08/2018 21:00:00,EXPIRED,LONG,7501.0,7515.0,7853.66,0.0,0.02,4.49,0.0,93.81,2,0.0,3.72
19/11/2022 15:00:00,16/06/2023 15:50:22,Gemini_BTCUSD_1h_17_12_17_to_10_03_23.csv,BTC_USD,HOUR,99949.81,0.12,19/11/2022 19:00:00,19/11/2022 18:00:00,19/11/2022 18:00:00,EXPIRED,LONG,16636.0,16606.0,16982.67,0.0,0.02,2.04,0.0,41.6,2,0.0,-3.6
14/10/2020 07:00:00,16/06/2023 15:50:22,Gemini_BTCUSD_1h_17_12_17_to_10_03_23.csv,BTC_USD,HOUR,99946.21,0.175,14/10/2020 09:00:00,14/10/2020 10:00:00,14/10/2020 10:00:00,EXPIRED,LONG,11424.0,11388.0,12156.37,0.0,0.02,6.02,0.0,128.16,2,0.1,-6.3
13/08/2021 00:00:00,16/06/2023 15:50:22,Gemini_BTCUSD_1h_17_12_17_to_10_03_23.csv,BTC_USD,HOUR,99939.91,0.045,13/08/2021 03:00:00,13/08/2021 03:00:00,13/08/2021 03:00:00,EXPIRED,LONG,44519.0,45205.0,46167.08,0.0,0.02,3.57,0.0,74.16,2,0.0,30.87
13/02/2022 17:00:00,16/06/2023 15:50:22,Gemini_BTCUSD_1h_17_12_17_to_10_03_23.csv,BTC_USD,HOUR,99970.78,0.047,13/02/2022 18:00:00,13/02/2022 20:00:00,13/02/2022 20:00:00,EXPIRED,LONG,42293.0,42451.0,46060.76,0.0,0.02,8.18,0.0,177.08,2,0.1,7.43
05/11/2019 21:00:00,16/06/2023 15:50:22,Gemini_BTCUSD_1h_17_12_17_to_10_03_23.csv,BTC_USD,HOUR,99978.21,0.214,05/11/2019 22:00:00,06/11/2019 00:00:00,06/11/2019 00:00:00,EXPIRED,LONG,9361.0,9303.0,9709.5,0.0,0.02,3.59,0.0,74.58,2,0.0,-12.41
04/05/2018 10:00:00,16/06/2023 15:50:22,Gemini_BTCUSD_1h_17_12_17_to_10_03_23.csv,BTC_USD,HOUR,99965.8,0.206,04/05/2018 11:00:00,04/05/2018 13:00:00,04/05/2018 13:00:00,EXPIRED,LONG,9690.0,9640.0,10319.89,0.0,0.02,6.1,0.0,129.76,2,0.1,-10.3
19/07/2018 16:00:00,16/06/2023 15:50:22,Gemini_BTCUSD_1h_17_12_17_to_10_03_23.csv,BTC_USD,HOUR,99955.5,0.272,19/07/2018 20:00:00,19/07/2018 19:00:00,19/07/2018 19:00:00,EXPIRED,LONG,7359.0,7448.0,7532.1,0.0,0.02,2.3,0.0,47.08,2,0.0,24.21
23/08/2019 10:00:00,16/06/2023 15:50:22,Gemini_BTCUSD_1h_17_12_17_to_10_03_23.csv,BTC_USD,HOUR,99979.71,0.197,23/08/2019 12:00:00,23/08/2019 13:00:00,23/08/2019 13:00:00,TAKE_PROFIT_HIT,LONG,10143.0,10437.74,10437.74,0.0,0.02,2.82,0.0,58.06,2,0.0,58.06
19/04/2020 00:00:00,16/06/2023 15:50:22,Gemini_BTCUSD_1h_17_12_17_to_10_03_23.csv,BTC_USD,HOUR,100037.77,0.276,19/04/2020 02:00:00,19/04/2020 03:00:00,19/04/2020 03:00:00,EXPIRED,LONG,7237.0,7247.0,7522.87,0.0,0.02,3.8,0.0,78.9,2,0.0,2.76
23/06/2021 23:00:00,16/06/2023 15:50:22,Gemini_BTCUSD_1h_17_12_17_to_10_03_23.csv,BTC_USD,HOUR,100040.53,0.059,24/06/2021 01:00:00,24/06/2021 02:00:00,24/06/2021 02:00:00,EXPIRED,LONG,33681.0,32507.0,36632.9,0.0,0.02,8.06,0.0,174.16,2,0.1,-69.27
08/02/2022 06:00:00,16/06/2023 15:50:22,Gemini_BTCUSD_1h_17_12_17_to_10_03_23.csv,BTC_USD,HOUR,99971.26,0.045,08/02/2022 07:00:00,08/02/2022 09:00:00,08/02/2022 09:00:00,EXPIRED,LONG,44852.0,43876.0,48426.44,0.0,0.02,7.38,0.0,160.85,2,0.1,-43.92
16/10/2021 11:00:00,16/06/2023 15:50:22,Gemini_BTCUSD_1h_17_12_17_to_10_03_23.csv,BTC_USD,HOUR,99927.34,0.032,16/10/2021 12:00:00,16/10/2021 14:00:00,16/10/2021 14:00:00,EXPIRED,LONG,61622.0,60944.0,63091.9,0.0,0.02,2.33,0.0,47.04,2,0.0,-21.7
20/01/2020 17:00:00,16/06/2023 15:50:22,Gemini_BTCUSD_1h_17_12_17_to_10_03_23.csv,BTC_USD,HOUR,99905.64,0.231,20/01/2020 18:00:00,20/01/2020 20:00:00,20/01/2020 20:00:00,EXPIRED,LONG,8635.0,8657.0,9293.77,0.0,0.02,7.09,0.0,152.18,2,0.1,5.08
27/06/2021 12:00:00,16/06/2023 15:50:22,Gemini_BTCUSD_1h_17_12_17_to_10_03_23.csv,BTC_USD,HOUR,99910.72,0.06,27/06/2021 16:00:00,27/06/2021 15:00:00,27/06/2021 15:00:00,EXPIRED,LONG,33338.0,33215.0,35514.97,0.0,0.02,6.13,0.0,130.62,2,0.1,-7.38
11/10/2022 12:00:00,16/06/2023 15:50:22,Gemini_BTCUSD_1h_17_12_17_to_10_03_23.csv,BTC_USD,HOUR,99903.34,0.104,11/10/2022 13:00:00,11/10/2022 15:00:00,11/10/2022 15:00:00,EXPIRED,LONG,19150.0,19144.0,20574.09,0.0,0.02,6.92,0.0,148.11,2,0.1,-0.62
03/03/2018 06:00:00,16/06/2023 15:50:22,Gemini_BTCUSD_1h_17_12_17_to_10_03_23.csv,BTC_USD,HOUR,99902.72,0.176,03/03/2018 08:00:00,03/03/2018 09:00:00,03/03/2018 09:00:00,EXPIRED,LONG,11329.0,11308.0,11588.78,0.0,0.02,2.24,0.0,45.72,2,0.0,-3.7
30/04/2019 05:00:00,16/06/2023 15:50:22,Gemini_BTCUSD_1h_17_12_17_to_10_03_23.csv,BTC_USD,HOUR,99899.02,0.389,30/04/2019 06:00:00,30/04/2019 08:00:00,30/04/2019 08:00:00,EXPIRED,LONG,5139.0,5160.0,5258.73,0.0,0.02,2.28,0.0,46.57,2,0.0,8.17
28/05/2022 13:00:00,16/06/2023 15:50:22,Gemini_BTCUSD_1h_17_12_17_to_10_03_23.csv,BTC_USD,HOUR,99907.19,0.069,28/05/2022 17:00:00,28/05/2022 16:00:00,28/05/2022 16:00:00,EXPIRED,LONG,29054.0,28876.0,30985.45,0.0,0.02,6.23,0.0,133.27,2,0.1,-12.28
25/02/2022 03:00:00,16/06/2023 15:50:22,Gemini_BTCUSD_1h_17_12_17_to_10_03_23.csv,BTC_USD,HOUR,99894.91,0.051,25/02/2022 05:00:00,25/02/2022 06:00:00,25/02/2022 06:00:00,EXPIRED,LONG,38962.0,38724.0,40243.85,0.0,0.02,3.19,0.0,65.37,2,0.0,-12.14
25/06/2019 06:00:00,16/06/2023 15:50:22,Gemini_BTCUSD_1h_17_12_17_to_10_03_23.csv,BTC_USD,HOUR,99882.77,0.177,25/06/2019 07:00:00,25/06/2019 09:00:00,25/06/2019 09:00:00,EXPIRED,LONG,11273.0,11340.0,11993.19,0.0,0.02,6.0,0.0,127.47,2,0.1,11.86
08/05/2020 12:00:00,16/06/2023 15:50:22,Gemini_BTCUSD_1h_17_12_17_to_10_03_23.csv,BTC_USD,HOUR,99894.63,0.203,08/05/2020 14:00:00,08/05/2020 15:00:00,08/05/2020 15:00:00,EXPIRED,LONG,9843.0,9956.0,10334.24,0.0,0.02,4.75,0.0,99.72,2,0.0,22.94
18/01/2021 22:00:00,16/06/2023 15:50:22,Gemini_BTCUSD_1h_17_12_17_to_10_03_23.csv,BTC_USD,HOUR,99917.57,0.055,19/01/2021 02:00:00,19/01/2021 01:00:00,19/01/2021 01:00:00,EXPIRED,LONG,36466.0,36946.0,38067.03,0.0,0.02,4.21,0.0,88.06,2,0.0,26.4
28/09/2018 18:00:00,16/06/2023 15:50:22,Gemini_BTCUSD_1h_17_12_17_to_10_03_23.csv,BTC_USD,HOUR,99943.97,0.301,28/09/2018 19:00:00,28/09/2018 21:00:00,28/09/2018 21:00:00,EXPIRED,LONG,6644.0,6637.0,6811.16,0.0,0.02,2.45,0.0,50.32,2,0.0,-2.11
02/06/2022 17:00:00,16/06/2023 15:50:22,Gemini_BTCUSD_1h_17_12_17_to_10_03_23.csv,BTC_USD,HOUR,99941.86,0.066,02/06/2022 18:00:00,02/06/2022 20:00:00,02/06/2022 20:00:00,EXPIRED,LONG,30177.0,30228.0,32371.07,0.0,0.02,6.78,0.0,144.81,2,0.1,3.37
04/01/2023 20:00:00,16/06/2023 15:50:22,Gemini_BTCUSD_1h_17_12_17_to_10_03_23.csv,BTC_USD,HOUR,99945.23,0.119,04/01/2023 22:00:00,04/01/2023 23:00:00,04/01/2023 23:00:00,EXPIRED,LONG,16800.0,16854.0,18330.1,0.0,0.02,8.35,0.0,182.08,2,0.1,6.43
12/05/2018 15:00:00,16/06/2023 15:50:22,Gemini_BTCUSD_1h_17_12_17_to_10_03_23.csv,BTC_USD,HOUR,99951.66,0.239,12/05/2018 18:00:00,12/05/2018 18:00:00,12/05/2018 18:00:00,EXPIRED,LONG,8353.0,8367.0,8649.71,0.0,0.02,3.43,0.0,70.91,2,0.0,3.35
01/02/2021 01:00:00,16/06/2023 15:50:22,Gemini_BTCUSD_1h_17_12_17_to_10_03_23.csv,BTC_USD,HOUR,99955.01,0.06,01/02/2021 03:00:00,01/02/2021 04:00:00,01/02/2021 04:00:00,EXPIRED,LONG,33469.0,33596.0,35860.56,0.0,0.02,6.67,0.0,143.49,2,0.1,7.62
31/03/2022 07:00:00,16/06/2023 15:50:22,Gemini_BTCUSD_1h_17_12_17_to_10_03_23.csv,BTC_USD,HOUR,99962.63,0.042,31/03/2022 11:00:00,31/03/2022 10:00:00,31/03/2022 10:00:00,EXPIRED,LONG,47193.0,47298.0,49529.83,0.0,0.02,4.72,0.0,98.15,2,0.0,4.41
20/11/2022 01:00:00,16/06/2023 15:50:22,Gemini_BTCUSD_1h_17_12_17_to_10_03_23.csv,BTC_USD,HOUR,99967.04,0.12,20/11/2022 02:00:00,20/11/2022 04:00:00,20/11/2022 04:00:00,EXPIRED,LONG,16637.0,16660.0,18076.24,0.0,0.02,7.96,0.0,172.71,2,0.1,2.76
14/01/2021 16:00:00,16/06/2023 15:50:22,Gemini_BTCUSD_1h_17_12_17_to_10_03_23.csv,BTC_USD,HOUR,99969.8,0.051,14/01/2021 17:00:00,14/01/2021 19:00:00,14/01/2021 19:00:00,EXPIRED,LONG,39223.0,39886.0,40059.36,0.0,0.02,2.09,0.0,42.65,2,0.0,33.81
26/12/2019 18:00:00,16/06/2023 15:50:22,Gemini_BTCUSD_1h_17_12_17_to_10_03_23.csv,BTC_USD,HOUR,100003.61,0.272,26/12/2019 19:00:00,26/12/2019 21:00:00,26/12/2019 21:00:00,EXPIRED,LONG,7360.0,7187.0,7863.87,0.0,0.02,6.41,0.0,137.05,2,0.1,-47.06
29/01/2018 22:00:00,16/06/2023 15:50:22,Gemini_BTCUSD_1h_17_12_17_to_10_03_23.csv,BTC_USD,HOUR,99956.55,0.181,30/01/2018 01:00:00,30/01/2018 01:00:00,30/01/2018 01:00:00,EXPIRED,LONG,11042.0,10870.0,11806.68,0.0,0.02,6.48,0.0,138.41,2,0.1,-31.13
07/03/2020 11:00:00,16/06/2023 15:50:22,Gemini_BTCUSD_1h_17_12_17_to_10_03_23.csv,BTC_USD,HOUR,99925.42,0.219,07/03/2020 12:00:00,07/03/2020 14:00:00,07/03/2020 14:00:00,EXPIRED,LONG,9118.0,9126.0,9919.48,0.0,0.02,8.08,0.0,175.52,2,0.1,1.75
29/10/2021 14:00:00,16/06/2023 15:50:22,Gemini_BTCUSD_1h_17_12_17_to_10_03_23.csv,BTC_USD,HOUR,99927.17,0.033,29/10/2021 15:00:00,29/10/2021 17:00:00,29/10/2021 17:00:00,EXPIRED,LONG,61256.0,62398.0,66671.73,0.0,0.02,8.12,0.0,178.72,2,0.1,37.69
25/12/2021 20:00:00,16/06/2023 15:50:22,Gemini_BTCUSD_1h_17_12_17_to_10_03_23.csv,BTC_USD,HOUR,99964.86,0.039,25/12/2021 21:00:00,25/12/2021 23:00:00,25/12/2021 23:00:00,EXPIRED,LONG,50900.0,50455.0,54954.34,0.0,0.02,7.38,0.0,158.12,2,0.1,-17.35
03/04/2018 20:00:00,16/06/2023 15:50:22,Gemini_BTCUSD_1h_17_12_17_to_10_03_23.csv,BTC_USD,HOUR,99947.51,0.27,03/04/2018 22:00:00,03/04/2018 23:00:00,03/04/2018 23:00:00,EXPIRED,LONG,7400.0,7419.0,7950.57,0.0,0.02,6.92,0.0,148.65,2,0.1,5.13
25/04/2022 12:00:00,16/06/2023 15:50:22,Gemini_BTCUSD_1h_17_12_17_to_10_03_23.csv,BTC_USD,HOUR,99952.64,0.052,25/04/2022 16:00:00,25/04/2022 15:00:00,25/04/2022 15:00:00,EXPIRED,LONG,38816.0,38986.0,39794.26,0.0,0.02,2.46,0.0,50.87,2,0.0,8.84
19/02/2021 16:00:00,16/06/2023 15:50:22,Gemini_BTCUSD_1h_17_12_17_to_10_03_23.csv,BTC_USD,HOUR,99961.48,0.037,19/02/2021 17:00:00,19/02/2021 19:00:00,19/02/2021 19:00:00,EXPIRED,LONG,54391.0,55036.0,58818.45,0.0,0.02,7.53,0.0,163.82,2,0.1,23.87
21/03/2019 08:00:00,16/06/2023 15:50:22,Gemini_BTCUSD_1h_17_12_17_to_10_03_23.csv,BTC_USD,HOUR,99985.35,0.496,21/03/2019 10:00:00,21/03/2019 11:00:00,21/03/2019 11:00:00,EXPIRED,LONG,4034.0,4036.0,4181.0,0.0,0.02,3.52,0.0,72.91,2,0.0,0.99
17/10/2022 16:00:00,16/06/2023 15:50:22,Gemini_BTCUSD_1h_17_12_17_to_10_03_23.csv,BTC_USD,HOUR,99986.34,0.102,17/10/2022 17:00:00,17/10/2022 19:00:00,17/10/2022 19:00:00,EXPIRED,LONG,19516.0,19523.0,20238.34,0.0,0.02,3.57,0.0,73.68,2,0.0,0.71
15/03/2022 18:00:00,16/06/2023 15:50:22,Gemini_BTCUSD_1h_17_12_17_to_10_03_23.csv,BTC_USD,HOUR,99987.05,0.051,15/03/2022 19:00:00,15/03/2022 21:00:00,15/03/2022 21:00:00,EXPIRED,LONG,39424.0,39665.0,42905.0,0.0,0.02,8.11,0.0,177.53,2,0.1,12.29
28/05/2020 14:00:00,16/06/2023 15:50:22,Gemini_BTCUSD_1h_17_12_17_to_10_03_23.csv,BTC_USD,HOUR,99999.34,0.211,28/05/2020 16:00:00,28/05/2020 17:00:00,28/05/2020 17:00:00,EXPIRED,LONG,9469.0,9475.0,9822.07,0.0,0.02,3.59,0.0,74.5,2,0.0,1.27
03/08/2020 03:00:00,16/06/2023 15:50:22,Gemini_BTCUSD_1h_17_12_17_to_10_03_23.csv,BTC_USD,HOUR,100000.61,0.18,03/08/2020 04:00:00,03/08/2020 06:00:00,03/08/2020 06:00:00,EXPIRED,LONG,11126.0,11198.0,11420.78,0.0,0.02,2.58,0.0,53.06,2,0.0,12.96
23/11/2020 00:00:00,16/06/2023 15:50:22,Gemini_BTCUSD_1h_17_12_17_to_10_03_23.csv,BTC_USD,HOUR,100013.57,0.11,23/11/2020 01:00:00,23/11/2020 03:00:00,23/11/2020 03:00:00,EXPIRED,LONG,18131.0,18393.0,18552.96,0.0,0.02,2.27,0.0,46.42,2,0.0,28.82
03/12/2018 15:00:00,16/06/2023 15:50:22,Gemini_BTCUSD_1h_17_12_17_to_10_03_23.csv,BTC_USD,HOUR,100042.39,0.524,03/12/2018 17:00:00,03/12/2018 18:00:00,03/12/2018 18:00:00,EXPIRED,LONG,3822.0,3839.0,3912.35,0.0,0.02,2.31,0.0,47.34,2,0.0,8.91
17/04/2018 13:00:00,16/06/2023 15:50:22,Gemini_BTCUSD_1h_17_12_17_to_10_03_23.csv,BTC_USD,HOUR,100051.3,0.247,17/04/2018 16:00:00,17/04/2018 16:00:00,17/04/2018 16:00:00,EXPIRED,LONG,8100.0,8112.0,8437.45,0.0,0.02,4.0,0.0,83.35,2,0.0,2.96
28/05/2020 13:00:00,16/06/2023 15:50:22,Gemini_BTCUSD_1h_17_12_17_to_10_03_23.csv,BTC_USD,HOUR,100054.26,0.213,28/05/2020 14:00:00,28/05/2020 16:00:00,28/05/2020 16:00:00,EXPIRED,LONG,9413.0,9447.0,9935.3,0.0,0.02,5.26,0.0,111.25,2,0.1,7.24
29/08/2021 23:00:00,16/06/2023 15:50:22,Gemini_BTCUSD_1h_17_12_17_to_10_03_23.csv,BTC_USD,HOUR,100061.5,0.041,30/08/2021 00:00:00,30/08/2021 02:00:00,30/08/2021 02:00:00,EXPIRED,LONG,48801.0,48430.0,51698.17,0.0,0.02,5.6,0.0,118.78,2,0.1,-15.21
11/05/2020 20:00:00,16/06/2023 15:50:22,Gemini_BTCUSD_1h_17_12_17_to_10_03_23.csv,BTC_USD,HOUR,100046.29,0.232,11/05/2020 21:00:00,11/05/2020 23:00:00,11/05/2020 23:00:00,EXPIRED,LONG,8632.0,8572.0,8838.17,0.0,0.02,2.33,0.0,47.83,2,0.0,-13.92
10/12/2021 10:00:00,16/06/2023 15:50:22,Gemini_BTCUSD_1h_17_12_17_to_10_03_23.csv,BTC_USD,HOUR,100032.37,0.041,10/12/2021 13:00:00,10/12/2021 13:00:00,10/12/2021 13:00:00,EXPIRED,LONG,48235.0,49094.0,50050.83,0.0,0.02,3.63,0.0,74.45,2,0.0,35.22
12/04/2020 15:00:00,16/06/2023 15:50:22,Gemini_BTCUSD_1h_17_12_17_to_10_03_23.csv,BTC_USD,HOUR,100067.59,0.284,12/04/2020 16:00:00,12/04/2020 18:00:00,12/04/2020 18:00:00,EXPIRED,LONG,7035.0,7123.0,7564.95,0.0,0.02,7.01,0.0,150.51,2,0.1,24.99
08/12/2022 16:00:00,16/06/2023 15:50:22,Gemini_BTCUSD_1h_17_12_17_to_10_03_23.csv,BTC_USD,HOUR,100092.58,0.118,08/12/2022 17:00:00,08/12/2022 19:00:00,08/12/2022 19:00:00,EXPIRED,LONG,16958.0,17259.0,18036.76,0.0,0.02,5.98,0.0,127.29,2,0.1,35.52
29/01/2021 01:00:00,16/06/2023 15:50:22,Gemini_BTCUSD_1h_17_12_17_to_10_03_23.csv,BTC_USD,HOUR,100128.1,0.059,29/01/2021 02:00:00,29/01/2021 04:00:00,29/01/2021 04:00:00,EXPIRED,LONG,33974.0,33103.0,36322.83,0.0,0.02,6.47,0.0,138.58,2,0.1,-51.39
31/07/2018 01:00:00,16/06/2023 15:50:22,Gemini_BTCUSD_1h_17_12_17_to_10_03_23.csv,BTC_USD,HOUR,100076.71,0.247,31/07/2018 04:00:00,31/07/2018 04:00:00,31/07/2018 04:00:00,EXPIRED,LONG,8108.0,8106.0,8367.52,0.0,0.02,3.1,0.0,64.1,2,0.0,-0.49
09/03/2021 04:00:00,16/06/2023 15:50:22,Gemini_BTCUSD_1h_17_12_17_to_10_03_23.csv,BTC_USD,HOUR,100076.22,0.037,09/03/2021 05:00:00,09/03/2021 07:00:00,09/03/2021 07:00:00,EXPIRED,LONG,53746.0,53519.0,56642.38,0.0,0.02,5.11,0.0,107.17,2,0.1,-8.4
17/06/2021 12:00:00,16/06/2023 15:50:22,Gemini_BTCUSD_1h_17_12_17_to_10_03_23.csv,BTC_USD,HOUR,100067.82,0.052,17/06/2021 16:00:00,17/06/2021 15:00:00,17/06/2021 15:00:00,EXPIRED,LONG,38763.0,39035.0,40510.7,0.0,0.02,4.31,0.0,90.88,2,0.0,14.14
27/09/2021 01:00:00,16/06/2023 15:50:22,Gemini_BTCUSD_1h_17_12_17_to_10_03_23.csv,BTC_USD,HOUR,100081.96,0.045,27/09/2021 04:00:00,27/09/2021 04:00:00,27/09/2021 04:00:00,EXPIRED,LONG,44300.0,44037.0,46661.07,0.0,0.02,5.06,0.0,106.25,2,0.1,-11.83
10/01/2023 21:00:00,16/06/2023 15:50:22,Gemini_BTCUSD_1h_17_12_17_to_10_03_23.csv,BTC_USD,HOUR,100070.13,0.115,10/01/2023 22:00:00,11/01/2023 00:00:00,11/01/2023 00:00:00,EXPIRED,LONG,17470.0,17469.0,18676.46,0.0,0.02,6.46,0.0,138.74,2,0.1,-0.11
20/01/2020 18:00:00,16/06/2023 15:50:22,Gemini_BTCUSD_1h_17_12_17_to_10_03_23.csv,BTC_USD,HOUR,100070.02,0.231,20/01/2020 22:00:00,20/01/2020 21:00:00,20/01/2020 21:00:00,EXPIRED,LONG,8651.0,8665.0,8846.85,0.0,0.02,2.21,0.0,45.24,2,0.0,3.23
27/10/2022 17:00:00,16/06/2023 15:50:22,Gemini_BTCUSD_1h_17_12_17_to_10_03_23.csv,BTC_USD,HOUR,100073.25,0.097,27/10/2022 19:00:00,27/10/2022 20:00:00,27/10/2022 20:00:00,EXPIRED,LONG,20578.0,20400.0,21843.03,0.0,0.02,5.79,0.0,122.71,2,0.1,-17.27
18/01/2020 00:00:00,16/06/2023 15:50:22,Gemini_BTCUSD_1h_17_12_17_to_10_03_23.csv,BTC_USD,HOUR,100055.98,0.223,18/01/2020 01:00:00,18/01/2020 03:00:00,18/01/2020 03:00:00,EXPIRED,LONG,8963.0,8915.0,9720.11,0.0,0.02,7.79,0.0,168.84,2,0.1,-10.7
02/02/2021 08:00:00,16/06/2023 15:50:22,Gemini_BTCUSD_1h_17_12_17_to_10_03_23.csv,BTC_USD,HOUR,100045.28,0.058,02/02/2021 09:00:00,02/02/2021 11:00:00,02/02/2021 11:00:00,EXPIRED,LONG,34681.0,34714.0,37677.49,0.0,0.02,7.95,0.0,173.8,2,0.1,1.91
18/06/2020 08:00:00,16/06/2023 15:50:22,Gemini_BTCUSD_1h_17_12_17_to_10_03_23.csv,BTC_USD,HOUR,100047.19,0.212,18/06/2020 12:00:00,18/06/2020 11:00:00,18/06/2020 11:00:00,EXPIRED,LONG,9428.0,9425.0,9996.05,0.0,0.02,5.68,0.0,120.43,2,0.1,-0.64
11/11/2021 07:00:00,16/06/2023 15:50:22,Gemini_BTCUSD_1h_17_12_17_to_10_03_23.csv,BTC_USD,HOUR,100046.55,0.031,11/11/2021 08:00:00,11/11/2021 10:00:00,11/11/2021 10:00:00,EXPIRED,LONG,65243.0,65273.0,67555.05,0.0,0.02,3.42,0.0,71.67,2,0.0,0.93
06/10/2018 10:00:00,16/06/2023 15:50:22,Gemini_BTCUSD_1h_17_12_17_to_10_03_23.csv,BTC_USD,HOUR,100047.48,0.305,06/10/2018 11:00:00,06/10/2018 13:00:00,06/10/2018 13:00:00,EXPIRED,LONG,6568.0,6540.0,6747.13,0.0,0.02,2.65,0.0,54.63,2,0.0,-8.54
15/06/2019 22:00:00,16/06/2023 15:50:22,Gemini_BTCUSD_1h_17_12_17_to_10_03_23.csv,BTC_USD,HOUR,100038.94,0.226,15/06/2019 23:00:00,16/06/2019 01:00:00,16/06/2019 01:00:00,EXPIRED,LONG,8837.0,8961.0,9169.31,0.0,0.02,3.62,0.0,75.1,2,0.0,28.02
30/03/2022 10:00:00,16/06/2023 15:50:22,Gemini_BTCUSD_1h_17_12_17_to_10_03_23.csv,BTC_USD,HOUR,100066.96,0.042,30/03/2022 12:00:00,30/03/2022 13:00:00,30/03/2022 13:00:00,EXPIRED,LONG,47277.0,47015.0,48287.25,0.0,0.02,2.09,0.0,42.43,2,0.0,-11.0
07/06/2022 17:00:00,16/06/2023 15:50:22,Gemini_BTCUSD_1h_17_12_17_to_10_03_23.csv,BTC_USD,HOUR,100055.96,0.067,07/06/2022 18:00:00,07/06/2022 20:00:00,07/06/2022 20:00:00,EXPIRED,LONG,29910.0,31331.0,32357.96,0.0,0.02,7.57,0.0,164.01,2,0.1,95.21
13/02/2018 22:00:00,16/06/2023 15:50:22,Gemini_BTCUSD_1h_17_12_17_to_10_03_23.csv,BTC_USD,HOUR,100151.17,0.234,14/02/2018 00:00:00,14/02/2018 01:00:00,14/02/2018 01:00:00,EXPIRED,LONG,8550.0,8669.0,9151.87,0.0,0.02,6.58,0.0,140.84,2,0.1,27.85
04/02/2023 13:00:00,16/06/2023 15:50:22,Gemini_BTCUSD_1h_17_12_17_to_10_03_23.csv,BTC_USD,HOUR,100179.02,0.085,04/02/2023 14:00:00,04/02/2023 16:00:00,04/02/2023 16:00:00,EXPIRED,LONG,23515.0,23412.0,25223.78,0.0,0.02,6.77,0.0,145.25,2,0.1,-8.76
08/03/2022 03:00:00,16/06/2023 15:50:22,Gemini_BTCUSD_1h_17_12_17_to_10_03_23.csv,BTC_USD,HOUR,100170.26,0.052,08/03/2022 04:00:00,08/03/2022 06:00:00,08/03/2022 06:00:00,EXPIRED,LONG,38686.0,38281.0,41062.94,0.0,0.02,5.79,0.0,123.6,2,0.1,-21.06
14/04/2020 15:00:00,16/06/2023 15:50:22,Gemini_BTCUSD_1h_17_12_17_to_10_03_23.csv,BTC_USD,HOUR,100149.2,0.289,14/04/2020 16:00:00,14/04/2020 18:00:00,14/04/2020 18:00:00,EXPIRED,LONG,6926.0,6922.0,7105.47,0.0,0.02,2.53,0.0,51.87,2,0.0,-1.16
22/11/2018 23:00:00,16/06/2023 15:50:22,Gemini_BTCUSD_1h_17_12_17_to_10_03_23.csv,BTC_USD,HOUR,100148.04,0.47,23/11/2018 01:00:00,23/11/2018 02:00:00,23/11/2018 02:00:00,EXPIRED,LONG,4263.0,4195.0,4593.26,0.0,0.02,7.19,0.0,155.22,2,0.1,-31.96
22/01/2022 23:00:00,16/06/2023 15:50:22,Gemini_BTCUSD_1h_17_12_17_to_10_03_23.csv,BTC_USD,HOUR,100116.08,0.057,23/01/2022 01:00:00,23/01/2022 02:00:00,23/01/2022 02:00:00,EXPIRED,LONG,35082.0,34887.0,37946.04,0.0,0.02,7.55,0.0,163.25,2,0.1,-11.11
21/02/2021 19:00:00,16/06/2023 15:50:22,Gemini_BTCUSD_1h_17_12_17_to_10_03_23.csv,BTC_USD,HOUR,100104.97,0.034,21/02/2021 20:00:00,21/02/2021 22:00:00,21/02/2021 22:00:00,EXPIRED,LONG,58108.0,57409.0,62257.63,0.0,0.02,6.67,0.0,141.09,2,0.1,-23.77
16/07/2018 11:00:00,16/06/2023 15:50:22,Gemini_BTCUSD_1h_17_12_17_to_10_03_23.csv,BTC_USD,HOUR,100081.2,0.302,16/07/2018 12:00:00,16/07/2018 14:00:00,16/07/2018 14:00:00,EXPIRED,LONG,6632.0,6625.0,6803.25,0.0,0.02,2.52,0.0,51.72,2,0.0,-2.11
09/10/2019 09:00:00,16/06/2023 15:50:22,Gemini_BTCUSD_1h_17_12_17_to_10_03_23.csv,BTC_USD,HOUR,100079.09,0.244,09/10/2019 10:00:00,09/10/2019 12:00:00,09/10/2019 12:00:00,EXPIRED,LONG,8194.0,8164.0,8909.27,0.0,0.02,8.03,0.0,174.53,2,0.1,-7.32
12/09/2021 08:00:00,16/06/2023 15:50:22,Gemini_BTCUSD_1h_17_12_17_to_10_03_23.csv,BTC_USD,HOUR,100071.77,0.043,12/09/2021 11:00:00,12/09/2021 11:00:00,12/09/2021 11:00:00,EXPIRED,LONG,46114.0,46090.0,48197.27,0.0,0.02,4.32,0.0,89.58,2,0.0,-1.03
05/05/2018 09:00:00,16/06/2023 15:50:22,Gemini_BTCUSD_1h_17_12_17_to_10_03_23.csv,BTC_USD,HOUR,100070.74,0.204,05/05/2018 13:00:00,05/05/2018 12:00:00,05/05/2018 12:00:00,EXPIRED,LONG,9818.0,9899.0,10082.16,0.0,0.02,2.62,0.0,53.89,2,0.0,16.52
27/06/2021 07:00:00,16/06/2023 15:50:22,Gemini_BTCUSD_1h_17_12_17_to_10_03_23.csv,BTC_USD,HOUR,100087.26,0.06,27/06/2021 10:00:00,27/06/2021 10:00:00,27/06/2021 10:00:00,EXPIRED,LONG,33304.0,32716.0,35675.4,0.0,0.02,6.65,0.0,142.28,2,0.1,-35.28
16/10/2018 21:00:00,16/06/2023 15:50:22,Gemini_BTCUSD_1h_17_12_17_to_10_03_23.csv,BTC_USD,HOUR,100051.98,0.31,16/10/2018 22:00:00,17/10/2018 00:00:00,17/10/2018 00:00:00,EXPIRED,LONG,6464.0,6454.0,7018.4,0.0,0.02,7.9,0.0,171.86,2,0.1,-3.1
30/09/2018 10:00:00,16/06/2023 15:50:22,Gemini_BTCUSD_1h_17_12_17_to_10_03_23.csv,BTC_USD,HOUR,100048.88,0.302,30/09/2018 11:00:00,30/09/2018 13:00:00,30/09/2018 13:00:00,EXPIRED,LONG,6620.0,6621.0,7110.49,0.0,0.02,6.9,0.0,148.13,2,0.1,0.3
20/02/2018 05:00:00,16/06/2023 15:50:22,Gemini_BTCUSD_1h_17_12_17_to_10_03_23.csv,BTC_USD,HOUR,100049.18,0.175,20/02/2018 06:00:00,20/02/2018 08:00:00,20/02/2018 08:00:00,EXPIRED,LONG,11460.0,11363.0,12012.06,0.0,0.02,4.6,0.0,96.61,2,0.0,-16.97
21/05/2021 10:00:00,16/06/2023 15:50:22,Gemini_BTCUSD_1h_17_12_17_to_10_03_23.csv,BTC_USD,HOUR,100032.21,0.049,21/05/2021 14:00:00,21/05/2021 13:00:00,21/05/2021 13:00:00,EXPIRED,LONG,40812.0,41163.0,42601.04,0.0,0.02,4.2,0.0,87.66,2,0.0,17.2
27/05/2021 08:00:00,16/06/2023 15:50:22,Gemini_BTCUSD_1h_17_12_17_to_10_03_23.csv,BTC_USD,HOUR,100049.41,0.051,27/05/2021 09:00:00,27/05/2021 11:00:00,27/05/2021 11:00:00,TAKE_PROFIT_HIT,LONG,38886.0,39795.93,39795.93,0.0,0.02,2.29,0.0,46.41,2,0.0,46.41
16/11/2020 01:00:00,16/06/2023 15:50:22,Gemini_BTCUSD_1h_17_12_17_to_10_03_23.csv,BTC_USD,HOUR,100095.82,0.125,16/11/2020 02:00:00,16/11/2020 04:00:00,16/11/2020 04:00:00,EXPIRED,LONG,15969.0,16048.0,17294.16,0.0,0.02,7.66,0.0,165.65,2,0.1,9.88
07/02/2020 16:00:00,16/06/2023 15:50:22,Gemini_BTCUSD_1h_17_12_17_to_10_03_23.csv,BTC_USD,HOUR,100105.7,0.205,07/02/2020 20:00:00,07/02/2020 19:00:00,07/02/2020 19:00:00,EXPIRED,LONG,9786.0,9769.0,9994.67,0.0,0.02,2.09,0.0,42.78,2,0.0,-3.48
21/05/2022 11:00:00,16/06/2023 15:50:22,Gemini_BTCUSD_1h_17_12_17_to_10_03_23.csv,BTC_USD,HOUR,100102.22,0.068,21/05/2022 12:00:00,21/05/2022 14:00:00,21/05/2022 14:00:00,EXPIRED,LONG,29253.0,29365.0,30093.51,0.0,0.02,2.79,0.0,57.15,2,0.0,7.62
17/11/2020 12:00:00,16/06/2023 15:50:22,Gemini_BTCUSD_1h_17_12_17_to_10_03_23.csv,BTC_USD,HOUR,100109.84,0.117,17/11/2020 13:00:00,17/11/2020 15:00:00,17/11/2020 15:00:00,EXPIRED,LONG,17099.0,17342.0,18187.93,0.0,0.02,5.99,0.0,127.4,2,0.1,28.43
15/05/2022 13:00:00,16/06/2023 15:50:22,Gemini_BTCUSD_1h_17_12_17_to_10_03_23.csv,BTC_USD,HOUR,100138.27,0.066,15/05/2022 14:00:00,15/05/2022 16:00:00,15/05/2022 16:00:00,EXPIRED,LONG,30143.0,30179.0,32416.34,0.0,0.02,7.01,0.0,150.04,2,0.1,2.38
22/07/2022 06:00:00,16/06/2023 15:50:22,Gemini_BTCUSD_1h_17_12_17_to_10_03_23.csv,BTC_USD,HOUR,100140.65,0.086,22/07/2022 10:00:00,22/07/2022 09:00:00,22/07/2022 09:00:00,EXPIRED,LONG,23162.0,23466.0,23730.94,0.0,0.02,2.4,0.0,48.93,2,0.0,26.14
23/08/2021 05:00:00,16/06/2023 15:50:22,Gemini_BTCUSD_1h_17_12_17_to_10_03_23.csv,BTC_USD,HOUR,100166.79,0.04,23/08/2021 06:00:00,23/08/2021 08:00:00,23/08/2021 08:00:00,EXPIRED,LONG,50250.0,50280.0,52658.16,0.0,0.02,4.57,0.0,96.33,2,0.0,1.2
07/11/2021 21:00:00,16/06/2023 15:50:23,Gemini_BTCUSD_1h_17_12_17_to_10_03_23.csv,BTC_USD,HOUR,100167.99,0.032,07/11/2021 22:00:00,08/11/2021 00:00:00,08/11/2021 00:00:00,EXPIRED,LONG,62874.0,65014.0,66772.43,0.0,0.02,5.84,0.0,124.75,2,0.1,68.48
26/02/2019 20:00:00,16/06/2023 15:50:23,Gemini_BTCUSD_1h_17_12_17_to_10_03_23.csv,BTC_USD,HOUR,100236.47,0.528,26/02/2019 21:00:00,26/02/2019 23:00:00,26/02/2019 23:00:00,EXPIRED,LONG,3795.0,3800.0,3936.23,0.0,0.02,3.59,0.0,74.57,2,0.0,2.64
16/10/2022 12:00:00,16/06/2023 15:50:23,Gemini_BTCUSD_1h_17_12_17_to_10_03_23.csv,BTC_USD,HOUR,100239.11,0.105,16/10/2022 13:00:00,16/10/2022 15:00:00,16/10/2022 15:00:00,EXPIRED,LONG,19130.0,19159.0,19876.14,0.0,0.02,3.75,0.0,78.34,2,0.0,3.05
05/01/2019 17:00:00,16/06/2023 15:50:23,Gemini_BTCUSD_1h_17_12_17_to_10_03_23.csv,BTC_USD,HOUR,100242.16,0.523,05/01/2019 21:00:00,05/01/2019 20:00:00,05/01/2019 20:00:00,EXPIRED,LONG,3833.0,3835.0,4032.96,0.0,0.02,4.96,0.0,104.58,2,0.1,1.05
26/12/2022 13:00:00,16/06/2023 15:50:23,Gemini_BTCUSD_1h_17_12_17_to_10_03_23.csv,BTC_USD,HOUR,100243.21,0.119,26/12/2022 14:00:00,26/12/2022 16:00:00,26/12/2022 16:00:00,EXPIRED,LONG,16842.0,16831.0,18182.56,0.0,0.02,7.37,0.0,159.53,2,0.1,-1.31
25/11/2019 12:00:00,16/06/2023 15:50:23,Gemini_BTCUSD_1h_17_12_17_to_10_03_23.csv,BTC_USD,HOUR,100241.9,0.281,25/11/2019 14:00:00,25/11/2019 15:00:00,25/11/2019 15:00:00,EXPIRED,LONG,7124.0,7256.0,7392.17,0.0,0.02,3.63,0.0,75.36,2,0.0,37.09
08/03/2023 18:00:00,16/06/2023 15:50:23,Gemini_BTCUSD_1h_17_12_17_to_10_03_23.csv,BTC_USD,HOUR,100278.99,0.091,08/03/2023 19:00:00,08/03/2023 21:00:00,08/03/2023 21:00:00,EXPIRED,LONG,22020.0,22007.0,23512.32,0.0,0.02,6.35,0.0,135.8,2,0.1,-1.18
19/09/2020 21:00:00,16/06/2023 15:50:23,Gemini_BTCUSD_1h_17_12_17_to_10_03_23.csv,BTC_USD,HOUR,100277.81,0.181,19/09/2020 22:00:00,20/09/2020 00:00:00,20/09/2020 00:00:00,EXPIRED,LONG,11055.0,11067.0,11328.2,0.0,0.02,2.41,0.0,49.45,2,0.0,2.17
25/06/2022 22:00:00,16/06/2023 15:50:23,Gemini_BTCUSD_1h_17_12_17_to_10_03_23.csv,BTC_USD,HOUR,100279.98,0.094,25/06/2022 23:00:00,26/06/2022 01:00:00,26/06/2022 01:00:00,EXPIRED,LONG,21418.0,21393.0,23105.76,0.0,0.02,7.3,0.0,158.65,2,0.1,-2.35
14/05/2020 21:00:00,16/06/2023 15:50:23,Gemini_BTCUSD_1h_17_12_17_to_10_03_23.csv,BTC_USD,HOUR,100277.63,0.205,15/05/2020 01:00:00,15/05/2020 00:00:00,15/05/2020 00:00:00,EXPIRED,LONG,9775.0,9784.0,10222.98,0.0,0.02,4.38,0.0,91.84,2,0.0,1.85
28/03/2018 15:00:00,16/06/2023 15:50:23,Gemini_BTCUSD_1h_17_12_17_to_10_03_23.csv,BTC_USD,HOUR,100279.48,0.255,28/03/2018 18:00:00,28/03/2018 18:00:00,28/03/2018 18:00:00,EXPIRED,LONG,7860.0,7932.0,8051.46,0.0,0.02,2.38,0.0,48.82,2,0.0,18.36
04/10/2020 13:00:00,16/06/2023 15:50:23,Gemini_BTCUSD_1h_17_12_17_to_10_03_23.csv,BTC_USD,HOUR,100297.84,0.189,04/10/2020 15:00:00,04/10/2020 16:00:00,04/10/2020 16:00:00,EXPIRED,LONG,10615.0,10603.0,10891.34,0.0,0.02,2.54,0.0,52.23,2,0.0,-2.27
27/11/2022 06:00:00,16/06/2023 15:50:23,Gemini_BTCUSD_1h_17_12_17_to_10_03_23.csv,BTC_USD,HOUR,100295.57,0.121,27/11/2022 07:00:00,27/11/2022 09:00:00,27/11/2022 09:00:00,EXPIRED,LONG,16556.0,16528.0,17523.87,0.0,0.02,5.52,0.0,117.11,2,0.1,-3.39
24/02/2022 23:00:00,16/06/2023 15:50:23,Gemini_BTCUSD_1h_17_12_17_to_10_03_23.csv,BTC_USD,HOUR,100292.18,0.052,25/02/2022 00:00:00,25/02/2022 02:00:00,25/02/2022 02:00:00,EXPIRED,LONG,38347.0,38825.0,41327.04,0.0,0.02,7.21,0.0,154.96,2,0.1,24.86
09/06/2022 11:00:00,16/06/2023 15:50:23,Gemini_BTCUSD_1h_17_12_17_to_10_03_23.csv,BTC_USD,HOUR,100317.04,0.066,09/06/2022 12:00:00,09/06/2022 14:00:00,09/06/2022 14:00:00,EXPIRED,LONG,30271.0,30101.0,32402.94,0.0,0.02,6.58,0.0,140.71,2,0.1,-11.22
17/12/2022 11:00:00,16/06/2023 15:50:23,Gemini_BTCUSD_1h_17_12_17_to_10_03_23.csv,BTC_USD,HOUR,100305.82,0.12,17/12/2022 12:00:00,17/12/2022 14:00:00,17/12/2022 14:00:00,EXPIRED,LONG,16709.0,16651.0,17005.81,0.0,0.02,1.75,0.0,35.62,2,0.0,-6.96
14/02/2023 03:00:00,16/06/2023 15:50:23,Gemini_BTCUSD_1h_17_12_17_to_10_03_23.csv,BTC_USD,HOUR,100298.86,0.092,14/02/2023 04:00:00,14/02/2023 06:00:00,14/02/2023 06:00:00,EXPIRED,LONG,21713.0,21764.0,22319.27,0.0,0.02,2.72,0.0,55.78,2,0.0,4.69
14/05/2020 17:00:00,16/06/2023 15:50:23,Gemini_BTCUSD_1h_17_12_17_to_10_03_23.csv,BTC_USD,HOUR,100303.55,0.209,14/05/2020 18:00:00,14/05/2020 20:00:00,14/05/2020 20:00:00,TAKE_PROFIT_HIT,LONG,9618.0,9850.93,9850.93,0.0,0.02,2.36,0.0,48.68,2,0.0,48.68
08/02/2018 15:00:00,16/06/2023 15:50:23,Gemini_BTCUSD_1h_17_12_17_to_10_03_23.csv,BTC_USD,HOUR,100352.23,0.244,08/02/2018 17:00:00,08/02/2018 18:00:00,08/02/2018 18:00:00,EXPIRED,LONG,8229.0,8206.0,8620.1,0.0,0.02,4.54,0.0,95.43,2,0.0,-5.61
12/10/2018 17:00:00,16/06/2023 15:50:23,Gemini_BTCUSD_1h_17_12_17_to_10_03_23.csv,BTC_USD,HOUR,100346.62,0.324,12/10/2018 19:00:00,12/10/2018 20:00:00,12/10/2018 20:00:00,EXPIRED,LONG,6196.0,6215.0,6508.57,0.0,0.02,4.8,0.0,101.27,2,0.1,6.16
13/04/2021 02:00:00,16/06/2023 15:50:23,Gemini_BTCUSD_1h_17_12_17_to_10_03_23.csv,BTC_USD,HOUR,100352.78,0.033,13/04/2021 03:00:00,13/04/2021 05:00:00,13/04/2021 05:00:00,EXPIRED,LONG,60814.0,60662.0,64916.68,0.0,0.02,6.32,0.0,135.39,2,0.1,-5.02
06/05/2018 00:00:00,16/06/2023 15:50:23,Gemini_BTCUSD_1h_17_12_17_to_10_03_23.csv,BTC_USD,HOUR,100347.76,0.203,06/05/2018 03:00:00,06/05/2018 03:00:00,06/05/2018 03:00:00,EXPIRED,LONG,9870.0,9828.0,10218.52,0.0,0.02,3.41,0.0,70.75,2,0.0,-8.53
19/03/2019 18:00:00,16/06/2023 15:50:23,Gemini_BTCUSD_1h_17_12_17_to_10_03_23.csv,BTC_USD,HOUR,100339.23,0.503,19/03/2019 19:00:00,19/03/2019 21:00:00,19/03/2019 21:00:00,EXPIRED,LONG,3988.0,3989.0,4254.44,0.0,0.02,6.26,0.0,134.02,2,0.1,0.5
10/10/2022 03:00:00,16/06/2023 15:50:23,Gemini_BTCUSD_1h_17_12_17_to_10_03_23.csv,BTC_USD,HOUR,100339.73,0.103,10/10/2022 04:00:00,10/10/2022 06:00:00,10/10/2022 06:00:00,EXPIRED,LONG,19456.0,19397.0,21206.84,0.0,0.02,8.26,0.0,180.34,2,0.1,-6.08
29/05/2018 14:00:00,16/06/2023 15:50:23,Gemini_BTCUSD_1h_17_12_17_to_10_03_23.csv,BTC_USD,HOUR,100333.65,0.27,29/05/2018 15:00:00,29/05/2018 17:00:00,29/05/2018 17:00:00,EXPIRED,LONG,7421.0,7518.0,7985.07,0.0,0.02,7.06,0.0,152.3,2,0.1,26.19
01/05/2020 12:00:00,16/06/2023 15:50:23,Gemini_BTCUSD_1h_17_12_17_to_10_03_23.csv,BTC_USD,HOUR,100359.84,0.226,01/05/2020 13:00:00,01/05/2020 15:00:00,01/05/2020 15:00:00,EXPIRED,LONG,8885.0,8731.0,9622.51,0.0,0.02,7.66,0.0,166.68,2,0.1,-34.8
09/04/2022 18:00:00,16/06/2023 15:50:23,Gemini_BTCUSD_1h_17_12_17_to_10_03_23.csv,BTC_USD,HOUR,100325.04,0.047,09/04/2022 19:00:00,09/04/2022 21:00:00,09/04/2022 21:00:00,EXPIRED,LONG,42489.0,42580.0,45127.69,0.0,0.02,5.85,0.0,124.02,2,0.1,4.28
16/04/2021 19:00:00,16/06/2023 15:50:23,Gemini_BTCUSD_1h_17_12_17_to_10_03_23.csv,BTC_USD,HOUR,100329.32,0.032,16/04/2021 22:00:00,16/04/2021 22:00:00,16/04/2021 22:00:00,EXPIRED,LONG,61851.0,61625.0,63448.13,0.0,0.02,2.52,0.0,51.11,2,0.0,-7.23
21/08/2019 18:00:00,16/06/2023 15:50:23,Gemini_BTCUSD_1h_17_12_17_to_10_03_23.csv,BTC_USD,HOUR,100322.09,0.199,21/08/2019 19:00:00,21/08/2019 21:00:00,21/08/2019 21:00:00,EXPIRED,LONG,10066.0,10045.0,10293.88,0.0,0.02,2.21,0.0,45.35,2,0.0,-4.18
22/10/2021 10:00:00,16/06/2023 15:50:23,Gemini_BTCUSD_1h_17_12_17_to_10_03_23.csv,BTC_USD,HOUR,100317.91,0.032,22/10/2021 11:00:00,22/10/2021 13:00:00,22/10/2021 13:00:00,EXPIRED,LONG,63207.0,62396.0,64615.99,0.0,0.02,2.18,0.0,45.09,2,0.0,-25.95
19/07/2020 15:00:00,16/06/2023 15:50:23,Gemini_BTCUSD_1h_17_12_17_to_10_03_23.csv,BTC_USD,HOUR,100291.96,0.22,19/07/2020 17:00:00,19/07/2020 18:00:00,19/07/2020 18:00:00,EXPIRED,LONG,9125.0,9165.0,9395.33,0.0,0.02,2.88,0.0,59.47,2,0.0,8.8
01/11/2020 17:00:00,16/06/2023 15:50:23,Gemini_BTCUSD_1h_17_12_17_to_10_03_23.csv,BTC_USD,HOUR,100300.76,0.145,01/11/2020 18:00:00,01/11/2020 20:00:00,01/11/2020 20:00:00,EXPIRED,LONG,13824.0,13835.0,14689.95,0.0,0.02,5.89,0.0,125.56,2,0.1,1.6
17/10/2022 08:00:00,16/06/2023 15:50:23,Gemini_BTCUSD_1h_17_12_17_to_10_03_23.csv,BTC_USD,HOUR,100302.36,0.104,17/10/2022 09:00:00,17/10/2022 11:00:00,17/10/2022 11:00:00,EXPIRED,LONG,19265.0,19462.0,20949.05,0.0,0.02,8.04,0.0,175.14,2,0.1,20.49
10/03/2020 12:00:00,16/06/2023 15:50:23,Gemini_BTCUSD_1h_17_12_17_to_10_03_23.csv,BTC_USD,HOUR,100322.85,0.247,10/03/2020 13:00:00,10/03/2020 15:00:00,10/03/2020 15:00:00,EXPIRED,LONG,8136.0,7765.0,8453.98,0.0,0.02,3.76,0.0,78.54,2,0.0,-91.64
23/10/2018 18:00:00,16/06/2023 15:50:23,Gemini_BTCUSD_1h_17_12_17_to_10_03_23.csv,BTC_USD,HOUR,100231.21,0.314,23/10/2018 20:00:00,23/10/2018 21:00:00,23/10/2018 21:00:00,EXPIRED,LONG,6393.0,6395.0,6536.24,0.0,0.02,2.19,0.0,44.98,2,0.0,0.63
02/04/2019 22:00:00,16/06/2023 15:50:23,Gemini_BTCUSD_1h_17_12_17_to_10_03_23.csv,BTC_USD,HOUR,100231.84,0.415,02/04/2019 23:00:00,03/04/2019 01:00:00,03/04/2019 01:00:00,EXPIRED,LONG,4829.0,4970.0,5060.54,0.0,0.02,4.58,0.0,96.09,2,0.0,58.52
26/03/2021 05:00:00,16/06/2023 15:50:23,Gemini_BTCUSD_1h_17_12_17_to_10_03_23.csv,BTC_USD,HOUR,100290.36,0.038,26/03/2021 07:00:00,26/03/2021 08:00:00,26/03/2021 08:00:00,EXPIRED,LONG,52836.0,53411.0,55881.06,0.0,0.02,5.45,0.0,115.71,2,0.1,21.85
22/04/2019 04:00:00,16/06/2023 15:50:23,Gemini_BTCUSD_1h_17_12_17_to_10_03_23.csv,BTC_USD,HOUR,100312.21,0.38,22/04/2019 05:00:00,22/04/2019 07:00:00,22/04/2019 07:00:00,EXPIRED,LONG,5279.0,5287.0,5425.62,0.0,0.02,2.7,0.0,55.72,2,0.0,3.04
29/05/2022 11:00:00,16/06/2023 15:50:23,Gemini_BTCUSD_1h_17_12_17_to_10_03_23.csv,BTC_USD,HOUR,100315.25,0.069,29/05/2022 12:00:00,29/05/2022 14:00:00,29/05/2022 14:00:00,EXPIRED,LONG,29195.0,29280.0,30882.41,0.0,0.02,5.46,0.0,116.43,2,0.1,5.87
12/10/2021 06:00:00,16/06/2023 15:50:23,Gemini_BTCUSD_1h_17_12_17_to_10_03_23.csv,BTC_USD,HOUR,100321.12,0.035,12/10/2021 08:00:00,12/10/2021 09:00:00,12/10/2021 09:00:00,EXPIRED,LONG,57249.0,56946.0,61766.39,0.0,0.02,7.31,0.0,158.11,2,0.1,-10.6
13/06/2021 02:00:00,16/06/2023 15:50:23,Gemini_BTCUSD_1h_17_12_17_to_10_03_23.csv,BTC_USD,HOUR,100310.52,0.057,13/06/2021 05:00:00,13/06/2021 05:00:00,13/06/2021 05:00:00,EXPIRED,LONG,35475.0,34984.0,36692.61,0.0,0.02,3.32,0.0,69.4,2,0.0,-27.99
23/02/2018 13:00:00,16/06/2023 15:50:23,Gemini_BTCUSD_1h_17_12_17_to_10_03_23.csv,BTC_USD,HOUR,100282.53,0.197,23/02/2018 14:00:00,23/02/2018 16:00:00,23/02/2018 16:00:00,EXPIRED,LONG,10204.0,10086.0,10572.66,0.0,0.02,3.49,0.0,72.63,2,0.0,-23.25
13/01/2023 22:00:00,16/06/2023 15:50:23,Gemini_BTCUSD_1h_17_12_17_to_10_03_23.csv,BTC_USD,HOUR,100259.28,0.101,13/01/2023 23:00:00,14/01/2023 01:00:00,14/01/2023 00:00:00,TAKE_PROFIT_HIT,LONG,19869.0,21211.33,21211.33,0.0,0.02,6.33,0.0,135.58,2,0.1,135.58
10/09/2022 22:00:00,16/06/2023 15:50:23,Gemini_BTCUSD_1h_17_12_17_to_10_03_23.csv,BTC_USD,HOUR,100394.86,0.092,11/09/2022 02:00:00,11/09/2022 01:00:00,11/09/2022 01:00:00,EXPIRED,LONG,21776.0,21615.0,22582.32,0.0,0.02,3.57,0.0,74.18,2,0.0,-14.81
19/04/2018 03:00:00,16/06/2023 15:50:23,Gemini_BTCUSD_1h_17_12_17_to_10_03_23.csv,BTC_USD,HOUR,100380.05,0.245,19/04/2018 04:00:00,19/04/2018 06:00:00,19/04/2018 06:00:00,EXPIRED,LONG,8192.0,8171.0,8762.55,0.0,0.02,6.51,0.0,139.78,2,0.1,-5.14
21/09/2022 13:00:00,16/06/2023 15:50:23,Gemini_BTCUSD_1h_17_12_17_to_10_03_23.csv,BTC_USD,HOUR,100374.91,0.104,21/09/2022 14:00:00,21/09/2022 16:00:00,21/09/2022 16:00:00,EXPIRED,LONG,19278.0,19244.0,21023.79,0.0,0.02,8.3,0.0,181.56,2,0.1,-3.54
03/03/2018 07:00:00,16/06/2023 15:50:23,Gemini_BTCUSD_1h_17_12_17_to_10_03_23.csv,BTC_USD,HOUR,100371.37,0.178,03/03/2018 09:00:00,03/03/2018 10:00:00,03/03/2018 10:00:00,EXPIRED,LONG,11300.0,11316.0,11590.91,0.0,0.02,2.51,0.0,51.78,2,0.0,2.85
11/02/2021 11:00:00,16/06/2023 15:50:23,Gemini_BTCUSD_1h_17_12_17_to_10_03_23.csv,BTC_USD,HOUR,100374.22,0.044,11/02/2021 12:00:00,11/02/2021 14:00:00,11/02/2021 14:00:00,EXPIRED,LONG,46093.0,47942.0,49073.38,0.0,0.02,6.07,0.0,131.14,2,0.1,81.36
24/05/2022 09:00:00,16/06/2023 15:50:23,Gemini_BTCUSD_1h_17_12_17_to_10_03_23.csv,BTC_USD,HOUR,100455.58,0.069,24/05/2022 12:00:00,24/05/2022 12:00:00,24/05/2022 12:00:00,EXPIRED,LONG,29300.0,29222.0,29949.11,0.0,0.02,2.17,0.0,44.79,2,0.0,-5.38
06/09/2019 06:00:00,16/06/2023 15:50:23,Gemini_BTCUSD_1h_17_12_17_to_10_03_23.csv,BTC_USD,HOUR,100450.2,0.187,06/09/2019 07:00:00,06/09/2019 09:00:00,06/09/2019 09:00:00,EXPIRED,LONG,10746.0,10741.0,11201.88,0.0,0.02,4.07,0.0,85.25,2,0.0,-0.93
20/01/2022 08:00:00,16/06/2023 15:50:23,Gemini_BTCUSD_1h_17_12_17_to_10_03_23.csv,BTC_USD,HOUR,100449.27,0.048,20/01/2022 09:00:00,20/01/2022 11:00:00,20/01/2022 11:00:00,EXPIRED,LONG,41994.0,42164.0,43871.27,0.0,0.02,4.28,0.0,90.11,2,0.0,8.16
29/03/2020 02:00:00,16/06/2023 15:50:23,Gemini_BTCUSD_1h_17_12_17_to_10_03_23.csv,BTC_USD,HOUR,100457.43,0.323,29/03/2020 05:00:00,29/03/2020 05:00:00,29/03/2020 05:00:00,EXPIRED,LONG,6220.0,6160.0,6391.39,0.0,0.02,2.68,0.0,55.36,2,0.0,-19.38
17/08/2018 18:00:00,16/06/2023 15:50:23,Gemini_BTCUSD_1h_17_12_17_to_10_03_23.csv,BTC_USD,HOUR,100438.05,0.308,17/08/2018 19:00:00,17/08/2018 21:00:00,17/08/2018 21:00:00,EXPIRED,LONG,6520.0,6521.0,7066.8,0.0,0.02,7.74,0.0,168.41,2,0.1,0.31
16/12/2019 00:00:00,16/06/2023 15:50:23,Gemini_BTCUSD_1h_17_12_17_to_10_03_23.csv,BTC_USD,HOUR,100438.36,0.284,16/12/2019 01:00:00,16/12/2019 03:00:00,16/12/2019 03:00:00,EXPIRED,LONG,7074.0,7065.0,7251.52,0.0,0.02,2.45,0.0,50.42,2,0.0,-2.56
30/04/2019 12:00:00,16/06/2023 15:50:23,Gemini_BTCUSD_1h_17_12_17_to_10_03_23.csv,BTC_USD,HOUR,100435.8,0.385,30/04/2019 13:00:00,30/04/2019 15:00:00,30/04/2019 15:00:00,EXPIRED,LONG,5212.0,5259.0,5615.14,0.0,0.02,7.18,0.0,155.21,2,0.1,18.1
02/01/2018 01:00:00,16/06/2023 15:50:23,Gemini_BTCUSD_1h_17_12_17_to_10_03_23.csv,BTC_USD,HOUR,100453.9,0.148,02/01/2018 02:00:00,02/01/2018 04:00:00,02/01/2018 02:00:00,TAKE_PROFIT_HIT,LONG,13607.0,13648.17,13648.17,0.0,0.02,0.3,0.0,6.09,2,0.0,6.09
26/01/2021 03:00:00,16/06/2023 15:50:23,Gemini_BTCUSD_1h_17_12_17_to_10_03_23.csv,BTC_USD,HOUR,100459.99,0.064,26/01/2021 05:00:00,26/01/2021 06:00:00,26/01/2021 05:00:00,TAKE_PROFIT_HIT,LONG,31558.0,32268.2,32268.2,0.0,0.02,2.2,0.0,45.45,2,0.0,45.45
19/02/2018 16:00:00,16/06/2023 15:50:23,Gemini_BTCUSD_1h_17_12_17_to_10_03_23.csv,BTC_USD,HOUR,100505.44,0.181,19/02/2018 17:00:00,19/02/2018 19:00:00,19/02/2018 19:00:00,EXPIRED,LONG,11075.0,11143.0,11762.18,0.0,0.02,5.84,0.0,124.38,2,0.1,12.31
05/03/2023 19:00:00,16/06/2023 15:50:23,Gemini_BTCUSD_1h_17_12_17_to_10_03_23.csv,BTC_USD,HOUR,100517.75,0.09,05/03/2023 20:00:00,05/03/2023 22:00:00,05/03/2023 22:00:00,EXPIRED,LONG,22411.0,22437.0,23245.02,0.0,0.02,3.59,0.0,75.06,2,0.0,2.34
04/10/2020 19:00:00,16/06/2023 15:50:23,Gemini_BTCUSD_1h_17_12_17_to_10_03_23.csv,BTC_USD,HOUR,100520.09,0.188,04/10/2020 20:00:00,04/10/2020 22:00:00,04/10/2020 22:00:00,EXPIRED,LONG,10680.0,10665.0,11381.01,0.0,0.02,6.16,0.0,131.79,2,0.1,-2.82
27/12/2020 05:00:00,16/06/2023 15:50:23,Gemini_BTCUSD_1h_17_12_17_to_10_03_23.csv,BTC_USD,HOUR,100517.27,0.075,27/12/2020 08:00:00,27/12/2020 08:00:00,27/12/2020 08:00:00,EXPIRED,LONG,26895.0,27456.0,27958.47,0.0,0.02,3.8,0.0,79.76,2,0.0,42.08
19/10/2021 00:00:00,16/06/2023 15:50:23,Gemini_BTCUSD_1h_17_12_17_to_10_03_23.csv,BTC_USD,HOUR,100559.35,0.033,19/10/2021 03:00:00,19/10/2021 03:00:00,19/10/2021 03:00:00,EXPIRED,LONG,61870.0,62600.0,63270.64,0.0,0.02,2.21,0.0,46.22,2,0.0,24.09
09/12/2019 14:00:00,16/06/2023 15:50:23,Gemini_BTCUSD_1h_17_12_17_to_10_03_23.csv,BTC_USD,HOUR,100583.44,0.267,09/12/2019 17:00:00,09/12/2019 17:00:00,09/12/2019 17:00:00,EXPIRED,LONG,7541.0,7442.0,8092.38,0.0,0.02,6.81,0.0,147.22,2,0.1,-26.43
05/03/2023 04:00:00,16/06/2023 15:50:23,Gemini_BTCUSD_1h_17_12_17_to_10_03_23.csv,BTC_USD,HOUR,100557.01,0.09,05/03/2023 05:00:00,05/03/2023 07:00:00,05/03/2023 07:00:00,EXPIRED,LONG,22448.0,22377.0,23445.39,0.0,0.02,4.25,0.0,89.77,2,0.0,-6.39
20/12/2017 09:00:00,16/06/2023 15:50:23,Gemini_BTCUSD_1h_17_12_17_to_10_03_23.csv,BTC_USD,HOUR,100550.62,0.119,20/12/2017 11:00:00,20/12/2017 12:00:00,20/12/2017 12:00:00,EXPIRED,LONG,16899.0,17841.0,18263.31,0.0,0.02,7.47,0.0,162.35,2,0.1,112.1
05/12/2021 05:00:00,16/06/2023 15:50:23,Gemini_BTCUSD_1h_17_12_17_to_10_03_23.csv,BTC_USD,HOUR,100662.72,0.041,05/12/2021 06:00:00,05/12/2021 08:00:00,05/12/2021 08:00:00,EXPIRED,LONG,49495.0,49587.0,51534.92,0.0,0.02,3.96,0.0,83.64,2,0.0,3.77
24/09/2022 01:00:00,16/06/2023 15:50:23,Gemini_BTCUSD_1h_17_12_17_to_10_03_23.csv,BTC_USD,HOUR,100666.49,0.105,24/09/2022 02:00:00,24/09/2022 04:00:00,24/09/2022 04:00:00,EXPIRED,LONG,19117.0,19164.0,19638.37,0.0,0.02,2.65,0.0,54.74,2,0.0,4.93
04/11/2020 11:00:00,16/06/2023 15:50:23,Gemini_BTCUSD_1h_17_12_17_to_10_03_23.csv,BTC_USD,HOUR,100671.42,0.146,04/11/2020 15:00:00,04/11/2020 14:00:00,04/11/2020 14:00:00,EXPIRED,LONG,13745.0,13864.0,14294.88,0.0,0.02,3.85,0.0,80.28,2,0.0,17.37
05/10/2022 23:00:00,16/06/2023 15:50:23,Gemini_BTCUSD_1h_17_12_17_to_10_03_23.csv,BTC_USD,HOUR,100688.79,0.1,06/10/2022 01:00:00,06/10/2022 02:00:00,06/10/2022 02:00:00,EXPIRED,LONG,20166.0,20320.0,20898.78,0.0,0.02,3.51,0.0,73.28,2,0.0,15.4
03/02/2023 12:00:00,16/06/2023 15:50:23,Gemini_BTCUSD_1h_17_12_17_to_10_03_23.csv,BTC_USD,HOUR,100704.19,0.086,03/02/2023 13:00:00,03/02/2023 15:00:00,03/02/2023 15:00:00,EXPIRED,LONG,23527.0,23614.0,25516.31,0.0,0.02,7.8,0.0,171.08,2,0.1,7.48
18/11/2020 04:00:00,16/06/2023 15:50:23,Gemini_BTCUSD_1h_17_12_17_to_10_03_23.csv,BTC_USD,HOUR,100711.67,0.11,18/11/2020 05:00:00,18/11/2020 07:00:00,18/11/2020 07:00:00,EXPIRED,LONG,18378.0,18094.0,19534.44,0.0,0.02,5.92,0.0,127.21,2,0.1,-31.24
22/04/2019 04:00:00,16/06/2023 15:50:23,Gemini_BTCUSD_1h_17_12_17_to_10_03_23.csv,BTC_USD,HOUR,100680.43,0.381,22/04/2019 05:00:00,22/04/2019 07:00:00,22/04/2019 07:00:00,EXPIRED,LONG,5279.0,5287.0,5425.62,0.0,0.02,2.7,0.0,55.86,2,0.0,3.05
14/02/2020 23:00:00,16/06/2023 15:50:23,Gemini_BTCUSD_1h_17_12_17_to_10_03_23.csv,BTC_USD,HOUR,100683.48,0.194,15/02/2020 03:00:00,15/02/2020 02:00:00,15/02/2020 02:00:00,EXPIRED,LONG,10373.0,10243.0,10861.9,0.0,0.02,4.5,0.0,94.85,2,0.0,-25.22
12/09/2019 19:00:00,16/06/2023 15:50:23,Gemini_BTCUSD_1h_17_12_17_to_10_03_23.csv,BTC_USD,HOUR,100658.26,0.195,12/09/2019 20:00:00,12/09/2019 22:00:00,12/09/2019 22:00:00,EXPIRED,LONG,10309.0,10410.0,10562.37,0.0,0.02,2.4,0.0,49.41,2,0.0,19.7
30/03/2021 07:00:00,16/06/2023 15:50:23,Gemini_BTCUSD_1h_17_12_17_to_10_03_23.csv,BTC_USD,HOUR,100677.96,0.035,30/03/2021 08:00:00,30/03/2021 10:00:00,30/03/2021 10:00:00,EXPIRED,LONG,58129.0,58878.0,62916.18,0.0,0.02,7.61,0.0,167.55,2,0.1,26.22
29/12/2022 15:00:00,16/06/2023 15:50:23,Gemini_BTCUSD_1h_17_12_17_to_10_03_23.csv,BTC_USD,HOUR,100704.18,0.121,29/12/2022 16:00:00,29/12/2022 18:00:00,29/12/2022 18:00:00,EXPIRED,LONG,16610.0,16619.0,17430.57,0.0,0.02,4.71,0.0,99.29,2,0.0,1.09
26/08/2022 00:00:00,16/06/2023 15:50:23,Gemini_BTCUSD_1h_17_12_17_to_10_03_23.csv,BTC_USD,HOUR,100705.27,0.094,26/08/2022 04:00:00,26/08/2022 03:00:00,26/08/2022 03:00:00,EXPIRED,LONG,21481.0,21558.0,21980.92,0.0,0.02,2.27,0.0,46.99,2,0.0,7.24
20/02/2018 02:00:00,16/06/2023 15:50:23,Gemini_BTCUSD_1h_17_12_17_to_10_03_23.csv,BTC_USD,HOUR,100712.51,0.177,20/02/2018 04:00:00,20/02/2018 05:00:00,20/02/2018 05:00:00,EXPIRED,LONG,11366.0,11460.0,11770.64,0.0,0.02,3.44,0.0,71.62,2,0.0,16.64
09/09/2018 13:00:00,16/06/2023 15:50:23,Gemini_BTCUSD_1h_17_12_17_to_10_03_23.csv,BTC_USD,HOUR,100729.15,0.315,09/09/2018 14:00:00,09/09/2018 16:00:00,09/09/2018 16:00:00,EXPIRED,LONG,6399.0,6381.0,6720.82,0.0,0.02,4.79,0.0,101.37,2,0.1,-5.67
15/07/2021 21:00:00,16/06/2023 15:50:23,Gemini_BTCUSD_1h_17_12_17_to_10_03_23.csv,BTC_USD,HOUR,100723.48,0.064,15/07/2021 23:00:00,16/07/2021 00:00:00,16/07/2021 00:00:00,EXPIRED,LONG,31671.0,31639.0,34062.17,0.0,0.02,7.02,0.0,153.03,2,0.1,-2.05
07/06/2019 14:00:00,16/06/2023 15:50:23,Gemini_BTCUSD_1h_17_12_17_to_10_03_23.csv,BTC_USD,HOUR,100721.43,0.254,07/06/2019 17:00:00,07/06/2019 17:00:00,07/06/2019 17:00:00,EXPIRED,LONG,7934.0,8102.0,8179.6,0.0,0.02,3.0,0.0,62.38,2,0.0,42.67
22/01/2018 08:00:00,16/06/2023 15:50:23,Gemini_BTCUSD_1h_17_12_17_to_10_03_23.csv,BTC_USD,HOUR,100764.1,0.172,22/01/2018 09:00:00,22/01/2018 11:00:00,22/01/2018 11:00:00,EXPIRED,LONG,11710.0,11275.0,12634.98,0.0,0.02,7.32,0.0,159.1,2,0.1,-74.82
27/10/2020 02:00:00,16/06/2023 15:50:23,Gemini_BTCUSD_1h_17_12_17_to_10_03_23.csv,BTC_USD,HOUR,100689.28,0.154,27/10/2020 03:00:00,27/10/2020 05:00:00,27/10/2020 05:00:00,EXPIRED,LONG,13083.0,13099.0,13380.21,0.0,0.02,2.22,0.0,45.77,2,0.0,2.46
22/03/2022 04:00:00,16/06/2023 15:50:23,Gemini_BTCUSD_1h_17_12_17_to_10_03_23.csv,BTC_USD,HOUR,100691.74,0.047,22/03/2022 05:00:00,22/03/2022 07:00:00,22/03/2022 07:00:00,EXPIRED,LONG,43005.0,42258.0,43904.14,0.0,0.02,2.05,0.0,42.26,2,0.0,-35.11
28/02/2021 11:00:00,16/06/2023 15:50:23,Gemini_BTCUSD_1h_17_12_17_to_10_03_23.csv,BTC_USD,HOUR,100656.63,0.044,28/02/2021 12:00:00,28/02/2021 14:00:00,28/02/2021 14:00:00,EXPIRED,LONG,45301.0,44596.0,49321.48,0.0,0.02,8.15,0.0,176.9,2,0.1,-31.02
29/01/2021 10:00:00,16/06/2023 15:50:23,Gemini_BTCUSD_1h_17_12_17_to_10_03_23.csv,BTC_USD,HOUR,100625.61,0.055,29/01/2021 11:00:00,29/01/2021 13:00:00,29/01/2021 13:00:00,TAKE_PROFIT_HIT,LONG,36769.0,38206.04,38206.04,0.0,0.02,3.76,0.0,79.04,2,0.0,79.04
22/02/2018 22:00:00,16/06/2023 15:50:23,Gemini_BTCUSD_1h_17_12_17_to_10_03_23.csv,BTC_USD,HOUR,100704.65,0.202,22/02/2018 23:00:00,23/02/2018 01:00:00,23/02/2018 01:00:00,EXPIRED,LONG,9951.0,9731.0,10766.67,0.0,0.02,7.58,0.0,164.77,2,0.1,-44.44
13/04/2021 09:00:00,16/06/2023 15:50:23,Gemini_BTCUSD_1h_17_12_17_to_10_03_23.csv,BTC_USD,HOUR,100660.21,0.032,13/04/2021 12:00:00,13/04/2021 12:00:00,13/04/2021 12:00:00,EXPIRED,LONG,62897.0,63063.0,65778.52,0.0,0.02,4.38,0.0,92.21,2,0.0,5.31
27/11/2022 04:00:00,16/06/2023 15:50:23,Gemini_BTCUSD_1h_17_12_17_to_10_03_23.csv,BTC_USD,HOUR,100665.52,0.122,27/11/2022 05:00:00,27/11/2022 07:00:00,27/11/2022 07:00:00,EXPIRED,LONG,16562.0,16563.0,18041.89,0.0,0.02,8.2,0.0,180.55,2,0.1,0.12
24/09/2020 08:00:00,16/06/2023 15:50:23,Gemini_BTCUSD_1h_17_12_17_to_10_03_23.csv,BTC_USD,HOUR,100665.64,0.195,24/09/2020 09:00:00,24/09/2020 11:00:00,24/09/2020 11:00:00,EXPIRED,LONG,10319.0,10412.0,10546.39,0.0,0.02,2.16,0.0,44.34,2,0.0,18.14
29/06/2022 11:00:00,16/06/2023 15:50:23,Gemini_BTCUSD_1h_17_12_17_to_10_03_23.csv,BTC_USD,HOUR,100683.78,0.1,29/06/2022 15:00:00,29/06/2022 14:00:00,29/06/2022 14:00:00,EXPIRED,LONG,20088.0,20103.0,20941.39,0.0,0.02,4.08,0.0,85.34,2,0.0,1.5
17/04/2018 00:00:00,16/06/2023 15:50:23,Gemini_BTCUSD_1h_17_12_17_to_10_03_23.csv,BTC_USD,HOUR,100685.28,0.251,17/04/2018 01:00:00,17/04/2018 03:00:00,17/04/2018 03:00:00,EXPIRED,LONG,8034.0,8026.0,8720.28,0.0,0.02,7.87,0.0,172.26,2,0.1,-2.01
29/06/2020 23:00:00,16/06/2023 15:50:23,Gemini_BTCUSD_1h_17_12_17_to_10_03_23.csv,BTC_USD,HOUR,100683.27,0.219,30/06/2020 01:00:00,30/06/2020 02:00:00,30/06/2020 02:00:00,EXPIRED,LONG,9189.0,9184.0,9412.88,0.0,0.02,2.38,0.0,49.03,2,0.0,-1.09
29/10/2022 05:00:00,16/06/2023 15:50:23,Gemini_BTCUSD_1h_17_12_17_to_10_03_23.csv,BTC_USD,HOUR,100682.18,0.097,29/10/2022 06:00:00,29/10/2022 08:00:00,29/10/2022 08:00:00,EXPIRED,LONG,20663.0,20917.0,22369.02,0.0,0.02,7.63,0.0,165.48,2,0.1,24.64
15/12/2021 03:00:00,16/06/2023 15:50:23,Gemini_BTCUSD_1h_17_12_17_to_10_03_23.csv,BTC_USD,HOUR,100706.82,0.042,15/12/2021 04:00:00,15/12/2021 06:00:00,15/12/2021 06:00:00,EXPIRED,LONG,48281.0,48085.0,49529.38,0.0,0.02,2.52,0.0,52.43,2,0.0,-8.23
31/05/2021 12:00:00,16/06/2023 15:50:23,Gemini_BTCUSD_1h_17_12_17_to_10_03_23.csv,BTC_USD,HOUR,100698.59,0.055,31/05/2021 14:00:00,31/05/2021 15:00:00,31/05/2021 15:00:00,EXPIRED,LONG,36800.0,37005.0,38263.85,0.0,0.02,3.83,0.0,80.51,2,0.0,11.28
20/11/2022 21:00:00,16/06/2023 15:50:23,Gemini_BTCUSD_1h_17_12_17_to_10_03_23.csv,BTC_USD,HOUR,100709.87,0.124,20/11/2022 22:00:00,21/11/2022 00:00:00,21/11/2022 00:00:00,EXPIRED,LONG,16247.0,16225.0,16837.94,0.0,0.02,3.51,0.0,73.28,2,0.0,-2.73
09/02/2019 15:00:00,16/06/2023 15:50:23,Gemini_BTCUSD_1h_17_12_17_to_10_03_23.csv,BTC_USD,HOUR,100707.14,0.559,09/02/2019 17:00:00,09/02/2019 18:00:00,09/02/2019 18:00:00,EXPIRED,LONG,3606.0,3606.0,3687.38,0.0,0.02,2.21,0.0,45.49,2,0.0,0.0
08/12/2020 08:00:00,16/06/2023 15:50:23,Gemini_BTCUSD_1h_17_12_17_to_10_03_23.csv,BTC_USD,HOUR,100707.14,0.106,08/12/2020 09:00:00,08/12/2020 11:00:00,08/12/2020 11:00:00,EXPIRED,LONG,19069.0,18785.0,19904.73,0.0,0.02,4.2,0.0,88.59,2,0.0,-30.1
30/09/2021 16:00:00,16/06/2023 15:50:23,Gemini_BTCUSD_1h_17_12_17_to_10_03_23.csv,BTC_USD,HOUR,100677.04,0.047,30/09/2021 17:00:00,30/09/2021 19:00:00,30/09/2021 19:00:00,EXPIRED,LONG,42929.0,43552.0,44771.67,0.0,0.02,4.12,0.0,86.61,2,0.0,29.28
10/10/2021 04:00:00,16/06/2023 15:50:23,Gemini_BTCUSD_1h_17_12_17_to_10_03_23.csv,BTC_USD,HOUR,100706.32,0.036,10/10/2021 05:00:00,10/10/2021 07:00:00,10/10/2021 07:00:00,EXPIRED,LONG,55882.0,55683.0,59550.05,0.0,0.02,6.16,0.0,132.05,2,0.1,-7.16
25/05/2018 13:00:00,16/06/2023 15:50:23,Gemini_BTCUSD_1h_17_12_17_to_10_03_23.csv,BTC_USD,HOUR,100699.16,0.269,25/05/2018 16:00:00,25/05/2018 16:00:00,25/05/2018 16:00:00,EXPIRED,LONG,7488.0,7465.0,7671.38,0.0,0.02,2.39,0.0,49.33,2,0.0,-6.19
16/12/2022 04:00:00,16/06/2023 15:50:23,Gemini_BTCUSD_1h_17_12_17_to_10_03_23.csv,BTC_USD,HOUR,100692.97,0.115,16/12/2022 05:00:00,16/12/2022 07:00:00,16/12/2022 07:00:00,EXPIRED,LONG,17470.0,17470.0,17888.97,0.0,0.02,2.34,0.0,48.18,2,0.0,0.0
14/10/2022 04:00:00,16/06/2023 15:50:23,Gemini_BTCUSD_1h_17_12_17_to_10_03_23.csv,BTC_USD,HOUR,100692.97,0.102,14/10/2022 05:00:00,14/10/2022 07:00:00,14/10/2022 07:00:00,EXPIRED,LONG,19806.0,19640.0,20788.25,0.0,0.02,4.73,0.0,100.19,2,0.0,-16.93
07/10/2019 04:00:00,16/06/2023 15:50:23,Gemini_BTCUSD_1h_17_12_17_to_10_03_23.csv,BTC_USD,HOUR,100676.04,0.257,07/10/2019 08:00:00,07/10/2019 07:00:00,07/10/2019 07:00:00,EXPIRED,LONG,7844.0,7860.0,8383.71,0.0,0.02,6.44,0.0,138.71,2,0.1,4.11
29/08/2020 18:00:00,16/06/2023 15:50:23,Gemini_BTCUSD_1h_17_12_17_to_10_03_23.csv,BTC_USD,HOUR,100680.15,0.175,29/08/2020 19:00:00,29/08/2020 21:00:00,29/08/2020 21:00:00,EXPIRED,LONG,11533.0,11517.0,12229.8,0.0,0.02,5.7,0.0,121.94,2,0.1,-2.8
13/07/2018 01:00:00,16/06/2023 15:50:23,Gemini_BTCUSD_1h_17_12_17_to_10_03_23.csv,BTC_USD,HOUR,100677.35,0.323,13/07/2018 02:00:00,13/07/2018 04:00:00,13/07/2018 04:00:00,EXPIRED,LONG,6237.0,6243.0,6378.2,0.0,0.02,2.21,0.0,45.61,2,0.0,1.94
07/12/2018 13:00:00,16/06/2023 15:50:23,Gemini_BTCUSD_1h_17_12_17_to_10_03_23.csv,BTC_USD,HOUR,100679.29,0.595,07/12/2018 14:00:00,07/12/2018 16:00:00,07/12/2018 16:00:00,EXPIRED,LONG,3385.0,3258.0,3705.28,0.0,0.02,8.64,0.0,190.57,2,0.1,-75.56
06/04/2019 06:00:00,16/06/2023 15:50:23,Gemini_BTCUSD_1h_17_12_17_to_10_03_23.csv,BTC_USD,HOUR,100603.73,0.401,06/04/2019 09:00:00,06/04/2019 09:00:00,06/04/2019 09:00:00,EXPIRED,LONG,5020.0,4985.0,5325.89,0.0,0.02,5.74,0.0,122.66,2,0.1,-14.03
08/09/2018 07:00:00,16/06/2023 15:50:23,Gemini_BTCUSD_1h_17_12_17_to_10_03_23.csv,BTC_USD,HOUR,100589.7,0.312,08/09/2018 08:00:00,08/09/2018 10:00:00,08/09/2018 10:00:00,EXPIRED,LONG,6446.0,6452.0,6599.42,0.0,0.02,2.32,0.0,47.87,2,0.0,1.87
10/11/2020 15:00:00,16/06/2023 15:50:23,Gemini_BTCUSD_1h_17_12_17_to_10_03_23.csv,BTC_USD,HOUR,100591.57,0.132,10/11/2020 16:00:00,10/11/2020 18:00:00,10/11/2020 18:00:00,EXPIRED,LONG,15195.0,15289.0,16104.02,0.0,0.02,5.64,0.0,119.99,2,0.1,12.41
31/07/2022 11:00:00,16/06/2023 15:50:23,Gemini_BTCUSD_1h_17_12_17_to_10_03_23.csv,BTC_USD,HOUR,100603.98,0.085,31/07/2022 12:00:00,31/07/2022 14:00:00,31/07/2022 14:00:00,EXPIRED,LONG,23807.0,23729.0,24711.6,0.0,0.02,3.66,0.0,76.89,2,0.0,-6.63
06/01/2018 16:00:00,16/06/2023 15:50:23,Gemini_BTCUSD_1h_17_12_17_to_10_03_23.csv,BTC_USD,HOUR,100597.35,0.12,06/01/2018 17:00:00,06/01/2018 19:00:00,06/01/2018 19:00:00,EXPIRED,LONG,16804.0,16718.0,17657.8,0.0,0.02,4.84,0.0,102.46,2,0.1,-10.32
12/01/2022 21:00:00,16/06/2023 15:50:23,Gemini_BTCUSD_1h_17_12_17_to_10_03_23.csv,BTC_USD,HOUR,100587.03,0.046,12/01/2022 22:00:00,13/01/2022 00:00:00,13/01/2022 00:00:00,EXPIRED,LONG,43792.0,43749.0,44719.72,0.0,0.02,2.07,0.0,42.68,2,0.0,-1.98
29/08/2021 20:00:00,16/06/2023 15:50:23,Gemini_BTCUSD_1h_17_12_17_to_10_03_23.csv,BTC_USD,HOUR,100585.05,0.041,30/08/2021 00:00:00,29/08/2021 23:00:00,29/08/2021 23:00:00,EXPIRED,LONG,48919.0,48801.0,50430.66,0.0,0.02,3.0,0.0,61.98,2,0.0,-4.84
28/09/2021 22:00:00,16/06/2023 15:50:23,Gemini_BTCUSD_1h_17_12_17_to_10_03_23.csv,BTC_USD,HOUR,100580.21,0.048,28/09/2021 23:00:00,29/09/2021 01:00:00,29/09/2021 01:00:00,EXPIRED,LONG,41589.0,41566.0,45085.95,0.0,0.02,7.76,0.0,167.85,2,0.1,-1.1
26/07/2022 22:00:00,16/06/2023 15:50:23,Gemini_BTCUSD_1h_17_12_17_to_10_03_23.csv,BTC_USD,HOUR,100579.11,0.095,26/07/2022 23:00:00,27/07/2022 01:00:00,27/07/2022 01:00:00,EXPIRED,LONG,21123.0,21154.0,21602.3,0.0,0.02,2.22,0.0,45.53,2,0.0,2.95
27/07/2021 11:00:00,16/06/2023 15:50:23,Gemini_BTCUSD_1h_17_12_17_to_10_03_23.csv,BTC_USD,HOUR,100582.06,0.053,27/07/2021 12:00:00,27/07/2021 14:00:00,27/07/2021 14:00:00,EXPIRED,LONG,38087.0,38280.0,40811.71,0.0,0.02,6.68,0.0,144.41,2,0.1,10.23
14/09/2020 03:00:00,16/06/2023 15:50:23,Gemini_BTCUSD_1h_17_12_17_to_10_03_23.csv,BTC_USD,HOUR,100592.29,0.194,14/09/2020 04:00:00,14/09/2020 06:00:00,14/09/2020 06:00:00,EXPIRED,LONG,10364.0,10363.0,10759.17,0.0,0.02,3.67,0.0,76.66,2,0.0,-0.19
06/04/2019 15:00:00,16/06/2023 15:50:23,Gemini_BTCUSD_1h_17_12_17_to_10_03_23.csv,BTC_USD,HOUR,100592.1,0.393,06/04/2019 16:00:00,06/04/2019 18:00:00,06/04/2019 18:00:00,EXPIRED,LONG,5120.0,5164.0,5596.7,0.0,0.02,8.52,0.0,187.34,2,0.1,17.29
30/04/2019 14:00:00,16/06/2023 15:50:23,Gemini_BTCUSD_1h_17_12_17_to_10_03_23.csv,BTC_USD,HOUR,100609.39,0.383,30/04/2019 15:00:00,30/04/2019 17:00:00,30/04/2019 17:00:00,EXPIRED,LONG,5259.0,5230.0,5677.05,0.0,0.02,7.36,0.0,160.11,2,0.1,-11.11
12/01/2020 16:00:00,16/06/2023 15:50:23,Gemini_BTCUSD_1h_17_12_17_to_10_03_23.csv,BTC_USD,HOUR,100598.28,0.248,12/01/2020 17:00:00,12/01/2020 19:00:00,12/01/2020 19:00:00,EXPIRED,LONG,8100.0,8123.0,8667.42,0.0,0.02,6.55,0.0,140.72,2,0.1,5.7
15/03/2018 02:00:00,16/06/2023 15:50:23,Gemini_BTCUSD_1h_17_12_17_to_10_03_23.csv,BTC_USD,HOUR,100603.98,0.258,15/03/2018 03:00:00,15/03/2018 05:00:00,15/03/2018 03:00:00,TAKE_PROFIT_HIT,LONG,7793.0,7972.83,7972.83,0.0,0.02,2.26,0.0,46.4,2,0.0,46.4
21/09/2022 11:00:00,16/06/2023 15:50:23,Gemini_BTCUSD_1h_17_12_17_to_10_03_23.csv,BTC_USD,HOUR,100650.38,0.105,21/09/2022 12:00:00,21/09/2022 14:00:00,21/09/2022 14:00:00,EXPIRED,LONG,19166.0,19252.0,20899.74,0.0,0.02,8.3,0.0,182.04,2,0.1,9.03
19/07/2019 02:00:00,16/06/2023 15:50:23,Gemini_BTCUSD_1h_17_12_17_to_10_03_23.csv,BTC_USD,HOUR,100659.41,0.189,19/07/2019 03:00:00,19/07/2019 05:00:00,19/07/2019 05:00:00,EXPIRED,LONG,10634.0,10537.0,11504.24,0.0,0.02,7.56,0.0,164.48,2,0.1,-18.33
27/11/2019 21:00:00,16/06/2023 15:50:23,Gemini_BTCUSD_1h_17_12_17_to_10_03_23.csv,BTC_USD,HOUR,100641.08,0.267,27/11/2019 23:00:00,28/11/2019 00:00:00,28/11/2019 00:00:00,EXPIRED,LONG,7549.0,7571.0,7722.1,0.0,0.02,2.24,0.0,46.22,2,0.0,5.87
01/04/2019 04:00:00,16/06/2023 15:50:23,Gemini_BTCUSD_1h_17_12_17_to_10_03_23.csv,BTC_USD,HOUR,100646.95,0.488,01/04/2019 05:00:00,01/04/2019 07:00:00,01/04/2019 07:00:00,EXPIRED,LONG,4126.0,4122.0,4217.39,0.0,0.02,2.17,0.0,44.6,2,0.0,-1.95
11/02/2022 11:00:00,16/06/2023 15:50:23,Gemini_BTCUSD_1h_17_12_17_to_10_03_23.csv,BTC_USD,HOUR,100645.0,0.046,11/02/2022 13:00:00,11/02/2022 14:00:00,11/02/2022 14:00:00,EXPIRED,LONG,43398.0,43522.0,46257.84,0.0,0.02,6.18,0.0,131.55,2,0.1,5.7
16/03/2022 04:00:00,16/06/2023 15:50:23,Gemini_BTCUSD_1h_17_12_17_to_10_03_23.csv,BTC_USD,HOUR,100650.7,0.051,16/03/2022 06:00:00,16/03/2022 07:00:00,16/03/2022 07:00:00,EXPIRED,LONG,39135.0,39586.0,40068.51,0.0,0.02,2.33,0.0,47.61,2,0.0,23.0
27/05/2021 08:00:00,16/06/2023 15:50:23,Gemini_BTCUSD_1h_17_12_17_to_10_03_23.csv,BTC_USD,HOUR,100673.7,0.052,27/05/2021 09:00:00,27/05/2021 11:00:00,27/05/2021 11:00:00,TAKE_PROFIT_HIT,LONG,38886.0,39795.93,39795.93,0.0,0.02,2.29,0.0,47.32,2,0.0,47.32
18/11/2020 01:00:00,16/06/2023 15:50:23,Gemini_BTCUSD_1h_17_12_17_to_10_03_23.csv,BTC_USD,HOUR,100721.02,0.113,18/11/2020 05:00:00,18/11/2020 04:00:00,18/11/2020 04:00:00,TAKE_PROFIT_HIT,LONG,17765.0,18160.35,18160.35,0.0,0.02,2.18,0.0,44.67,2,0.0,44.67
27/01/2020 19:00:00,16/06/2023 15:50:23,Gemini_BTCUSD_1h_17_12_17_to_10_03_23.csv,BTC_USD,HOUR,100765.69,0.226,27/01/2020 20:00:00,27/01/2020 22:00:00,27/01/2020 22:00:00,EXPIRED,LONG,8909.0,8888.0,9094.65,0.0,0.02,2.04,0.0,41.96,2,0.0,-4.75
05/07/2022 09:00:00,16/06/2023 15:50:23,Gemini_BTCUSD_1h_17_12_17_to_10_03_23.csv,BTC_USD,HOUR,100760.94,0.102,05/07/2022 10:00:00,05/07/2022 12:00:00,05/07/2022 12:00:00,EXPIRED,LONG,19737.0,19362.0,20190.59,0.0,0.02,2.25,0.0,46.27,2,0.0,-38.25
16/05/2020 01:00:00,16/06/2023 15:50:23,Gemini_BTCUSD_1h_17_12_17_to_10_03_23.csv,BTC_USD,HOUR,100722.69,0.214,16/05/2020 02:00:00,16/05/2020 04:00:00,16/05/2020 04:00:00,EXPIRED,LONG,9408.0,9500.0,9650.05,0.0,0.02,2.51,0.0,51.8,2,0.0,19.69
01/03/2018 12:00:00,16/06/2023 15:50:23,Gemini_BTCUSD_1h_17_12_17_to_10_03_23.csv,BTC_USD,HOUR,100742.38,0.19,01/03/2018 14:00:00,01/03/2018 15:00:00,01/03/2018 15:00:00,EXPIRED,LONG,10629.0,10705.0,10916.95,0.0,0.02,2.64,0.0,54.71,2,0.0,14.44
15/05/2021 14:00:00,16/06/2023 15:50:23,Gemini_BTCUSD_1h_17_12_17_to_10_03_23.csv,BTC_USD,HOUR,100756.82,0.041,15/05/2021 17:00:00,15/05/2021 17:00:00,15/05/2021 17:00:00,EXPIRED,LONG,49452.0,47854.0,50600.48,0.0,0.02,2.27,0.0,47.09,2,0.0,-65.52
26/09/2018 01:00:00,16/06/2023 15:50:23,Gemini_BTCUSD_1h_17_12_17_to_10_03_23.csv,BTC_USD,HOUR,100691.3,0.315,26/09/2018 03:00:00,26/09/2018 04:00:00,26/09/2018 04:00:00,EXPIRED,LONG,6390.0,6390.0,6835.75,0.0,0.02,6.52,0.0,140.41,2,0.1,0.0
19/11/2022 23:00:00,16/06/2023 15:50:23,Gemini_BTCUSD_1h_17_12_17_to_10_03_23.csv,BTC_USD,HOUR,100691.3,0.121,20/11/2022 03:00:00,20/11/2022 02:00:00,20/11/2022 02:00:00,EXPIRED,LONG,16685.0,16658.0,18066.38,0.0,0.02,7.65,0.0,167.15,2,0.1,-3.27
31/12/2020 10:00:00,16/06/2023 15:50:23,Gemini_BTCUSD_1h_17_12_17_to_10_03_23.csv,BTC_USD,HOUR,100688.03,0.069,31/12/2020 12:00:00,31/12/2020 13:00:00,31/12/2020 13:00:00,EXPIRED,LONG,29171.0,28540.0,30980.54,0.0,0.02,5.84,0.0,124.86,2,0.1,-43.54
24/07/2021 08:00:00,16/06/2023 15:50:23,Gemini_BTCUSD_1h_17_12_17_to_10_03_23.csv,BTC_USD,HOUR,100644.49,0.06,24/07/2021 09:00:00,24/07/2021 11:00:00,24/07/2021 11:00:00,EXPIRED,LONG,33636.0,33894.0,35574.81,0.0,0.02,5.45,0.0,116.33,2,0.1,15.48
29/06/2020 22:00:00,16/06/2023 15:50:23,Gemini_BTCUSD_1h_17_12_17_to_10_03_23.csv,BTC_USD,HOUR,100659.97,0.219,30/06/2020 00:00:00,30/06/2020 01:00:00,30/06/2020 01:00:00,EXPIRED,LONG,9186.0,9204.0,9399.68,0.0,0.02,2.27,0.0,46.8,2,0.0,3.94
04/03/2023 03:00:00,16/06/2023 15:50:23,Gemini_BTCUSD_1h_17_12_17_to_10_03_23.csv,BTC_USD,HOUR,100663.91,0.09,04/03/2023 04:00:00,04/03/2023 06:00:00,04/03/2023 06:00:00,EXPIRED,LONG,22349.0,22378.0,23257.6,0.0,0.02,3.91,0.0,81.77,2,0.0,2.61
25/05/2018 06:00:00,16/06/2023 15:50:23,Gemini_BTCUSD_1h_17_12_17_to_10_03_23.csv,BTC_USD,HOUR,100666.52,0.268,25/05/2018 07:00:00,25/05/2018 09:00:00,25/05/2018 09:00:00,EXPIRED,LONG,7515.0,7424.0,7952.01,0.0,0.02,5.5,0.0,117.12,2,0.1,-24.39
12/05/2018 13:00:00,16/06/2023 15:50:23,Gemini_BTCUSD_1h_17_12_17_to_10_03_23.csv,BTC_USD,HOUR,100642.13,0.236,12/05/2018 14:00:00,12/05/2018 16:00:00,12/05/2018 16:00:00,EXPIRED,LONG,8541.0,8328.0,8863.19,0.0,0.02,3.64,0.0,76.04,2,0.0,-50.27
31/10/2019 18:00:00,16/06/2023 15:50:23,Gemini_BTCUSD_1h_17_12_17_to_10_03_23.csv,BTC_USD,HOUR,100591.86,0.218,31/10/2019 19:00:00,31/10/2019 21:00:00,31/10/2019 21:00:00,EXPIRED,LONG,9245.0,9140.0,9465.53,0.0,0.02,2.33,0.0,48.08,2,0.0,-22.89
05/06/2022 15:00:00,16/06/2023 15:50:23,Gemini_BTCUSD_1h_17_12_17_to_10_03_23.csv,BTC_USD,HOUR,100568.97,0.067,05/06/2022 16:00:00,05/06/2022 18:00:00,05/06/2022 18:00:00,EXPIRED,LONG,29943.0,29977.0,30950.4,0.0,0.02,3.25,0.0,67.5,2,0.0,2.28
02/08/2022 19:00:00,16/06/2023 15:50:23,Gemini_BTCUSD_1h_17_12_17_to_10_03_23.csv,BTC_USD,HOUR,100571.25,0.088,02/08/2022 21:00:00,02/08/2022 22:00:00,02/08/2022 22:00:00,EXPIRED,LONG,22950.0,23108.0,23802.99,0.0,0.02,3.58,0.0,75.06,2,0.0,13.9
15/05/2018 14:00:00,16/06/2023 15:50:23,Gemini_BTCUSD_1h_17_12_17_to_10_03_23.csv,BTC_USD,HOUR,100585.15,0.236,15/05/2018 15:00:00,15/05/2018 17:00:00,15/05/2018 17:00:00,EXPIRED,LONG,8518.0,8555.0,8861.98,0.0,0.02,3.88,0.0,81.18,2,0.0,8.73
16/06/2020 23:00:00,16/06/2023 15:50:23,Gemini_BTCUSD_1h_17_12_17_to_10_03_23.csv,BTC_USD,HOUR,100593.88,0.211,17/06/2020 01:00:00,17/06/2020 02:00:00,17/06/2020 02:00:00,EXPIRED,LONG,9526.0,9438.0,9754.84,0.0,0.02,2.35,0.0,48.29,2,0.0,-18.57
27/07/2022 21:00:00,16/06/2023 15:50:23,Gemini_BTCUSD_1h_17_12_17_to_10_03_23.csv,BTC_USD,HOUR,100575.31,0.089,27/07/2022 22:00:00,28/07/2022 00:00:00,28/07/2022 00:00:00,EXPIRED,LONG,22689.0,22793.0,23956.86,0.0,0.02,5.29,0.0,112.84,2,0.1,9.26
17/05/2022 22:00:00,16/06/2023 15:50:23,Gemini_BTCUSD_1h_17_12_17_to_10_03_23.csv,BTC_USD,HOUR,100584.57,0.066,17/05/2022 23:00:00,18/05/2022 01:00:00,18/05/2022 01:00:00,EXPIRED,LONG,30327.0,30081.0,32876.32,0.0,0.02,7.75,0.0,168.26,2,0.1,-16.24
30/08/2022 07:00:00,16/06/2023 15:50:23,Gemini_BTCUSD_1h_17_12_17_to_10_03_23.csv,BTC_USD,HOUR,100568.33,0.098,30/08/2022 08:00:00,30/08/2022 10:00:00,30/08/2022 10:00:00,EXPIRED,LONG,20437.0,20409.0,22048.93,0.0,0.02,7.31,0.0,157.97,2,0.1,-2.74
18/11/2020 02:00:00,16/06/2023 15:50:23,Gemini_BTCUSD_1h_17_12_17_to_10_03_23.csv,BTC_USD,HOUR,100565.59,0.114,18/11/2020 03:00:00,18/11/2020 05:00:00,18/11/2020 05:00:00,EXPIRED,LONG,17714.0,17651.0,19245.33,0.0,0.02,7.96,0.0,174.57,2,0.1,-7.18
27/11/2021 11:00:00,16/06/2023 15:50:23,Gemini_BTCUSD_1h_17_12_17_to_10_03_23.csv,BTC_USD,HOUR,100558.41,0.037,27/11/2021 12:00:00,27/11/2021 14:00:00,27/11/2021 14:00:00,EXPIRED,LONG,54645.0,54757.0,58489.62,0.0,0.02,6.57,0.0,142.25,2,0.1,4.14
07/01/2020 00:00:00,16/06/2023 15:50:23,Gemini_BTCUSD_1h_17_12_17_to_10_03_23.csv,BTC_USD,HOUR,100562.55,0.255,07/01/2020 01:00:00,07/01/2020 03:00:00,07/01/2020 03:00:00,EXPIRED,LONG,7887.0,7899.0,8347.96,0.0,0.02,5.52,0.0,117.54,2,0.1,3.06
10/10/2021 06:00:00,16/06/2023 15:50:23,Gemini_BTCUSD_1h_17_12_17_to_10_03_23.csv,BTC_USD,HOUR,100565.61,0.036,10/10/2021 07:00:00,10/10/2021 09:00:00,10/10/2021 09:00:00,EXPIRED,LONG,55619.0,54984.0,59543.97,0.0,0.02,6.59,0.0,141.3,2,0.1,-22.86
04/09/2022 21:00:00,16/06/2023 15:50:23,Gemini_BTCUSD_1h_17_12_17_to_10_03_23.csv,BTC_USD,HOUR,100542.75,0.101,04/09/2022 22:00:00,05/09/2022 00:00:00,05/09/2022 00:00:00,EXPIRED,LONG,19874.0,19922.0,20966.21,0.0,0.02,5.21,0.0,110.31,2,0.1,4.85
12/08/2018 12:00:00,16/06/2023 15:50:23,Gemini_BTCUSD_1h_17_12_17_to_10_03_23.csv,BTC_USD,HOUR,100547.6,0.321,12/08/2018 13:00:00,12/08/2018 15:00:00,12/08/2018 15:00:00,EXPIRED,LONG,6261.0,6323.0,6774.91,0.0,0.02,7.59,0.0,164.97,2,0.1,19.9
30/06/2020 15:00:00,16/06/2023 15:50:23,Gemini_BTCUSD_1h_17_12_17_to_10_03_23.csv,BTC_USD,HOUR,100567.5,0.219,30/06/2020 16:00:00,30/06/2020 18:00:00,30/06/2020 18:00:00,EXPIRED,LONG,9168.0,9130.0,9914.1,0.0,0.02,7.53,0.0,163.4,2,0.1,-8.32
21/07/2020 02:00:00,16/06/2023 15:50:23,Gemini_BTCUSD_1h_17_12_17_to_10_03_23.csv,BTC_USD,HOUR,100559.18,0.219,21/07/2020 05:00:00,21/07/2020 05:00:00,21/07/2020 05:00:00,EXPIRED,LONG,9182.0,9193.0,9447.41,0.0,0.02,2.81,0.0,58.12,2,0.0,2.41
31/05/2018 08:00:00,16/06/2023 15:50:23,Gemini_BTCUSD_1h_17_12_17_to_10_03_23.csv,BTC_USD,HOUR,100561.59,0.267,31/05/2018 09:00:00,31/05/2018 11:00:00,31/05/2018 11:00:00,EXPIRED,LONG,7542.0,7537.0,7999.51,0.0,0.02,5.72,0.0,122.16,2,0.1,-1.33
29/06/2022 20:00:00,16/06/2023 15:50:23,Gemini_BTCUSD_1h_17_12_17_to_10_03_23.csv,BTC_USD,HOUR,100560.26,0.1,29/06/2022 21:00:00,29/06/2022 23:00:00,29/06/2022 23:00:00,EXPIRED,LONG,20196.0,20092.0,21476.8,0.0,0.02,5.96,0.0,128.08,2,0.1,-10.4
13/11/2019 18:00:00,16/06/2023 15:50:23,Gemini_BTCUSD_1h_17_12_17_to_10_03_23.csv,BTC_USD,HOUR,100549.86,0.23,13/11/2019 22:00:00,13/11/2019 21:00:00,13/11/2019 21:00:00,EXPIRED,LONG,8742.0,8754.0,8939.73,0.0,0.02,2.21,0.0,45.48,2,0.0,2.76
05/10/2021 08:00:00,16/06/2023 15:50:23,Gemini_BTCUSD_1h_17_12_17_to_10_03_23.csv,BTC_USD,HOUR,100552.62,0.04,05/10/2021 12:00:00,05/10/2021 11:00:00,05/10/2021 11:00:00,EXPIRED,LONG,49933.0,49913.0,53517.87,0.0,0.02,6.7,0.0,143.39,2,0.1,-0.8
19/04/2022 01:00:00,16/06/2023 15:50:23,Gemini_BTCUSD_1h_17_12_17_to_10_03_23.csv,BTC_USD,HOUR,100551.82,0.049,19/04/2022 02:00:00,19/04/2022 04:00:00,19/04/2022 04:00:00,EXPIRED,LONG,40762.0,40856.0,41653.75,0.0,0.02,2.14,0.0,43.7,2,0.0,4.61
14/04/2018 05:00:00,16/06/2023 15:50:23,Gemini_BTCUSD_1h_17_12_17_to_10_03_23.csv,BTC_USD,HOUR,100556.43,0.253,14/04/2018 09:00:00,14/04/2018 08:00:00,14/04/2018 08:00:00,EXPIRED,LONG,7959.0,8118.0,8242.47,0.0,0.02,3.44,0.0,71.72,2,0.0,40.23
31/12/2017 15:00:00,16/06/2023 15:50:23,Gemini_BTCUSD_1h_17_12_17_to_10_03_23.csv,BTC_USD,HOUR,100596.66,0.151,31/12/2017 16:00:00,31/12/2017 18:00:00,31/12/2017 16:00:00,TAKE_PROFIT_HIT,LONG,13290.0,14087.12,14087.12,0.0,0.02,5.66,0.0,120.37,2,0.1,120.37
26/10/2022 18:00:00,16/06/2023 15:50:23,Gemini_BTCUSD_1h_17_12_17_to_10_03_23.csv,BTC_USD,HOUR,100717.03,0.097,26/10/2022 19:00:00,26/10/2022 21:00:00,26/10/2022 21:00:00,EXPIRED,LONG,20703.0,20738.0,21712.75,0.0,0.02,4.65,0.0,97.95,2,0.0,3.4
18/12/2022 07:00:00,16/06/2023 15:50:23,Gemini_BTCUSD_1h_17_12_17_to_10_03_23.csv,BTC_USD,HOUR,100720.43,0.12,18/12/2022 08:00:00,18/12/2022 10:00:00,18/12/2022 10:00:00,EXPIRED,LONG,16756.0,16719.0,17161.64,0.0,0.02,2.36,0.0,48.68,2,0.0,-4.44
19/05/2019 22:00:00,16/06/2023 15:50:23,Gemini_BTCUSD_1h_17_12_17_to_10_03_23.csv,BTC_USD,HOUR,100715.99,0.245,19/05/2019 23:00:00,20/05/2019 01:00:00,20/05/2019 01:00:00,EXPIRED,LONG,8220.0,7978.0,8783.92,0.0,0.02,6.42,0.0,138.16,2,0.1,-59.29
29/04/2020 03:00:00,16/06/2023 15:50:23,Gemini_BTCUSD_1h_17_12_17_to_10_03_23.csv,BTC_USD,HOUR,100656.7,0.257,29/04/2020 07:00:00,29/04/2020 06:00:00,29/04/2020 06:00:00,EXPIRED,LONG,7828.0,7961.0,8477.73,0.0,0.02,7.66,0.0,166.98,2,0.1,34.18
19/03/2020 12:00:00,16/06/2023 15:50:23,Gemini_BTCUSD_1h_17_12_17_to_10_03_23.csv,BTC_USD,HOUR,100690.88,0.342,19/03/2020 13:00:00,19/03/2020 15:00:00,19/03/2020 15:00:00,EXPIRED,LONG,5884.0,5931.0,6048.24,0.0,0.02,2.72,0.0,56.17,2,0.0,16.07
23/12/2019 02:00:00,16/06/2023 15:50:23,Gemini_BTCUSD_1h_17_12_17_to_10_03_23.csv,BTC_USD,HOUR,100706.95,0.266,23/12/2019 03:00:00,23/12/2019 05:00:00,23/12/2019 05:00:00,EXPIRED,LONG,7568.0,7554.0,7995.52,0.0,0.02,5.35,0.0,113.72,2,0.1,-3.72
22/05/2020 13:00:00,16/06/2023 15:50:23,Gemini_BTCUSD_1h_17_12_17_to_10_03_23.csv,BTC_USD,HOUR,100703.23,0.221,22/05/2020 14:00:00,22/05/2020 16:00:00,22/05/2020 16:00:00,EXPIRED,LONG,9106.0,9245.0,9487.0,0.0,0.02,4.02,0.0,84.2,2,0.0,30.72
29/10/2021 06:00:00,16/06/2023 15:50:23,Gemini_BTCUSD_1h_17_12_17_to_10_03_23.csv,BTC_USD,HOUR,100733.95,0.033,29/10/2021 10:00:00,29/10/2021 09:00:00,29/10/2021 09:00:00,EXPIRED,LONG,61411.0,60864.0,63988.03,0.0,0.02,4.03,0.0,85.04,2,0.0,-18.05
29/01/2022 00:00:00,16/06/2023 15:50:23,Gemini_BTCUSD_1h_17_12_17_to_10_03_23.csv,BTC_USD,HOUR,100715.9,0.053,29/01/2022 01:00:00,29/01/2022 03:00:00,29/01/2022 03:00:00,EXPIRED,LONG,37818.0,37765.0,38853.66,0.0,0.02,2.67,0.0,54.89,2,0.0,-2.81
25/01/2023 17:00:00,16/06/2023 15:50:23,Gemini_BTCUSD_1h_17_12_17_to_10_03_23.csv,BTC_USD,HOUR,100713.09,0.089,25/01/2023 21:00:00,25/01/2023 20:00:00,25/01/2023 20:00:00,EXPIRED,LONG,22571.0,22941.0,23428.54,0.0,0.02,3.66,0.0,76.32,2,0.0,32.93
03/05/2021 06:00:00,16/06/2023 15:50:23,Gemini_BTCUSD_1h_17_12_17_to_10_03_23.csv,BTC_USD,HOUR,100746.02,0.035,03/05/2021 08:00:00,03/05/2021 09:00:00,03/05/2021 09:00:00,EXPIRED,LONG,57983.0,58451.0,60345.6,0.0,0.02,3.92,0.0,82.69,2,0.0,16.38
25/11/2022 15:00:00,16/06/2023 15:50:23,Gemini_BTCUSD_1h_17_12_17_to_10_03_23.csv,BTC_USD,HOUR,100762.4,0.122,25/11/2022 16:00:00,25/11/2022 18:00:00,25/11/2022 18:00:00,EXPIRED,LONG,16490.0,16486.0,17382.47,0.0,0.02,5.13,0.0,108.88,2,0.1,-0.49
08/05/2022 10:00:00,16/06/2023 15:50:23,Gemini_BTCUSD_1h_17_12_17_to_10_03_23.csv,BTC_USD,HOUR,100761.91,0.058,08/05/2022 11:00:00,08/05/2022 13:00:00,08/05/2022 13:00:00,EXPIRED,LONG,34714.0,34366.0,35607.13,0.0,0.02,2.51,0.0,51.8,2,0.0,-20.18
24/05/2021 08:00:00,16/06/2023 15:50:23,Gemini_BTCUSD_1h_17_12_17_to_10_03_23.csv,BTC_USD,HOUR,100741.73,0.055,24/05/2021 09:00:00,24/05/2021 11:00:00,24/05/2021 11:00:00,EXPIRED,LONG,36672.0,37657.0,39095.27,0.0,0.02,6.2,0.0,133.28,2,0.1,54.18
07/02/2022 05:00:00,16/06/2023 15:50:23,Gemini_BTCUSD_1h_17_12_17_to_10_03_23.csv,BTC_USD,HOUR,100795.91,0.047,07/02/2022 07:00:00,07/02/2022 08:00:00,07/02/2022 08:00:00,EXPIRED,LONG,42820.0,42639.0,46568.89,0.0,0.02,8.05,0.0,176.2,2,0.1,-8.51
18/08/2021 14:00:00,16/06/2023 15:50:23,Gemini_BTCUSD_1h_17_12_17_to_10_03_23.csv,BTC_USD,HOUR,100787.4,0.044,18/08/2021 18:00:00,18/08/2021 17:00:00,18/08/2021 17:00:00,EXPIRED,LONG,45434.0,45840.0,48792.38,0.0,0.02,6.88,0.0,147.77,2,0.1,17.86
04/03/2022 09:00:00,16/06/2023 15:50:23,Gemini_BTCUSD_1h_17_12_17_to_10_03_23.csv,BTC_USD,HOUR,100805.26,0.049,04/03/2022 10:00:00,04/03/2022 12:00:00,04/03/2022 12:00:00,EXPIRED,LONG,41538.0,41532.0,43633.37,0.0,0.02,4.8,0.0,102.67,2,0.1,-0.29
04/10/2022 19:00:00,16/06/2023 15:50:23,Gemini_BTCUSD_1h_17_12_17_to_10_03_23.csv,BTC_USD,HOUR,100804.97,0.1,04/10/2022 23:00:00,04/10/2022 22:00:00,04/10/2022 22:00:00,EXPIRED,LONG,20222.0,20308.0,21535.96,0.0,0.02,6.1,0.0,131.4,2,0.1,8.6
13/10/2018 11:00:00,16/06/2023 15:50:23,Gemini_BTCUSD_1h_17_12_17_to_10_03_23.csv,BTC_USD,HOUR,100813.57,0.325,13/10/2018 14:00:00,13/10/2018 14:00:00,13/10/2018 14:00:00,EXPIRED,LONG,6205.0,6204.0,6339.8,0.0,0.02,2.13,0.0,43.81,2,0.0,-0.32
02/01/2021 09:00:00,16/06/2023 15:50:23,Gemini_BTCUSD_1h_17_12_17_to_10_03_23.csv,BTC_USD,HOUR,100813.25,0.068,02/01/2021 13:00:00,02/01/2021 12:00:00,02/01/2021 12:00:00,TAKE_PROFIT_HIT,LONG,29645.0,30394.11,30394.11,0.0,0.02,2.46,0.0,50.94,2,0.0,50.94
27/07/2020 12:00:00,16/06/2023 15:50:23,Gemini_BTCUSD_1h_17_12_17_to_10_03_23.csv,BTC_USD,HOUR,100864.19,0.196,27/07/2020 14:00:00,27/07/2020 15:00:00,27/07/2020 15:00:00,EXPIRED,LONG,10290.0,10317.0,10835.11,0.0,0.02,5.03,0.0,106.84,2,0.1,5.29
24/01/2018 04:00:00,16/06/2023 15:50:23,Gemini_BTCUSD_1h_17_12_17_to_10_03_23.csv,BTC_USD,HOUR,100869.48,0.189,24/01/2018 07:00:00,24/01/2018 07:00:00,24/01/2018 07:00:00,EXPIRED,LONG,10655.0,10938.0,11351.5,0.0,0.02,6.14,0.0,131.64,2,0.1,53.49
21/07/2018 16:00:00,16/06/2023 15:50:23,Gemini_BTCUSD_1h_17_12_17_to_10_03_23.csv,BTC_USD,HOUR,100922.97,0.273,21/07/2018 17:00:00,21/07/2018 19:00:00,21/07/2018 19:00:00,EXPIRED,LONG,7405.0,7432.0,8064.85,0.0,0.02,8.18,0.0,180.14,2,0.1,7.37
19/07/2022 19:00:00,16/06/2023 15:50:23,Gemini_BTCUSD_1h_17_12_17_to_10_03_23.csv,BTC_USD,HOUR,100930.34,0.086,19/07/2022 23:00:00,19/07/2022 22:00:00,19/07/2022 22:00:00,EXPIRED,LONG,23409.0,23517.0,24705.52,0.0,0.02,5.25,0.0,111.5,2,0.1,9.29
13/03/2018 23:00:00,16/06/2023 15:50:23,Gemini_BTCUSD_1h_17_12_17_to_10_03_23.csv,BTC_USD,HOUR,100939.63,0.221,14/03/2018 03:00:00,14/03/2018 02:00:00,14/03/2018 02:00:00,EXPIRED,LONG,9147.0,9230.0,9913.37,0.0,0.02,7.73,0.0,169.37,2,0.1,18.34
16/11/2019 15:00:00,16/06/2023 15:50:23,Gemini_BTCUSD_1h_17_12_17_to_10_03_23.csv,BTC_USD,HOUR,100957.97,0.238,16/11/2019 17:00:00,16/11/2019 18:00:00,16/11/2019 18:00:00,EXPIRED,LONG,8487.0,8475.0,8814.36,0.0,0.02,3.71,0.0,77.91,2,0.0,-2.86
15/12/2020 13:00:00,16/06/2023 15:50:23,Gemini_BTCUSD_1h_17_12_17_to_10_03_23.csv,BTC_USD,HOUR,100955.11,0.104,15/12/2020 14:00:00,15/12/2020 16:00:00,15/12/2020 16:00:00,EXPIRED,LONG,19352.0,19376.0,20838.49,0.0,0.02,7.13,0.0,154.59,2,0.1,2.5
31/10/2019 16:00:00,16/06/2023 15:50:23,Gemini_BTCUSD_1h_17_12_17_to_10_03_23.csv,BTC_USD,HOUR,100957.61,0.218,31/10/2019 17:00:00,31/10/2019 19:00:00,31/10/2019 19:00:00,EXPIRED,LONG,9263.0,9244.0,9511.63,0.0,0.02,2.61,0.0,54.2,2,0.0,-4.14
09/09/2022 22:00:00,16/06/2023 15:50:23,Gemini_BTCUSD_1h_17_12_17_to_10_03_23.csv,BTC_USD,HOUR,100953.47,0.095,09/09/2022 23:00:00,10/09/2022 01:00:00,10/09/2022 01:00:00,EXPIRED,LONG,21361.0,21287.0,22288.07,0.0,0.02,4.16,0.0,88.07,2,0.0,-7.03
27/04/2022 17:00:00,16/06/2023 15:50:24,Gemini_BTCUSD_1h_17_12_17_to_10_03_23.csv,BTC_USD,HOUR,100946.44,0.052,27/04/2022 18:00:00,27/04/2022 20:00:00,27/04/2022 20:00:00,EXPIRED,LONG,39115.0,39106.0,41241.49,0.0,0.02,5.16,0.0,110.58,2,0.1,-0.47
28/08/2021 07:00:00,16/06/2023 15:50:24,Gemini_BTCUSD_1h_17_12_17_to_10_03_23.csv,BTC_USD,HOUR,100945.97,0.041,28/08/2021 11:00:00,28/08/2021 10:00:00,28/08/2021 10:00:00,EXPIRED,LONG,48972.0,48872.0,50773.1,0.0,0.02,3.55,0.0,73.85,2,0.0,-4.1
19/09/2021 21:00:00,16/06/2023 15:50:24,Gemini_BTCUSD_1h_17_12_17_to_10_03_23.csv,BTC_USD,HOUR,100941.87,0.043,19/09/2021 23:00:00,20/09/2021 00:00:00,20/09/2021 00:00:00,EXPIRED,LONG,47463.0,46991.0,50945.82,0.0,0.02,6.84,0.0,149.76,2,0.1,-20.3
10/06/2022 07:00:00,16/06/2023 15:50:24,Gemini_BTCUSD_1h_17_12_17_to_10_03_23.csv,BTC_USD,HOUR,100921.57,0.067,10/06/2022 08:00:00,10/06/2022 10:00:00,10/06/2022 10:00:00,EXPIRED,LONG,30028.0,29961.0,31331.97,0.0,0.02,4.16,0.0,87.37,2,0.0,-4.49
11/09/2021 03:00:00,16/06/2023 15:50:24,Gemini_BTCUSD_1h_17_12_17_to_10_03_23.csv,BTC_USD,HOUR,100917.08,0.045,11/09/2021 04:00:00,11/09/2021 06:00:00,11/09/2021 06:00:00,EXPIRED,LONG,45182.0,45282.0,47081.78,0.0,0.02,4.04,0.0,85.49,2,0.0,4.5
11/10/2018 15:00:00,16/06/2023 15:50:24,Gemini_BTCUSD_1h_17_12_17_to_10_03_23.csv,BTC_USD,HOUR,100921.58,0.326,11/10/2018 16:00:00,11/10/2018 18:00:00,11/10/2018 18:00:00,EXPIRED,LONG,6197.0,6195.0,6435.87,0.0,0.02,3.71,0.0,77.87,2,0.0,-0.65
12/09/2021 10:00:00,16/06/2023 15:50:24,Gemini_BTCUSD_1h_17_12_17_to_10_03_23.csv,BTC_USD,HOUR,100920.93,0.044,12/09/2021 12:00:00,12/09/2021 13:00:00,12/09/2021 13:00:00,EXPIRED,LONG,45975.0,45949.0,47039.03,0.0,0.02,2.26,0.0,46.82,2,0.0,-1.14
31/12/2017 19:00:00,16/06/2023 15:50:24,Gemini_BTCUSD_1h_17_12_17_to_10_03_23.csv,BTC_USD,HOUR,100919.79,0.145,31/12/2017 20:00:00,31/12/2017 22:00:00,31/12/2017 22:00:00,EXPIRED,LONG,13890.0,13906.0,14828.24,0.0,0.02,6.33,0.0,136.04,2,0.1,2.32
23/06/2019 16:00:00,16/06/2023 15:50:24,Gemini_BTCUSD_1h_17_12_17_to_10_03_23.csv,BTC_USD,HOUR,100922.11,0.189,23/06/2019 17:00:00,23/06/2019 19:00:00,23/06/2019 19:00:00,EXPIRED,LONG,10670.0,10894.0,11439.29,0.0,0.02,6.72,0.0,145.4,2,0.1,42.34
11/02/2020 09:00:00,16/06/2023 15:50:24,Gemini_BTCUSD_1h_17_12_17_to_10_03_23.csv,BTC_USD,HOUR,100964.45,0.207,11/02/2020 10:00:00,11/02/2020 12:00:00,11/02/2020 12:00:00,EXPIRED,LONG,9775.0,9862.0,10435.43,0.0,0.02,6.33,0.0,136.71,2,0.1,18.01
20/10/2018 00:00:00,16/06/2023 15:50:24,Gemini_BTCUSD_1h_17_12_17_to_10_03_23.csv,BTC_USD,HOUR,100982.46,0.316,20/10/2018 01:00:00,20/10/2018 03:00:00,20/10/2018 03:00:00,EXPIRED,LONG,6386.0,6382.0,6556.74,0.0,0.02,2.6,0.0,53.95,2,0.0,-1.26
16/09/2020 14:00:00,16/06/2023 15:50:24,Gemini_BTCUSD_1h_17_12_17_to_10_03_23.csv,BTC_USD,HOUR,100981.2,0.185,16/09/2020 16:00:00,16/09/2020 17:00:00,16/09/2020 17:00:00,EXPIRED,LONG,10896.0,11051.0,11523.36,0.0,0.02,5.44,0.0,116.06,2,0.1,28.68
27/10/2020 16:00:00,16/06/2023 15:50:24,Gemini_BTCUSD_1h_17_12_17_to_10_03_23.csv,BTC_USD,HOUR,101009.88,0.148,27/10/2020 17:00:00,27/10/2020 19:00:00,27/10/2020 19:00:00,EXPIRED,LONG,13666.0,13683.0,14164.15,0.0,0.02,3.52,0.0,73.73,2,0.0,2.52
27/09/2018 15:00:00,16/06/2023 15:50:24,Gemini_BTCUSD_1h_17_12_17_to_10_03_23.csv,BTC_USD,HOUR,101012.4,0.312,27/09/2018 16:00:00,27/09/2018 18:00:00,27/09/2018 18:00:00,EXPIRED,LONG,6481.0,6515.0,6988.14,0.0,0.02,7.26,0.0,158.23,2,0.1,10.61
22/07/2021 07:00:00,16/06/2023 15:50:24,Gemini_BTCUSD_1h_17_12_17_to_10_03_23.csv,BTC_USD,HOUR,101023.01,0.063,22/07/2021 08:00:00,22/07/2021 10:00:00,22/07/2021 10:00:00,EXPIRED,LONG,32150.0,31816.0,33556.47,0.0,0.02,4.19,0.0,88.61,2,0.0,-21.04
11/08/2018 12:00:00,16/06/2023 15:50:24,Gemini_BTCUSD_1h_17_12_17_to_10_03_23.csv,BTC_USD,HOUR,101001.97,0.33,11/08/2018 13:00:00,11/08/2018 15:00:00,11/08/2018 15:00:00,EXPIRED,LONG,6126.0,6116.0,6560.74,0.0,0.02,6.63,0.0,143.46,2,0.1,-3.3
01/03/2019 23:00:00,16/06/2023 15:50:24,Gemini_BTCUSD_1h_17_12_17_to_10_03_23.csv,BTC_USD,HOUR,100998.67,0.53,02/03/2019 00:00:00,02/03/2019 02:00:00,02/03/2019 02:00:00,EXPIRED,LONG,3808.0,3816.0,3890.52,0.0,0.02,2.12,0.0,43.74,2,0.0,4.24
10/05/2019 22:00:00,16/06/2023 15:50:24,Gemini_BTCUSD_1h_17_12_17_to_10_03_23.csv,BTC_USD,HOUR,101002.91,0.316,10/05/2019 23:00:00,11/05/2019 01:00:00,11/05/2019 01:00:00,EXPIRED,LONG,6389.0,6486.0,6651.07,0.0,0.02,3.94,0.0,82.81,2,0.0,30.65
26/03/2019 20:00:00,16/06/2023 15:50:24,Gemini_BTCUSD_1h_17_12_17_to_10_03_23.csv,BTC_USD,HOUR,101033.56,0.516,26/03/2019 22:00:00,26/03/2019 23:00:00,26/03/2019 23:00:00,EXPIRED,LONG,3917.0,3920.0,4006.76,0.0,0.02,2.24,0.0,46.32,2,0.0,1.55
26/04/2021 23:00:00,16/06/2023 15:50:24,Gemini_BTCUSD_1h_17_12_17_to_10_03_23.csv,BTC_USD,HOUR,101035.11,0.037,27/04/2021 03:00:00,27/04/2021 02:00:00,27/04/2021 02:00:00,EXPIRED,LONG,54060.0,53888.0,58009.41,0.0,0.02,6.81,0.0,146.13,2,0.1,-6.36
13/11/2019 01:00:00,16/06/2023 15:50:24,Gemini_BTCUSD_1h_17_12_17_to_10_03_23.csv,BTC_USD,HOUR,101028.75,0.229,13/11/2019 04:00:00,13/11/2019 04:00:00,13/11/2019 04:00:00,EXPIRED,LONG,8830.0,8726.0,9145.43,0.0,0.02,3.45,0.0,72.23,2,0.0,-23.82
27/02/2018 22:00:00,16/06/2023 15:50:24,Gemini_BTCUSD_1h_17_12_17_to_10_03_23.csv,BTC_USD,HOUR,101004.93,0.188,27/02/2018 23:00:00,28/02/2018 01:00:00,28/02/2018 01:00:00,EXPIRED,LONG,10730.0,10689.0,11466.31,0.0,0.02,6.42,0.0,138.43,2,0.1,-7.71
07/03/2021 13:00:00,16/06/2023 15:50:24,Gemini_BTCUSD_1h_17_12_17_to_10_03_23.csv,BTC_USD,HOUR,100997.22,0.04,07/03/2021 17:00:00,07/03/2021 16:00:00,07/03/2021 16:00:00,EXPIRED,LONG,50822.0,51058.0,52663.03,0.0,0.02,3.5,0.0,73.64,2,0.0,9.44
10/08/2018 00:00:00,16/06/2023 15:50:24,Gemini_BTCUSD_1h_17_12_17_to_10_03_23.csv,BTC_USD,HOUR,101006.66,0.308,10/08/2018 01:00:00,10/08/2018 03:00:00,10/08/2018 03:00:00,EXPIRED,LONG,6566.0,6468.0,7023.15,0.0,0.02,6.51,0.0,140.8,2,0.1,-30.18
26/06/2019 04:00:00,16/06/2023 15:50:24,Gemini_BTCUSD_1h_17_12_17_to_10_03_23.csv,BTC_USD,HOUR,100976.48,0.162,26/06/2019 05:00:00,26/06/2019 07:00:00,26/06/2019 05:00:00,TAKE_PROFIT_HIT,LONG,12445.0,12902.8,12902.8,0.0,0.02,3.55,0.0,74.16,2,0.0,74.16
24/01/2023 18:00:00,16/06/2023 15:50:24,Gemini_BTCUSD_1h_17_12_17_to_10_03_23.csv,BTC_USD,HOUR,101050.64,0.088,24/01/2023 19:00:00,24/01/2023 21:00:00,24/01/2023 21:00:00,EXPIRED,LONG,23007.0,22909.0,24683.53,0.0,0.02,6.79,0.0,147.53,2,0.1,-8.62
04/05/2018 10:00:00,16/06/2023 15:50:24,Gemini_BTCUSD_1h_17_12_17_to_10_03_23.csv,BTC_USD,HOUR,101042.02,0.209,04/05/2018 11:00:00,04/05/2018 13:00:00,04/05/2018 13:00:00,EXPIRED,LONG,9690.0,9640.0,10319.89,0.0,0.02,6.1,0.0,131.65,2,0.1,-10.45
01/04/2019 04:00:00,16/06/2023 15:50:24,Gemini_BTCUSD_1h_17_12_17_to_10_03_23.csv,BTC_USD,HOUR,101031.57,0.49,01/04/2019 05:00:00,01/04/2019 07:00:00,01/04/2019 07:00:00,EXPIRED,LONG,4126.0,4122.0,4217.39,0.0,0.02,2.17,0.0,44.78,2,0.0,-1.96
20/10/2022 17:00:00,16/06/2023 15:50:24,Gemini_BTCUSD_1h_17_12_17_to_10_03_23.csv,BTC_USD,HOUR,101029.61,0.106,20/10/2022 18:00:00,20/10/2022 20:00:00,20/10/2022 20:00:00,EXPIRED,LONG,19091.0,19028.0,20410.96,0.0,0.02,6.47,0.0,139.92,2,0.1,-6.68
13/02/2018 17:00:00,16/06/2023 15:50:24,Gemini_BTCUSD_1h_17_12_17_to_10_03_23.csv,BTC_USD,HOUR,101022.93,0.234,13/02/2018 21:00:00,13/02/2018 20:00:00,13/02/2018 20:00:00,EXPIRED,LONG,8635.0,8711.0,9176.2,0.0,0.02,5.9,0.0,126.64,2,0.1,17.78
23/06/2022 10:00:00,16/06/2023 15:50:24,Gemini_BTCUSD_1h_17_12_17_to_10_03_23.csv,BTC_USD,HOUR,101040.71,0.098,23/06/2022 11:00:00,23/06/2022 13:00:00,23/06/2022 13:00:00,EXPIRED,LONG,20682.0,20448.0,22493.31,0.0,0.02,8.05,0.0,177.51,2,0.1,-22.93
11/02/2021 05:00:00,16/06/2023 15:50:24,Gemini_BTCUSD_1h_17_12_17_to_10_03_23.csv,BTC_USD,HOUR,101017.78,0.045,11/02/2021 07:00:00,11/02/2021 08:00:00,11/02/2021 08:00:00,EXPIRED,LONG,44728.0,45071.0,45439.72,0.0,0.02,1.57,0.0,32.03,2,0.0,15.43
26/12/2017 00:00:00,16/06/2023 15:50:24,Gemini_BTCUSD_1h_17_12_17_to_10_03_23.csv,BTC_USD,HOUR,101033.21,0.144,26/12/2017 01:00:00,26/12/2017 03:00:00,26/12/2017 03:00:00,TAKE_PROFIT_HIT,LONG,14007.0,14539.13,14539.13,0.0,0.02,3.66,0.0,76.63,2,0.0,76.63
03/11/2020 09:00:00,16/06/2023 15:50:24,Gemini_BTCUSD_1h_17_12_17_to_10_03_23.csv,BTC_USD,HOUR,101109.84,0.149,03/11/2020 12:00:00,03/11/2020 12:00:00,03/11/2020 12:00:00,EXPIRED,LONG,13570.0,13531.0,14574.84,0.0,0.02,6.89,0.0,149.72,2,0.1,-5.81
25/10/2022 15:00:00,16/06/2023 15:50:24,Gemini_BTCUSD_1h_17_12_17_to_10_03_23.csv,BTC_USD,HOUR,101104.03,0.102,25/10/2022 16:00:00,25/10/2022 18:00:00,25/10/2022 18:00:00,EXPIRED,LONG,19747.0,20292.0,20704.73,0.0,0.02,4.63,0.0,97.69,2,0.0,55.59
30/11/2021 14:00:00,16/06/2023 15:50:24,Gemini_BTCUSD_1h_17_12_17_to_10_03_23.csv,BTC_USD,HOUR,101159.62,0.035,30/11/2021 15:00:00,30/11/2021 17:00:00,30/11/2021 17:00:00,EXPIRED,LONG,58419.0,57441.0,62824.25,0.0,0.02,7.01,0.0,154.18,2,0.1,-34.23
31/03/2020 15:00:00,16/06/2023 15:50:24,Gemini_BTCUSD_1h_17_12_17_to_10_03_23.csv,BTC_USD,HOUR,101125.39,0.313,31/03/2020 16:00:00,31/03/2020 18:00:00,31/03/2020 18:00:00,EXPIRED,LONG,6470.0,6478.0,6778.37,0.0,0.02,4.55,0.0,96.52,2,0.0,2.5
20/12/2018 04:00:00,16/06/2023 15:50:24,Gemini_BTCUSD_1h_17_12_17_to_10_03_23.csv,BTC_USD,HOUR,101127.89,0.541,20/12/2018 05:00:00,20/12/2018 07:00:00,20/12/2018 07:00:00,EXPIRED,LONG,3740.0,3737.0,3842.0,0.0,0.02,2.65,0.0,55.18,2,0.0,-1.62
18/12/2020 11:00:00,16/06/2023 15:50:24,Gemini_BTCUSD_1h_17_12_17_to_10_03_23.csv,BTC_USD,HOUR,101126.27,0.088,18/12/2020 12:00:00,18/12/2020 14:00:00,18/12/2020 14:00:00,EXPIRED,LONG,22879.0,22618.0,24802.05,0.0,0.02,7.75,0.0,169.23,2,0.1,-22.97
14/08/2020 02:00:00,16/06/2023 15:50:24,Gemini_BTCUSD_1h_17_12_17_to_10_03_23.csv,BTC_USD,HOUR,101103.3,0.172,14/08/2020 03:00:00,14/08/2020 05:00:00,14/08/2020 05:00:00,EXPIRED,LONG,11750.0,11743.0,12064.0,0.0,0.02,2.6,0.0,54.01,2,0.0,-1.2
13/08/2021 11:00:00,16/06/2023 15:50:24,Gemini_BTCUSD_1h_17_12_17_to_10_03_23.csv,BTC_USD,HOUR,101102.1,0.044,13/08/2021 12:00:00,13/08/2021 14:00:00,13/08/2021 14:00:00,EXPIRED,LONG,46163.0,46464.0,48081.23,0.0,0.02,3.99,0.0,84.4,2,0.0,13.24
11/02/2022 13:00:00,16/06/2023 15:50:24,Gemini_BTCUSD_1h_17_12_17_to_10_03_23.csv,BTC_USD,HOUR,101115.34,0.046,11/02/2022 14:00:00,11/02/2022 16:00:00,11/02/2022 16:00:00,EXPIRED,LONG,43810.0,43627.0,46694.1,0.0,0.02,6.18,0.0,132.67,2,0.1,-8.42
11/02/2019 19:00:00,16/06/2023 15:50:24,Gemini_BTCUSD_1h_17_12_17_to_10_03_23.csv,BTC_USD,HOUR,101106.92,0.562,11/02/2019 20:00:00,11/02/2019 22:00:00,11/02/2019 22:00:00,EXPIRED,LONG,3601.0,3598.0,3736.72,0.0,0.02,3.63,0.0,76.27,2,0.0,-1.69
01/09/2021 13:00:00,16/06/2023 15:50:24,Gemini_BTCUSD_1h_17_12_17_to_10_03_23.csv,BTC_USD,HOUR,101105.23,0.043,01/09/2021 14:00:00,01/09/2021 16:00:00,01/09/2021 16:00:00,TAKE_PROFIT_HIT,LONG,47478.0,48592.28,48592.28,0.0,0.02,2.29,0.0,47.91,2,0.0,47.91
06/10/2021 02:00:00,16/06/2023 15:50:24,Gemini_BTCUSD_1h_17_12_17_to_10_03_23.csv,BTC_USD,HOUR,101153.14,0.039,06/10/2021 03:00:00,06/10/2021 05:00:00,06/10/2021 05:00:00,EXPIRED,LONG,51594.0,51562.0,53543.05,0.0,0.02,3.64,0.0,76.01,2,0.0,-1.25
08/07/2019 13:00:00,16/06/2023 15:50:24,Gemini_BTCUSD_1h_17_12_17_to_10_03_23.csv,BTC_USD,HOUR,101151.89,0.17,08/07/2019 17:00:00,08/07/2019 16:00:00,08/07/2019 16:00:00,EXPIRED,LONG,11905.0,11883.0,12194.78,0.0,0.02,2.38,0.0,49.26,2,0.0,-3.74
22/11/2022 13:00:00,16/06/2023 15:50:24,Gemini_BTCUSD_1h_17_12_17_to_10_03_23.csv,BTC_USD,HOUR,101148.15,0.125,22/11/2022 15:00:00,22/11/2022 16:00:00,22/11/2022 16:00:00,EXPIRED,LONG,16140.0,16146.0,17359.91,0.0,0.02,7.03,0.0,152.49,2,0.1,0.75
15/01/2020 03:00:00,16/06/2023 15:50:24,Gemini_BTCUSD_1h_17_12_17_to_10_03_23.csv,BTC_USD,HOUR,101148.9,0.232,15/01/2020 04:00:00,15/01/2020 06:00:00,15/01/2020 06:00:00,EXPIRED,LONG,8727.0,8659.0,9084.64,0.0,0.02,3.94,0.0,82.97,2,0.0,-15.78
06/10/2021 19:00:00,16/06/2023 15:50:24,Gemini_BTCUSD_1h_17_12_17_to_10_03_23.csv,BTC_USD,HOUR,101133.12,0.037,06/10/2021 20:00:00,06/10/2021 22:00:00,06/10/2021 22:00:00,EXPIRED,LONG,55081.0,55173.0,56274.56,0.0,0.02,2.12,0.0,44.16,2,0.0,3.4
23/12/2020 10:00:00,16/06/2023 15:50:24,Gemini_BTCUSD_1h_17_12_17_to_10_03_23.csv,BTC_USD,HOUR,101136.52,0.086,23/12/2020 14:00:00,23/12/2020 13:00:00,23/12/2020 13:00:00,EXPIRED,LONG,23428.0,23621.0,24348.08,0.0,0.02,3.78,0.0,79.13,2,0.0,16.6
31/12/2017 15:00:00,16/06/2023 15:50:24,Gemini_BTCUSD_1h_17_12_17_to_10_03_23.csv,BTC_USD,HOUR,101153.12,0.152,31/12/2017 16:00:00,31/12/2017 18:00:00,31/12/2017 16:00:00,TAKE_PROFIT_HIT,LONG,13290.0,14087.12,14087.12,0.0,0.02,5.66,0.0,121.16,2,0.1,121.16
01/11/2019 11:00:00,16/06/2023 15:50:24,Gemini_BTCUSD_1h_17_12_17_to_10_03_23.csv,BTC_USD,HOUR,101274.28,0.221,01/11/2019 12:00:00,01/11/2019 14:00:00,01/11/2019 14:00:00,EXPIRED,LONG,9180.0,9131.0,9779.11,0.0,0.02,6.13,0.0,132.4,2,0.1,-10.83
03/07/2018 06:00:00,16/06/2023 15:50:24,Gemini_BTCUSD_1h_17_12_17_to_10_03_23.csv,BTC_USD,HOUR,101263.45,0.305,03/07/2018 07:00:00,03/07/2018 09:00:00,03/07/2018 09:00:00,EXPIRED,LONG,6633.0,6614.0,7253.38,0.0,0.02,8.55,0.0,189.22,2,0.1,-5.79
17/09/2021 02:00:00,16/06/2023 15:50:24,Gemini_BTCUSD_1h_17_12_17_to_10_03_23.csv,BTC_USD,HOUR,101257.66,0.042,17/09/2021 03:00:00,17/09/2021 05:00:00,17/09/2021 05:00:00,EXPIRED,LONG,47777.0,48056.0,51065.74,0.0,0.02,6.44,0.0,138.13,2,0.1,11.72
08/12/2022 02:00:00,16/06/2023 15:50:24,Gemini_BTCUSD_1h_17_12_17_to_10_03_23.csv,BTC_USD,HOUR,101269.38,0.12,08/12/2022 03:00:00,08/12/2022 05:00:00,08/12/2022 05:00:00,EXPIRED,LONG,16848.0,16824.0,17376.92,0.0,0.02,3.04,0.0,63.47,2,0.0,-2.88
02/04/2018 05:00:00,16/06/2023 15:50:24,Gemini_BTCUSD_1h_17_12_17_to_10_03_23.csv,BTC_USD,HOUR,101266.5,0.294,02/04/2018 06:00:00,02/04/2018 08:00:00,02/04/2018 08:00:00,EXPIRED,LONG,6900.0,7060.0,7231.66,0.0,0.02,4.59,0.0,97.51,2,0.0,47.04
23/06/2019 17:00:00,16/06/2023 15:50:24,Gemini_BTCUSD_1h_17_12_17_to_10_03_23.csv,BTC_USD,HOUR,101313.54,0.19,23/06/2019 19:00:00,23/06/2019 20:00:00,23/06/2019 20:00:00,EXPIRED,LONG,10690.0,11004.0,11069.94,0.0,0.02,3.43,0.0,72.19,2,0.0,59.66
20/03/2022 21:00:00,16/06/2023 15:50:24,Gemini_BTCUSD_1h_17_12_17_to_10_03_23.csv,BTC_USD,HOUR,101373.2,0.049,20/03/2022 23:00:00,21/03/2022 00:00:00,21/03/2022 00:00:00,EXPIRED,LONG,41397.0,41440.0,42302.64,0.0,0.02,2.14,0.0,44.38,2,0.0,2.11
24/01/2020 19:00:00,16/06/2023 15:50:24,Gemini_BTCUSD_1h_17_12_17_to_10_03_23.csv,BTC_USD,HOUR,101375.31,0.239,24/01/2020 22:00:00,24/01/2020 22:00:00,24/01/2020 22:00:00,EXPIRED,LONG,8488.0,8449.0,8733.69,0.0,0.02,2.81,0.0,58.72,2,0.0,-9.32
21/08/2022 12:00:00,16/06/2023 15:50:24,Gemini_BTCUSD_1h_17_12_17_to_10_03_23.csv,BTC_USD,HOUR,101365.99,0.094,21/08/2022 13:00:00,21/08/2022 15:00:00,21/08/2022 15:00:00,EXPIRED,LONG,21483.0,21425.0,22358.89,0.0,0.02,3.92,0.0,82.33,2,0.0,-5.45
11/03/2018 10:00:00,16/06/2023 15:50:24,Gemini_BTCUSD_1h_17_12_17_to_10_03_23.csv,BTC_USD,HOUR,101360.54,0.232,11/03/2018 14:00:00,11/03/2018 13:00:00,11/03/2018 12:00:00,TAKE_PROFIT_HIT,LONG,8733.0,9168.26,9168.26,0.0,0.02,4.75,0.0,100.98,2,0.0,100.98
05/03/2022 17:00:00,16/06/2023 15:50:24,Gemini_BTCUSD_1h_17_12_17_to_10_03_23.csv,BTC_USD,HOUR,101461.52,0.051,05/03/2022 18:00:00,05/03/2022 20:00:00,05/03/2022 20:00:00,EXPIRED,LONG,39455.0,39471.0,41432.6,0.0,0.02,4.77,0.0,100.86,2,0.1,0.82
18/03/2022 14:00:00,16/06/2023 15:50:24,Gemini_BTCUSD_1h_17_12_17_to_10_03_23.csv,BTC_USD,HOUR,101462.34,0.05,18/03/2022 17:00:00,18/03/2022 17:00:00,18/03/2022 17:00:00,EXPIRED,LONG,40574.0,41704.0,42098.51,0.0,0.02,3.62,0.0,76.23,2,0.0,56.5
10/12/2021 14:00:00,16/06/2023 15:50:24,Gemini_BTCUSD_1h_17_12_17_to_10_03_23.csv,BTC_USD,HOUR,101518.84,0.041,10/12/2021 16:00:00,10/12/2021 17:00:00,10/12/2021 17:00:00,EXPIRED,LONG,49094.0,49094.0,52985.81,0.0,0.02,7.35,0.0,159.56,2,0.1,0.0
14/01/2018 21:00:00,16/06/2023 15:50:24,Gemini_BTCUSD_1h_17_12_17_to_10_03_23.csv,BTC_USD,HOUR,101518.84,0.151,14/01/2018 22:00:00,15/01/2018 00:00:00,15/01/2018 00:00:00,EXPIRED,LONG,13402.0,13718.0,13790.28,0.0,0.02,2.82,0.0,58.63,2,0.0,47.72
08/08/2021 14:00:00,16/06/2023 15:50:24,Gemini_BTCUSD_1h_17_12_17_to_10_03_23.csv,BTC_USD,HOUR,101566.56,0.046,08/08/2021 16:00:00,08/08/2021 17:00:00,08/08/2021 17:00:00,EXPIRED,LONG,43939.0,43707.0,44955.9,0.0,0.02,2.26,0.0,46.78,2,0.0,-10.67
29/01/2022 10:00:00,16/06/2023 15:50:24,Gemini_BTCUSD_1h_17_12_17_to_10_03_23.csv,BTC_USD,HOUR,101555.89,0.054,29/01/2022 11:00:00,29/01/2022 13:00:00,29/01/2022 13:00:00,EXPIRED,LONG,37784.0,38183.0,39559.94,0.0,0.02,4.49,0.0,95.9,2,0.0,21.55
17/07/2021 20:00:00,16/06/2023 15:50:24,Gemini_BTCUSD_1h_17_12_17_to_10_03_23.csv,BTC_USD,HOUR,101577.44,0.064,17/07/2021 21:00:00,17/07/2021 23:00:00,17/07/2021 23:00:00,EXPIRED,LONG,31744.0,31535.0,33567.51,0.0,0.02,5.43,0.0,116.7,2,0.1,-13.38
14/10/2021 03:00:00,16/06/2023 15:50:24,Gemini_BTCUSD_1h_17_12_17_to_10_03_23.csv,BTC_USD,HOUR,101564.06,0.035,14/10/2021 05:00:00,14/10/2021 06:00:00,14/10/2021 06:00:00,EXPIRED,LONG,58074.0,57666.0,60521.23,0.0,0.02,4.04,0.0,85.65,2,0.0,-14.28
01/09/2021 05:00:00,16/06/2023 15:50:24,Gemini_BTCUSD_1h_17_12_17_to_10_03_23.csv,BTC_USD,HOUR,101549.78,0.043,01/09/2021 06:00:00,01/09/2021 08:00:00,01/09/2021 08:00:00,EXPIRED,LONG,47460.0,47357.0,51567.3,0.0,0.02,7.96,0.0,176.61,2,0.1,-4.43
05/08/2022 22:00:00,16/06/2023 15:50:24,Gemini_BTCUSD_1h_17_12_17_to_10_03_23.csv,BTC_USD,HOUR,101545.35,0.087,06/08/2022 02:00:00,06/08/2022 01:00:00,06/08/2022 01:00:00,EXPIRED,LONG,23251.0,23217.0,25088.84,0.0,0.02,7.33,0.0,159.89,2,0.1,-2.96
16/03/2020 16:00:00,16/06/2023 15:50:24,Gemini_BTCUSD_1h_17_12_17_to_10_03_23.csv,BTC_USD,HOUR,101542.39,0.404,16/03/2020 17:00:00,16/03/2020 19:00:00,16/03/2020 19:00:00,EXPIRED,LONG,5025.0,4950.0,5512.26,0.0,0.02,8.84,0.0,196.85,2,0.1,-30.3
25/09/2020 19:00:00,16/06/2023 15:50:24,Gemini_BTCUSD_1h_17_12_17_to_10_03_23.csv,BTC_USD,HOUR,101512.09,0.189,25/09/2020 20:00:00,25/09/2020 22:00:00,25/09/2020 22:00:00,EXPIRED,LONG,10720.0,10691.0,11381.91,0.0,0.02,5.82,0.0,125.1,2,0.1,-5.48
13/03/2018 17:00:00,16/06/2023 15:50:24,Gemini_BTCUSD_1h_17_12_17_to_10_03_23.csv,BTC_USD,HOUR,101506.61,0.223,13/03/2018 18:00:00,13/03/2018 20:00:00,13/03/2018 20:00:00,EXPIRED,LONG,9118.0,9067.0,9671.63,0.0,0.02,5.72,0.0,123.46,2,0.1,-11.37
15/04/2021 18:00:00,16/06/2023 15:50:24,Gemini_BTCUSD_1h_17_12_17_to_10_03_23.csv,BTC_USD,HOUR,101495.24,0.032,15/04/2021 20:00:00,15/04/2021 21:00:00,15/04/2021 21:00:00,EXPIRED,LONG,62823.0,63450.0,64405.86,0.0,0.02,2.46,0.0,50.65,2,0.0,20.06
26/07/2020 00:00:00,16/06/2023 15:50:24,Gemini_BTCUSD_1h_17_12_17_to_10_03_23.csv,BTC_USD,HOUR,101515.3,0.209,26/07/2020 03:00:00,26/07/2020 03:00:00,26/07/2020 03:00:00,EXPIRED,LONG,9700.0,9691.0,9922.95,0.0,0.02,2.25,0.0,46.6,2,0.0,-1.88
16/01/2022 13:00:00,16/06/2023 15:50:24,Gemini_BTCUSD_1h_17_12_17_to_10_03_23.csv,BTC_USD,HOUR,101513.42,0.047,16/01/2022 17:00:00,16/01/2022 16:00:00,16/01/2022 16:00:00,EXPIRED,LONG,43173.0,43425.0,45156.4,0.0,0.02,4.39,0.0,93.22,2,0.0,11.84
26/11/2022 22:00:00,16/06/2023 15:50:24,Gemini_BTCUSD_1h_17_12_17_to_10_03_23.csv,BTC_USD,HOUR,101525.26,0.123,27/11/2022 02:00:00,27/11/2022 01:00:00,27/11/2022 01:00:00,EXPIRED,LONG,16510.0,16489.0,16865.47,0.0,0.02,2.11,0.0,43.72,2,0.0,-2.58
29/07/2022 05:00:00,16/06/2023 15:50:24,Gemini_BTCUSD_1h_17_12_17_to_10_03_23.csv,BTC_USD,HOUR,101522.68,0.085,29/07/2022 07:00:00,29/07/2022 08:00:00,29/07/2022 08:00:00,EXPIRED,LONG,24015.0,23924.0,24585.24,0.0,0.02,2.32,0.0,48.47,2,0.0,-7.73
17/03/2022 18:00:00,16/06/2023 15:50:24,Gemini_BTCUSD_1h_17_12_17_to_10_03_23.csv,BTC_USD,HOUR,101514.95,0.05,17/03/2022 21:00:00,17/03/2022 21:00:00,17/03/2022 21:00:00,EXPIRED,LONG,40837.0,41005.0,41990.85,0.0,0.02,2.75,0.0,57.69,2,0.0,8.4
27/03/2022 16:00:00,16/06/2023 15:50:24,Gemini_BTCUSD_1h_17_12_17_to_10_03_23.csv,BTC_USD,HOUR,101523.35,0.045,27/03/2022 18:00:00,27/03/2022 19:00:00,27/03/2022 19:00:00,EXPIRED,LONG,44966.0,44851.0,48838.96,0.0,0.02,7.93,0.0,174.28,2,0.1,-5.17
01/06/2019 11:00:00,16/06/2023 15:50:24,Gemini_BTCUSD_1h_17_12_17_to_10_03_23.csv,BTC_USD,HOUR,101518.18,0.237,01/06/2019 12:00:00,01/06/2019 14:00:00,01/06/2019 14:00:00,EXPIRED,LONG,8573.0,8502.0,9264.22,0.0,0.02,7.46,0.0,163.82,2,0.1,-16.83
23/05/2020 05:00:00,16/06/2023 15:50:24,Gemini_BTCUSD_1h_17_12_17_to_10_03_23.csv,BTC_USD,HOUR,101501.35,0.219,23/05/2020 06:00:00,23/05/2020 08:00:00,23/05/2020 08:00:00,EXPIRED,LONG,9267.0,9190.0,9472.3,0.0,0.02,2.17,0.0,44.96,2,0.0,-16.86
19/12/2018 02:00:00,16/06/2023 15:50:24,Gemini_BTCUSD_1h_17_12_17_to_10_03_23.csv,BTC_USD,HOUR,101484.49,0.546,19/12/2018 03:00:00,19/12/2018 05:00:00,19/12/2018 05:00:00,EXPIRED,LONG,3716.0,3738.0,3899.25,0.0,0.02,4.7,0.0,100.05,2,0.0,12.01
02/05/2020 06:00:00,16/06/2023 15:50:24,Gemini_BTCUSD_1h_17_12_17_to_10_03_23.csv,BTC_USD,HOUR,101496.5,0.23,02/05/2020 08:00:00,02/05/2020 09:00:00,02/05/2020 09:00:00,EXPIRED,LONG,8820.0,8816.0,9410.81,0.0,0.02,6.28,0.0,135.89,2,0.1,-0.92
29/12/2022 18:00:00,16/06/2023 15:50:24,Gemini_BTCUSD_1h_17_12_17_to_10_03_23.csv,BTC_USD,HOUR,101495.58,0.122,29/12/2022 19:00:00,29/12/2022 21:00:00,29/12/2022 21:00:00,EXPIRED,LONG,16619.0,16584.0,17367.59,0.0,0.02,4.31,0.0,91.33,2,0.0,-4.27
30/11/2019 09:00:00,16/06/2023 15:50:24,Gemini_BTCUSD_1h_17_12_17_to_10_03_23.csv,BTC_USD,HOUR,101491.31,0.263,30/11/2019 10:00:00,30/11/2019 12:00:00,30/11/2019 12:00:00,EXPIRED,LONG,7712.0,7701.0,8084.81,0.0,0.02,4.61,0.0,98.05,2,0.0,-2.89
28/12/2018 15:00:00,16/06/2023 15:50:24,Gemini_BTCUSD_1h_17_12_17_to_10_03_23.csv,BTC_USD,HOUR,101488.42,0.531,28/12/2018 16:00:00,28/12/2018 18:00:00,28/12/2018 18:00:00,EXPIRED,LONG,3825.0,3864.0,3980.11,0.0,0.02,3.9,0.0,82.36,2,0.0,20.71
24/08/2022 09:00:00,16/06/2023 15:50:24,Gemini_BTCUSD_1h_17_12_17_to_10_03_23.csv,BTC_USD,HOUR,101509.13,0.095,24/08/2022 10:00:00,24/08/2022 12:00:00,24/08/2022 12:00:00,EXPIRED,LONG,21314.0,21485.0,21862.38,0.0,0.02,2.51,0.0,52.1,2,0.0,16.25
20/01/2019 11:00:00,16/06/2023 15:50:24,Gemini_BTCUSD_1h_17_12_17_to_10_03_23.csv,BTC_USD,HOUR,101525.38,0.566,20/01/2019 12:00:00,20/01/2019 14:00:00,20/01/2019 14:00:00,EXPIRED,LONG,3589.0,3525.0,3664.29,0.0,0.02,2.05,0.0,42.61,2,0.0,-36.22
28/08/2019 11:00:00,16/06/2023 15:50:24,Gemini_BTCUSD_1h_17_12_17_to_10_03_23.csv,BTC_USD,HOUR,101489.16,0.2,28/08/2019 13:00:00,28/08/2019 14:00:00,28/08/2019 14:00:00,EXPIRED,LONG,10142.0,10212.0,10397.53,0.0,0.02,2.46,0.0,51.11,2,0.0,14.0
19/03/2022 23:00:00,16/06/2023 15:50:24,Gemini_BTCUSD_1h_17_12_17_to_10_03_23.csv,BTC_USD,HOUR,101503.16,0.048,20/03/2022 00:00:00,20/03/2022 02:00:00,20/03/2022 02:00:00,EXPIRED,LONG,42227.0,41851.0,44352.0,0.0,0.02,4.79,0.0,102.0,2,0.1,-18.05
29/08/2022 05:00:00,16/06/2023 15:50:24,Gemini_BTCUSD_1h_17_12_17_to_10_03_23.csv,BTC_USD,HOUR,101485.11,0.103,29/08/2022 06:00:00,29/08/2022 08:00:00,29/08/2022 08:00:00,EXPIRED,LONG,19746.0,19795.0,20218.41,0.0,0.02,2.34,0.0,48.66,2,0.0,5.05
14/06/2018 22:00:00,16/06/2023 15:50:24,Gemini_BTCUSD_1h_17_12_17_to_10_03_23.csv,BTC_USD,HOUR,101490.16,0.306,15/06/2018 00:00:00,15/06/2018 01:00:00,15/06/2018 01:00:00,EXPIRED,LONG,6625.0,6595.0,6801.5,0.0,0.02,2.6,0.0,54.01,2,0.0,-9.18
31/08/2020 18:00:00,16/06/2023 15:50:24,Gemini_BTCUSD_1h_17_12_17_to_10_03_23.csv,BTC_USD,HOUR,101480.98,0.173,31/08/2020 19:00:00,31/08/2020 21:00:00,31/08/2020 21:00:00,EXPIRED,LONG,11731.0,11638.0,12004.32,0.0,0.02,2.28,0.0,47.28,2,0.0,-16.09
21/07/2021 06:00:00,16/06/2023 15:50:24,Gemini_BTCUSD_1h_17_12_17_to_10_03_23.csv,BTC_USD,HOUR,101464.89,0.066,21/07/2021 09:00:00,21/07/2021 09:00:00,21/07/2021 09:00:00,EXPIRED,LONG,30896.0,31333.0,31584.75,0.0,0.02,2.18,0.0,45.46,2,0.0,28.84
21/06/2022 05:00:00,16/06/2023 15:50:24,Gemini_BTCUSD_1h_17_12_17_to_10_03_23.csv,BTC_USD,HOUR,101493.73,0.097,21/06/2022 06:00:00,21/06/2022 08:00:00,21/06/2022 08:00:00,EXPIRED,LONG,20871.0,21337.0,22512.35,0.0,0.02,7.29,0.0,159.21,2,0.1,45.2
07/08/2022 13:00:00,16/06/2023 15:50:24,Gemini_BTCUSD_1h_17_12_17_to_10_03_23.csv,BTC_USD,HOUR,101538.93,0.088,07/08/2022 14:00:00,07/08/2022 16:00:00,07/08/2022 16:00:00,EXPIRED,LONG,23169.0,23096.0,25275.03,0.0,0.02,8.33,0.0,185.33,2,0.1,-6.42
10/04/2019 21:00:00,16/06/2023 15:50:24,Gemini_BTCUSD_1h_17_12_17_to_10_03_23.csv,BTC_USD,HOUR,101532.51,0.383,10/04/2019 22:00:00,11/04/2019 00:00:00,11/04/2019 00:00:00,EXPIRED,LONG,5297.0,5309.0,5692.34,0.0,0.02,6.95,0.0,151.42,2,0.1,4.6
09/03/2018 13:00:00,16/06/2023 15:50:24,Gemini_BTCUSD_1h_17_12_17_to_10_03_23.csv,BTC_USD,HOUR,101537.11,0.228,09/03/2018 16:00:00,09/03/2018 16:00:00,09/03/2018 16:00:00,EXPIRED,LONG,8923.0,8700.0,9251.26,0.0,0.02,3.55,0.0,74.84,2,0.0,-50.84
12/11/2021 18:00:00,16/06/2023 15:50:24,Gemini_BTCUSD_1h_17_12_17_to_10_03_23.csv,BTC_USD,HOUR,101486.27,0.032,12/11/2021 21:00:00,12/11/2021 21:00:00,12/11/2021 21:00:00,EXPIRED,LONG,63922.0,64125.0,65728.12,0.0,0.02,2.75,0.0,57.8,2,0.0,6.5
27/01/2023 00:00:00,16/06/2023 15:50:24,Gemini_BTCUSD_1h_17_12_17_to_10_03_23.csv,BTC_USD,HOUR,101492.77,0.089,27/01/2023 03:00:00,27/01/2023 03:00:00,27/01/2023 03:00:00,EXPIRED,LONG,22931.0,22777.0,23571.82,0.0,0.02,2.72,0.0,57.03,2,0.0,-13.71
04/11/2021 23:00:00,16/06/2023 15:50:24,Gemini_BTCUSD_1h_17_12_17_to_10_03_23.csv,BTC_USD,HOUR,101479.06,0.033,05/11/2021 00:00:00,05/11/2021 02:00:00,05/11/2021 02:00:00,EXPIRED,LONG,61453.0,61693.0,65425.72,0.0,0.02,6.07,0.0,131.1,2,0.1,7.92
23/12/2017 09:00:00,16/06/2023 15:50:24,Gemini_BTCUSD_1h_17_12_17_to_10_03_23.csv,BTC_USD,HOUR,101486.98,0.138,23/12/2017 10:00:00,23/12/2017 12:00:00,23/12/2017 12:00:00,EXPIRED,LONG,14733.0,15193.0,15818.67,0.0,0.02,6.86,0.0,149.82,2,0.1,63.48
26/09/2022 14:00:00,16/06/2023 15:50:24,Gemini_BTCUSD_1h_17_12_17_to_10_03_23.csv,BTC_USD,HOUR,101550.46,0.106,26/09/2022 18:00:00,26/09/2022 17:00:00,26/09/2022 17:00:00,EXPIRED,LONG,19137.0,19105.0,20020.54,0.0,0.02,4.41,0.0,93.66,2,0.0,-3.39
28/07/2018 01:00:00,16/06/2023 15:50:24,Gemini_BTCUSD_1h_17_12_17_to_10_03_23.csv,BTC_USD,HOUR,101547.07,0.248,28/07/2018 04:00:00,28/07/2018 04:00:00,28/07/2018 04:00:00,EXPIRED,LONG,8192.0,8221.0,8385.08,0.0,0.02,2.3,0.0,47.88,2,0.0,7.19
11/10/2021 19:00:00,16/06/2023 15:50:24,Gemini_BTCUSD_1h_17_12_17_to_10_03_23.csv,BTC_USD,HOUR,101554.26,0.035,11/10/2021 22:00:00,11/10/2021 22:00:00,11/10/2021 22:00:00,EXPIRED,LONG,57504.0,57194.0,59319.43,0.0,0.02,3.06,0.0,63.54,2,0.0,-10.85
24/06/2021 00:00:00,16/06/2023 15:50:24,Gemini_BTCUSD_1h_17_12_17_to_10_03_23.csv,BTC_USD,HOUR,101543.41,0.061,24/06/2021 01:00:00,24/06/2021 03:00:00,24/06/2021 03:00:00,EXPIRED,LONG,33204.0,32607.0,36298.51,0.0,0.02,8.53,0.0,188.77,2,0.1,-36.42
05/10/2020 03:00:00,16/06/2023 15:50:24,Gemini_BTCUSD_1h_17_12_17_to_10_03_23.csv,BTC_USD,HOUR,101506.99,0.19,05/10/2020 04:00:00,05/10/2020 06:00:00,05/10/2020 06:00:00,EXPIRED,LONG,10672.0,10650.0,11575.88,0.0,0.02,7.81,0.0,171.74,2,0.1,-4.18
04/11/2019 09:00:00,16/06/2023 15:50:24,Gemini_BTCUSD_1h_17_12_17_to_10_03_23.csv,BTC_USD,HOUR,101502.81,0.221,04/11/2019 10:00:00,04/11/2019 12:00:00,04/11/2019 12:00:00,EXPIRED,LONG,9170.0,9244.0,9769.66,0.0,0.02,6.14,0.0,132.52,2,0.1,16.35
21/09/2018 13:00:00,16/06/2023 15:50:24,Gemini_BTCUSD_1h_17_12_17_to_10_03_23.csv,BTC_USD,HOUR,101519.16,0.302,21/09/2018 16:00:00,21/09/2018 16:00:00,21/09/2018 16:00:00,EXPIRED,LONG,6728.0,6718.0,6968.84,0.0,0.02,3.46,0.0,72.73,2,0.0,-3.02
10/04/2021 05:00:00,16/06/2023 15:50:24,Gemini_BTCUSD_1h_17_12_17_to_10_03_23.csv,BTC_USD,HOUR,101516.14,0.033,10/04/2021 06:00:00,10/04/2021 08:00:00,10/04/2021 08:00:00,EXPIRED,LONG,60804.0,60495.0,63628.17,0.0,0.02,4.44,0.0,93.2,2,0.0,-10.2
15/04/2021 20:00:00,16/06/2023 15:50:24,Gemini_BTCUSD_1h_17_12_17_to_10_03_23.csv,BTC_USD,HOUR,101505.94,0.032,15/04/2021 21:00:00,15/04/2021 23:00:00,15/04/2021 23:00:00,EXPIRED,LONG,63410.0,63238.0,65125.05,0.0,0.02,2.63,0.0,54.88,2,0.0,-5.5
14/03/2022 12:00:00,16/06/2023 15:50:24,Gemini_BTCUSD_1h_17_12_17_to_10_03_23.csv,BTC_USD,HOUR,101500.44,0.052,14/03/2022 16:00:00,14/03/2022 15:00:00,14/03/2022 15:00:00,EXPIRED,LONG,38836.0,38975.0,39728.52,0.0,0.02,2.25,0.0,46.41,2,0.0,7.23
03/09/2018 22:00:00,16/06/2023 15:50:24,Gemini_BTCUSD_1h_17_12_17_to_10_03_23.csv,BTC_USD,HOUR,101507.67,0.28,04/09/2018 01:00:00,04/09/2018 01:00:00,04/09/2018 01:00:00,EXPIRED,LONG,7259.0,7274.0,7450.4,0.0,0.02,2.57,0.0,53.59,2,0.0,4.2
13/03/2018 17:00:00,16/06/2023 15:50:24,Gemini_BTCUSD_1h_17_12_17_to_10_03_23.csv,BTC_USD,HOUR,101511.87,0.223,13/03/2018 18:00:00,13/03/2018 20:00:00,13/03/2018 20:00:00,EXPIRED,LONG,9118.0,9067.0,9671.63,0.0,0.02,5.72,0.0,123.46,2,0.1,-11.37
11/03/2018 17:00:00,16/06/2023 15:50:24,Gemini_BTCUSD_1h_17_12_17_to_10_03_23.csv,BTC_USD,HOUR,101500.5,0.21,11/03/2018 19:00:00,11/03/2018 20:00:00,11/03/2018 20:00:00,EXPIRED,LONG,9644.0,9609.0,10132.13,0.0,0.02,4.82,0.0,102.51,2,0.1,-7.35
09/07/2020 02:00:00,16/06/2023 15:50:24,Gemini_BTCUSD_1h_17_12_17_to_10_03_23.csv,BTC_USD,HOUR,101493.15,0.216,09/07/2020 03:00:00,09/07/2020 05:00:00,09/07/2020 05:00:00,EXPIRED,LONG,9385.0,9382.0,9600.68,0.0,0.02,2.25,0.0,46.59,2,0.0,-0.65
11/12/2022 09:00:00,16/06/2023 15:50:24,Gemini_BTCUSD_1h_17_12_17_to_10_03_23.csv,BTC_USD,HOUR,101492.5,0.118,11/12/2022 10:00:00,11/12/2022 12:00:00,11/12/2022 12:00:00,EXPIRED,LONG,17172.0,17164.0,17698.37,0.0,0.02,2.97,0.0,62.11,2,0.0,-0.94
13/02/2022 23:00:00,16/06/2023 15:50:24,Gemini_BTCUSD_1h_17_12_17_to_10_03_23.csv,BTC_USD,HOUR,101491.56,0.048,14/02/2022 02:00:00,14/02/2022 02:00:00,14/02/2022 02:00:00,EXPIRED,LONG,42080.0,41711.0,44316.04,0.0,0.02,5.05,0.0,107.33,2,0.1,-17.71
08/04/2020 23:00:00,16/06/2023 15:50:24,Gemini_BTCUSD_1h_17_12_17_to_10_03_23.csv,BTC_USD,HOUR,101473.85,0.275,09/04/2020 00:00:00,09/04/2020 02:00:00,09/04/2020 02:00:00,EXPIRED,LONG,7370.0,7330.0,8052.03,0.0,0.02,8.47,0.0,187.56,2,0.1,-11.0
01/01/2020 05:00:00,16/06/2023 15:50:24,Gemini_BTCUSD_1h_17_12_17_to_10_03_23.csv,BTC_USD,HOUR,101462.85,0.282,01/01/2020 06:00:00,01/01/2020 08:00:00,01/01/2020 08:00:00,EXPIRED,LONG,7200.0,7174.0,7625.47,0.0,0.02,5.58,0.0,119.98,2,0.1,-7.33
25/05/2021 22:00:00,16/06/2023 15:50:24,Gemini_BTCUSD_1h_17_12_17_to_10_03_23.csv,BTC_USD,HOUR,101455.52,0.053,26/05/2021 02:00:00,26/05/2021 01:00:00,26/05/2021 01:00:00,EXPIRED,LONG,38459.0,38681.0,41981.74,0.0,0.02,8.39,0.0,186.71,2,0.1,11.77
17/02/2018 13:00:00,16/06/2023 15:50:24,Gemini_BTCUSD_1h_17_12_17_to_10_03_23.csv,BTC_USD,HOUR,101467.29,0.189,17/02/2018 14:00:00,17/02/2018 16:00:00,17/02/2018 16:00:00,EXPIRED,LONG,10730.0,10833.0,11003.66,0.0,0.02,2.49,0.0,51.72,2,0.0,19.47
02/09/2022 14:00:00,16/06/2023 15:50:24,Gemini_BTCUSD_1h_17_12_17_to_10_03_23.csv,BTC_USD,HOUR,101486.76,0.1,02/09/2022 18:00:00,02/09/2022 17:00:00,02/09/2022 17:00:00,EXPIRED,LONG,20375.0,19801.0,20831.4,0.0,0.02,2.19,0.0,45.64,2,0.0,-57.4
29/01/2020 02:00:00,16/06/2023 15:50:24,Gemini_BTCUSD_1h_17_12_17_to_10_03_23.csv,BTC_USD,HOUR,101429.36,0.218,29/01/2020 03:00:00,29/01/2020 05:00:00,29/01/2020 05:00:00,EXPIRED,LONG,9325.0,9355.0,9974.66,0.0,0.02,6.51,0.0,141.63,2,0.1,6.54
25/02/2019 08:00:00,16/06/2023 15:50:24,Gemini_BTCUSD_1h_17_12_17_to_10_03_23.csv,BTC_USD,HOUR,101435.9,0.538,25/02/2019 09:00:00,25/02/2019 11:00:00,25/02/2019 11:00:00,EXPIRED,LONG,3773.0,3781.0,3854.76,0.0,0.02,2.12,0.0,43.99,2,0.0,4.3
14/02/2018 15:00:00,16/06/2023 15:50:24,Gemini_BTCUSD_1h_17_12_17_to_10_03_23.csv,BTC_USD,HOUR,101440.2,0.217,14/02/2018 16:00:00,14/02/2018 18:00:00,14/02/2018 18:00:00,EXPIRED,LONG,9347.0,9299.0,10017.2,0.0,0.02,6.69,0.0,145.43,2,0.1,-10.42
18/12/2019 14:00:00,16/06/2023 15:50:24,Gemini_BTCUSD_1h_17_12_17_to_10_03_23.csv,BTC_USD,HOUR,101429.78,0.303,18/12/2019 15:00:00,18/12/2019 17:00:00,18/12/2019 16:00:00,TAKE_PROFIT_HIT,LONG,6694.0,6874.3,6874.3,0.0,0.02,2.62,0.0,54.63,2,0.0,54.63
07/07/2021 06:00:00,16/06/2023 15:50:24,Gemini_BTCUSD_1h_17_12_17_to_10_03_23.csv,BTC_USD,HOUR,101484.41,0.058,07/07/2021 08:00:00,07/07/2021 09:00:00,07/07/2021 09:00:00,EXPIRED,LONG,34726.0,34714.0,37526.4,0.0,0.02,7.46,0.0,162.42,2,0.1,-0.7
13/06/2022 18:00:00,16/06/2023 15:50:24,Gemini_BTCUSD_1h_17_12_17_to_10_03_23.csv,BTC_USD,HOUR,101483.71,0.087,13/06/2022 21:00:00,13/06/2022 21:00:00,13/06/2022 21:00:00,EXPIRED,LONG,23345.0,23029.0,25066.11,0.0,0.02,6.87,0.0,149.74,2,0.1,-27.49
14/08/2020 22:00:00,16/06/2023 15:50:24,Gemini_BTCUSD_1h_17_12_17_to_10_03_23.csv,BTC_USD,HOUR,101456.22,0.172,14/08/2020 23:00:00,15/08/2020 01:00:00,15/08/2020 01:00:00,EXPIRED,LONG,11795.0,11938.0,12082.14,0.0,0.02,2.38,0.0,49.39,2,0.0,24.6
06/07/2022 11:00:00,16/06/2023 15:50:24,Gemini_BTCUSD_1h_17_12_17_to_10_03_23.csv,BTC_USD,HOUR,101480.82,0.101,06/07/2022 12:00:00,06/07/2022 14:00:00,06/07/2022 14:00:00,EXPIRED,LONG,20080.0,20193.0,20835.65,0.0,0.02,3.63,0.0,76.32,2,0.0,11.41
24/09/2018 20:00:00,16/06/2023 15:50:24,Gemini_BTCUSD_1h_17_12_17_to_10_03_23.csv,BTC_USD,HOUR,101492.23,0.306,24/09/2018 21:00:00,24/09/2018 23:00:00,24/09/2018 23:00:00,EXPIRED,LONG,6623.0,6578.0,6902.86,0.0,0.02,4.05,0.0,85.64,2,0.0,-13.77
02/02/2021 19:00:00,16/06/2023 15:50:24,Gemini_BTCUSD_1h_17_12_17_to_10_03_23.csv,BTC_USD,HOUR,101478.46,0.057,02/02/2021 20:00:00,02/02/2021 22:00:00,02/02/2021 22:00:00,EXPIRED,LONG,35801.0,35621.0,38760.86,0.0,0.02,7.64,0.0,168.71,2,0.1,-10.26
08/09/2018 06:00:00,16/06/2023 15:50:24,Gemini_BTCUSD_1h_17_12_17_to_10_03_23.csv,BTC_USD,HOUR,101468.2,0.315,08/09/2018 07:00:00,08/09/2018 09:00:00,08/09/2018 09:00:00,EXPIRED,LONG,6440.0,6456.0,6685.32,0.0,0.02,3.67,0.0,77.28,2,0.0,5.04
27/03/2022 12:00:00,16/06/2023 15:50:24,Gemini_BTCUSD_1h_17_12_17_to_10_03_23.csv,BTC_USD,HOUR,101473.24,0.046,27/03/2022 13:00:00,27/03/2022 15:00:00,27/03/2022 15:00:00,EXPIRED,LONG,44463.0,44889.0,45473.09,0.0,0.02,2.22,0.0,46.46,2,0.0,19.6
23/03/2018 11:00:00,16/06/2023 15:50:24,Gemini_BTCUSD_1h_17_12_17_to_10_03_23.csv,BTC_USD,HOUR,101492.84,0.238,23/03/2018 12:00:00,23/03/2018 14:00:00,23/03/2018 14:00:00,EXPIRED,LONG,8514.0,8592.0,9249.19,0.0,0.02,7.95,0.0,174.98,2,0.1,18.56
12/12/2021 19:00:00,16/06/2023 15:50:24,Gemini_BTCUSD_1h_17_12_17_to_10_03_23.csv,BTC_USD,HOUR,101511.4,0.04,12/12/2021 20:00:00,12/12/2021 22:00:00,12/12/2021 22:00:00,EXPIRED,LONG,50244.0,50315.0,53274.69,0.0,0.02,5.69,0.0,121.23,2,0.1,2.84
26/07/2021 01:00:00,16/06/2023 15:50:24,Gemini_BTCUSD_1h_17_12_17_to_10_03_23.csv,BTC_USD,HOUR,101514.24,0.053,26/07/2021 02:00:00,26/07/2021 04:00:00,26/07/2021 04:00:00,EXPIRED,LONG,38346.0,38330.0,41135.3,0.0,0.02,6.78,0.0,147.83,2,0.1,-0.85
12/06/2021 12:00:00,16/06/2023 15:50:24,Gemini_BTCUSD_1h_17_12_17_to_10_03_23.csv,BTC_USD,HOUR,101513.39,0.056,12/06/2021 13:00:00,12/06/2021 15:00:00,12/06/2021 15:00:00,EXPIRED,LONG,36030.0,35424.0,37952.3,0.0,0.02,5.07,0.0,107.65,2,0.1,-33.94
01/03/2022 00:00:00,16/06/2023 15:50:24,Gemini_BTCUSD_1h_17_12_17_to_10_03_23.csv,BTC_USD,HOUR,101479.45,0.047,01/03/2022 01:00:00,01/03/2022 03:00:00,01/03/2022 03:00:00,EXPIRED,LONG,43586.0,43174.0,45939.39,0.0,0.02,5.12,0.0,110.61,2,0.1,-19.36
26/05/2021 05:00:00,16/06/2023 15:50:24,Gemini_BTCUSD_1h_17_12_17_to_10_03_23.csv,BTC_USD,HOUR,101460.09,0.052,26/05/2021 07:00:00,26/05/2021 08:00:00,26/05/2021 08:00:00,TAKE_PROFIT_HIT,LONG,39256.0,40843.79,40843.79,0.0,0.02,3.89,0.0,82.57,2,0.0,82.57
28/02/2021 11:00:00,16/06/2023 15:50:24,Gemini_BTCUSD_1h_17_12_17_to_10_03_23.csv,BTC_USD,HOUR,101542.66,0.045,28/02/2021 12:00:00,28/02/2021 14:00:00,28/02/2021 14:00:00,EXPIRED,LONG,45301.0,44596.0,49321.48,0.0,0.02,8.15,0.0,180.92,2,0.1,-31.72
02/10/2021 21:00:00,16/06/2023 15:50:24,Gemini_BTCUSD_1h_17_12_17_to_10_03_23.csv,BTC_USD,HOUR,101510.94,0.042,02/10/2021 23:00:00,03/10/2021 00:00:00,03/10/2021 00:00:00,EXPIRED,LONG,48153.0,47325.0,50059.86,0.0,0.02,3.81,0.0,80.09,2,0.0,-34.78
23/10/2018 23:00:00,16/06/2023 15:50:24,Gemini_BTCUSD_1h_17_12_17_to_10_03_23.csv,BTC_USD,HOUR,101476.16,0.317,24/10/2018 00:00:00,24/10/2018 02:00:00,24/10/2018 02:00:00,EXPIRED,LONG,6395.0,6400.0,6733.37,0.0,0.02,5.03,0.0,107.26,2,0.1,1.59
06/11/2021 02:00:00,16/06/2023 15:50:24,Gemini_BTCUSD_1h_17_12_17_to_10_03_23.csv,BTC_USD,HOUR,101477.75,0.033,06/11/2021 03:00:00,06/11/2021 05:00:00,06/11/2021 05:00:00,EXPIRED,LONG,61039.0,61502.0,62903.47,0.0,0.02,2.96,0.0,61.53,2,0.0,15.28
28/07/2022 04:00:00,16/06/2023 15:50:24,Gemini_BTCUSD_1h_17_12_17_to_10_03_23.csv,BTC_USD,HOUR,101493.03,0.088,28/07/2022 06:00:00,28/07/2022 07:00:00,28/07/2022 07:00:00,EXPIRED,LONG,23079.0,22923.0,23661.43,0.0,0.02,2.46,0.0,51.25,2,0.0,-13.73
17/07/2021 14:00:00,16/06/2023 15:50:24,Gemini_BTCUSD_1h_17_12_17_to_10_03_23.csv,BTC_USD,HOUR,101479.3,0.064,17/07/2021 18:00:00,17/07/2021 17:00:00,17/07/2021 17:00:00,EXPIRED,LONG,31650.0,31742.0,34381.48,0.0,0.02,7.94,0.0,174.81,2,0.1,5.89
30/03/2020 15:00:00,16/06/2023 15:50:24,Gemini_BTCUSD_1h_17_12_17_to_10_03_23.csv,BTC_USD,HOUR,101485.19,0.319,30/03/2020 16:00:00,30/03/2020 18:00:00,30/03/2020 18:00:00,EXPIRED,LONG,6359.0,6384.0,6619.36,0.0,0.02,3.93,0.0,83.05,2,0.0,7.98
03/07/2021 00:00:00,16/06/2023 15:50:24,Gemini_BTCUSD_1h_17_12_17_to_10_03_23.csv,BTC_USD,HOUR,101493.17,0.061,03/07/2021 02:00:00,03/07/2021 03:00:00,03/07/2021 03:00:00,EXPIRED,LONG,33541.0,33540.0,34440.18,0.0,0.02,2.61,0.0,54.85,2,0.0,-0.06
27/04/2022 03:00:00,16/06/2023 15:50:24,Gemini_BTCUSD_1h_17_12_17_to_10_03_23.csv,BTC_USD,HOUR,101493.11,0.053,27/04/2022 04:00:00,27/04/2022 06:00:00,27/04/2022 06:00:00,EXPIRED,LONG,38345.0,38648.0,39674.33,0.0,0.02,3.35,0.0,70.45,2,0.0,16.06
05/07/2022 02:00:00,16/06/2023 15:50:24,Gemini_BTCUSD_1h_17_12_17_to_10_03_23.csv,BTC_USD,HOUR,101509.17,0.101,05/07/2022 04:00:00,05/07/2022 05:00:00,05/07/2022 05:00:00,EXPIRED,LONG,20160.0,20271.0,21671.27,0.0,0.02,6.97,0.0,152.64,2,0.1,11.21
06/01/2022 14:00:00,16/06/2023 15:50:24,Gemini_BTCUSD_1h_17_12_17_to_10_03_23.csv,BTC_USD,HOUR,101520.38,0.047,06/01/2022 15:00:00,06/01/2022 17:00:00,06/01/2022 17:00:00,EXPIRED,LONG,42793.0,43018.0,46153.97,0.0,0.02,7.28,0.0,157.97,2,0.1,10.58
24/01/2019 10:00:00,16/06/2023 15:50:24,Gemini_BTCUSD_1h_17_12_17_to_10_03_23.csv,BTC_USD,HOUR,101530.96,0.574,24/01/2019 11:00:00,24/01/2019 13:00:00,24/01/2019 13:00:00,EXPIRED,LONG,3540.0,3560.0,3805.7,0.0,0.02,6.98,0.0,152.51,2,0.1,11.48
11/10/2018 17:00:00,16/06/2023 15:50:24,Gemini_BTCUSD_1h_17_12_17_to_10_03_23.csv,BTC_USD,HOUR,101542.44,0.327,11/10/2018 18:00:00,11/10/2018 20:00:00,11/10/2018 20:00:00,EXPIRED,LONG,6212.0,6209.0,6357.53,0.0,0.02,2.29,0.0,47.59,2,0.0,-0.98
07/05/2021 04:00:00,16/06/2023 15:50:24,Gemini_BTCUSD_1h_17_12_17_to_10_03_23.csv,BTC_USD,HOUR,101541.46,0.036,07/05/2021 05:00:00,07/05/2021 07:00:00,07/05/2021 07:00:00,EXPIRED,LONG,55892.0,55829.0,57904.12,0.0,0.02,3.47,0.0,72.44,2,0.0,-2.27
24/10/2022 00:00:00,16/06/2023 15:50:24,Gemini_BTCUSD_1h_17_12_17_to_10_03_23.csv,BTC_USD,HOUR,101539.19,0.104,24/10/2022 01:00:00,24/10/2022 03:00:00,24/10/2022 03:00:00,EXPIRED,LONG,19523.0,19387.0,19987.65,0.0,0.02,2.32,0.0,48.32,2,0.0,-14.14
03/04/2019 04:00:00,16/06/2023 15:50:24,Gemini_BTCUSD_1h_17_12_17_to_10_03_23.csv,BTC_USD,HOUR,101525.05,0.413,03/04/2019 06:00:00,03/04/2019 07:00:00,03/04/2019 07:00:00,EXPIRED,LONG,4916.0,4963.0,5105.06,0.0,0.02,3.7,0.0,78.08,2,0.0,19.41
16/01/2022 14:00:00,16/06/2023 15:50:24,Gemini_BTCUSD_1h_17_12_17_to_10_03_23.csv,BTC_USD,HOUR,101544.46,0.047,16/01/2022 15:00:00,16/01/2022 17:00:00,16/01/2022 17:00:00,EXPIRED,LONG,43343.0,43099.0,45906.21,0.0,0.02,5.58,0.0,120.47,2,0.1,-11.47
07/04/2019 23:00:00,16/06/2023 15:50:24,Gemini_BTCUSD_1h_17_12_17_to_10_03_23.csv,BTC_USD,HOUR,101532.99,0.391,08/04/2019 00:00:00,08/04/2019 02:00:00,08/04/2019 02:00:00,EXPIRED,LONG,5196.0,5292.0,5422.07,0.0,0.02,4.17,0.0,88.39,2,0.0,37.54
25/03/2022 12:00:00,16/06/2023 15:50:24,Gemini_BTCUSD_1h_17_12_17_to_10_03_23.csv,BTC_USD,HOUR,101570.53,0.045,25/03/2022 13:00:00,25/03/2022 15:00:00,25/03/2022 15:00:00,EXPIRED,LONG,44870.0,44338.0,48683.68,0.0,0.02,7.83,0.0,171.62,2,0.1,-23.94
18/11/2022 13:00:00,16/06/2023 15:50:24,Gemini_BTCUSD_1h_17_12_17_to_10_03_23.csv,BTC_USD,HOUR,101546.59,0.121,18/11/2022 14:00:00,18/11/2022 16:00:00,18/11/2022 16:00:00,EXPIRED,LONG,16745.0,16653.0,18145.51,0.0,0.02,7.72,0.0,169.46,2,0.1,-11.13
05/05/2020 23:00:00,16/06/2023 15:50:24,Gemini_BTCUSD_1h_17_12_17_to_10_03_23.csv,BTC_USD,HOUR,101535.46,0.225,06/05/2020 00:00:00,06/05/2020 02:00:00,06/05/2020 02:00:00,EXPIRED,LONG,9024.0,8983.0,9721.89,0.0,0.02,7.18,0.0,157.03,2,0.1,-9.22
12/11/2019 07:00:00,16/06/2023 15:50:24,Gemini_BTCUSD_1h_17_12_17_to_10_03_23.csv,BTC_USD,HOUR,101526.24,0.232,12/11/2019 09:00:00,12/11/2019 10:00:00,12/11/2019 10:00:00,EXPIRED,LONG,8759.0,8733.0,9443.07,0.0,0.02,7.24,0.0,158.7,2,0.1,-6.03
12/10/2021 08:00:00,16/06/2023 15:50:24,Gemini_BTCUSD_1h_17_12_17_to_10_03_23.csv,BTC_USD,HOUR,101520.21,0.035,12/10/2021 09:00:00,12/10/2021 11:00:00,12/10/2021 11:00:00,EXPIRED,LONG,57502.0,57276.0,62330.13,0.0,0.02,7.75,0.0,168.98,2,0.1,-7.91
14/04/2021 07:00:00,16/06/2023 15:50:24,Gemini_BTCUSD_1h_17_12_17_to_10_03_23.csv,BTC_USD,HOUR,101512.3,0.032,14/04/2021 08:00:00,14/04/2021 10:00:00,14/04/2021 10:00:00,EXPIRED,LONG,64375.0,64159.0,70045.51,0.0,0.02,8.1,0.0,181.46,2,0.1,-6.91
17/01/2023 17:00:00,16/06/2023 15:50:24,Gemini_BTCUSD_1h_17_12_17_to_10_03_23.csv,BTC_USD,HOUR,101505.39,0.096,17/01/2023 18:00:00,17/01/2023 20:00:00,17/01/2023 20:00:00,EXPIRED,LONG,21225.0,21374.0,22780.26,0.0,0.02,6.83,0.0,149.3,2,0.1,14.3
01/01/2021 03:00:00,16/06/2023 15:50:24,Gemini_BTCUSD_1h_17_12_17_to_10_03_23.csv,BTC_USD,HOUR,101519.69,0.069,01/01/2021 05:00:00,01/01/2021 06:00:00,01/01/2021 06:00:00,EXPIRED,LONG,29364.0,29211.0,31061.56,0.0,0.02,5.47,0.0,117.13,2,0.1,-10.56
28/03/2018 09:00:00,16/06/2023 15:50:24,Gemini_BTCUSD_1h_17_12_17_to_10_03_23.csv,BTC_USD,HOUR,101509.13,0.251,28/03/2018 12:00:00,28/03/2018 12:00:00,28/03/2018 12:00:00,EXPIRED,LONG,8082.0,8018.0,8259.51,0.0,0.02,2.15,0.0,44.56,2,0.0,-16.06
26/01/2023 20:00:00,16/06/2023 15:50:24,Gemini_BTCUSD_1h_17_12_17_to_10_03_23.csv,BTC_USD,HOUR,101493.07,0.088,26/01/2023 22:00:00,26/01/2023 23:00:00,26/01/2023 23:00:00,EXPIRED,LONG,23112.0,23013.0,24181.49,0.0,0.02,4.42,0.0,94.12,2,0.0,-8.71
08/04/2019 05:00:00,16/06/2023 15:50:24,Gemini_BTCUSD_1h_17_12_17_to_10_03_23.csv,BTC_USD,HOUR,101484.36,0.384,08/04/2019 09:00:00,08/04/2019 08:00:00,08/04/2019 08:00:00,EXPIRED,LONG,5285.0,5234.0,5490.2,0.0,0.02,3.74,0.0,78.8,2,0.0,-19.58
04/07/2019 13:00:00,16/06/2023 15:50:24,Gemini_BTCUSD_1h_17_12_17_to_10_03_23.csv,BTC_USD,HOUR,101464.78,0.171,04/07/2019 14:00:00,04/07/2019 16:00:00,04/07/2019 16:00:00,EXPIRED,LONG,11872.0,11787.0,12563.78,0.0,0.02,5.51,0.0,118.29,2,0.1,-14.54
26/01/2022 13:00:00,16/06/2023 15:50:24,Gemini_BTCUSD_1h_17_12_17_to_10_03_23.csv,BTC_USD,HOUR,101450.24,0.053,26/01/2022 15:00:00,26/01/2022 16:00:00,26/01/2022 16:00:00,EXPIRED,LONG,38247.0,38309.0,41461.05,0.0,0.02,7.75,0.0,170.34,2,0.1,3.29
29/10/2020 22:00:00,16/06/2023 15:50:24,Gemini_BTCUSD_1h_17_12_17_to_10_03_23.csv,BTC_USD,HOUR,101453.53,0.151,30/10/2020 01:00:00,30/10/2020 01:00:00,30/10/2020 01:00:00,EXPIRED,LONG,13420.0,13581.0,13959.58,0.0,0.02,3.87,0.0,81.48,2,0.0,24.31
12/10/2022 09:00:00,16/06/2023 15:50:24,Gemini_BTCUSD_1h_17_12_17_to_10_03_23.csv,BTC_USD,HOUR,101477.84,0.106,12/10/2022 10:00:00,12/10/2022 12:00:00,12/10/2022 12:00:00,EXPIRED,LONG,19174.0,19074.0,20384.1,0.0,0.02,5.94,0.0,128.27,2,0.1,-10.6
26/05/2021 13:00:00,16/06/2023 15:50:24,Gemini_BTCUSD_1h_17_12_17_to_10_03_23.csv,BTC_USD,HOUR,101467.24,0.052,26/05/2021 15:00:00,26/05/2021 16:00:00,26/05/2021 16:00:00,EXPIRED,LONG,38914.0,38605.0,41492.94,0.0,0.02,6.22,0.0,134.1,2,0.1,-16.07
16/04/2022 23:00:00,16/06/2023 15:50:24,Gemini_BTCUSD_1h_17_12_17_to_10_03_23.csv,BTC_USD,HOUR,101451.17,0.05,17/04/2022 00:00:00,17/04/2022 02:00:00,17/04/2022 02:00:00,EXPIRED,LONG,40394.0,40197.0,42603.59,0.0,0.02,5.19,0.0,110.48,2,0.1,-9.85
15/01/2021 00:00:00,16/06/2023 15:50:24,Gemini_BTCUSD_1h_17_12_17_to_10_03_23.csv,BTC_USD,HOUR,101441.32,0.051,15/01/2021 03:00:00,15/01/2021 03:00:00,15/01/2021 03:00:00,EXPIRED,LONG,39430.0,38707.0,40322.63,0.0,0.02,2.21,0.0,45.52,2,0.0,-36.87
27/08/2020 16:00:00,16/06/2023 15:50:24,Gemini_BTCUSD_1h_17_12_17_to_10_03_23.csv,BTC_USD,HOUR,101404.45,0.18,27/08/2020 17:00:00,27/08/2020 19:00:00,27/08/2020 19:00:00,EXPIRED,LONG,11279.0,11255.0,12127.04,0.0,0.02,6.99,0.0,152.65,2,0.1,-4.32
25/07/2022 21:00:00,16/06/2023 15:50:24,Gemini_BTCUSD_1h_17_12_17_to_10_03_23.csv,BTC_USD,HOUR,101400.13,0.092,25/07/2022 22:00:00,26/07/2022 00:00:00,26/07/2022 00:00:00,EXPIRED,LONG,22024.0,20997.0,23509.62,0.0,0.02,6.32,0.0,136.68,2,0.1,-94.48
25/11/2018 15:00:00,16/06/2023 15:50:24,Gemini_BTCUSD_1h_17_12_17_to_10_03_23.csv,BTC_USD,HOUR,101305.65,0.543,25/11/2018 16:00:00,25/11/2018 18:00:00,25/11/2018 18:00:00,EXPIRED,LONG,3730.0,3704.0,3884.16,0.0,0.02,3.97,0.0,83.71,2,0.0,-14.12
17/05/2022 14:00:00,16/06/2023 15:50:24,Gemini_BTCUSD_1h_17_12_17_to_10_03_23.csv,BTC_USD,HOUR,101291.53,0.067,17/05/2022 18:00:00,17/05/2022 17:00:00,17/05/2022 17:00:00,EXPIRED,LONG,30033.0,30060.0,30825.87,0.0,0.02,2.57,0.0,53.12,2,0.0,1.81
27/07/2020 10:00:00,16/06/2023 15:50:24,Gemini_BTCUSD_1h_17_12_17_to_10_03_23.csv,BTC_USD,HOUR,101293.34,0.197,27/07/2020 11:00:00,27/07/2020 13:00:00,27/07/2020 13:00:00,EXPIRED,LONG,10274.0,10374.0,10552.08,0.0,0.02,2.64,0.0,54.78,2,0.0,19.7
14/03/2022 16:00:00,16/06/2023 15:50:24,Gemini_BTCUSD_1h_17_12_17_to_10_03_23.csv,BTC_USD,HOUR,101313.04,0.052,14/03/2022 18:00:00,14/03/2022 19:00:00,14/03/2022 19:00:00,EXPIRED,LONG,38841.0,38805.0,40803.84,0.0,0.02,4.81,0.0,102.07,2,0.1,-1.87
08/05/2019 10:00:00,16/06/2023 15:50:24,Gemini_BTCUSD_1h_17_12_17_to_10_03_23.csv,BTC_USD,HOUR,101311.17,0.348,08/05/2019 11:00:00,08/05/2019 13:00:00,08/05/2019 13:00:00,EXPIRED,LONG,5830.0,5859.0,5976.68,0.0,0.02,2.45,0.0,51.04,2,0.0,10.09
31/07/2019 06:00:00,16/06/2023 15:50:24,Gemini_BTCUSD_1h_17_12_17_to_10_03_23.csv,BTC_USD,HOUR,101321.26,0.207,31/07/2019 10:00:00,31/07/2019 09:00:00,31/07/2019 09:00:00,EXPIRED,LONG,9770.0,9758.0,9980.36,0.0,0.02,2.11,0.0,43.54,2,0.0,-2.48
01/03/2019 21:00:00,16/06/2023 15:50:24,Gemini_BTCUSD_1h_17_12_17_to_10_03_23.csv,BTC_USD,HOUR,101318.78,0.529,02/03/2019 01:00:00,02/03/2019 00:00:00,02/03/2019 00:00:00,EXPIRED,LONG,3830.0,3810.0,3926.52,0.0,0.02,2.46,0.0,51.06,2,0.0,-10.58
08/03/2022 15:00:00,16/06/2023 15:50:24,Gemini_BTCUSD_1h_17_12_17_to_10_03_23.csv,BTC_USD,HOUR,101308.2,0.052,08/03/2022 17:00:00,08/03/2022 18:00:00,08/03/2022 18:00:00,EXPIRED,LONG,38647.0,38696.0,39468.4,0.0,0.02,2.08,0.0,42.71,2,0.0,2.55
18/11/2020 18:00:00,16/06/2023 15:50:24,Gemini_BTCUSD_1h_17_12_17_to_10_03_23.csv,BTC_USD,HOUR,101310.75,0.114,18/11/2020 19:00:00,18/11/2020 21:00:00,18/11/2020 21:00:00,EXPIRED,LONG,17803.0,17792.0,18274.68,0.0,0.02,2.58,0.0,53.77,2,0.0,-1.25
15/06/2019 04:00:00,16/06/2023 15:50:24,Gemini_BTCUSD_1h_17_12_17_to_10_03_23.csv,BTC_USD,HOUR,101309.5,0.234,15/06/2019 05:00:00,15/06/2019 07:00:00,15/06/2019 07:00:00,EXPIRED,LONG,8658.0,8710.0,8856.98,0.0,0.02,2.25,0.0,46.56,2,0.0,12.17
27/11/2021 11:00:00,16/06/2023 15:50:24,Gemini_BTCUSD_1h_17_12_17_to_10_03_23.csv,BTC_USD,HOUR,101321.67,0.037,27/11/2021 12:00:00,27/11/2021 14:00:00,27/11/2021 14:00:00,EXPIRED,LONG,54645.0,54757.0,58489.62,0.0,0.02,6.57,0.0,142.25,2,0.1,4.14
09/08/2018 16:00:00,16/06/2023 15:50:24,Gemini_BTCUSD_1h_17_12_17_to_10_03_23.csv,BTC_USD,HOUR,101325.81,0.314,09/08/2018 18:00:00,09/08/2018 19:00:00,09/08/2018 19:00:00,EXPIRED,LONG,6454.0,6475.0,6844.44,0.0,0.02,5.7,0.0,122.6,2,0.1,6.59
05/05/2021 15:00:00,16/06/2023 15:50:24,Gemini_BTCUSD_1h_17_12_17_to_10_03_23.csv,BTC_USD,HOUR,101332.4,0.035,05/05/2021 16:00:00,05/05/2021 18:00:00,05/05/2021 18:00:00,EXPIRED,LONG,57664.0,57372.0,60754.54,0.0,0.02,5.09,0.0,108.17,2,0.1,-10.22
20/10/2022 08:00:00,16/06/2023 15:50:24,Gemini_BTCUSD_1h_17_12_17_to_10_03_23.csv,BTC_USD,HOUR,101322.18,0.106,20/10/2022 11:00:00,20/10/2022 11:00:00,20/10/2022 11:00:00,EXPIRED,LONG,19114.0,19213.0,19536.01,0.0,0.02,2.16,0.0,44.73,2,0.0,10.49
28/09/2020 02:00:00,16/06/2023 15:50:24,Gemini_BTCUSD_1h_17_12_17_to_10_03_23.csv,BTC_USD,HOUR,101332.67,0.186,28/09/2020 03:00:00,28/09/2020 05:00:00,28/09/2020 05:00:00,EXPIRED,LONG,10915.0,10884.0,11362.73,0.0,0.02,3.94,0.0,83.28,2,0.0,-5.77
27/11/2018 19:00:00,16/06/2023 15:50:24,Gemini_BTCUSD_1h_17_12_17_to_10_03_23.csv,BTC_USD,HOUR,101326.9,0.545,27/11/2018 20:00:00,27/11/2018 22:00:00,27/11/2018 22:00:00,EXPIRED,LONG,3717.0,3799.0,3858.47,0.0,0.02,3.67,0.0,77.1,2,0.0,44.69
19/10/2020 17:00:00,16/06/2023 15:50:24,Gemini_BTCUSD_1h_17_12_17_to_10_03_23.csv,BTC_USD,HOUR,101371.59,0.173,19/10/2020 18:00:00,19/10/2020 20:00:00,19/10/2020 20:00:00,EXPIRED,LONG,11732.0,11740.0,12462.46,0.0,0.02,5.86,0.0,126.37,2,0.1,1.38
27/07/2022 14:00:00,16/06/2023 15:50:24,Gemini_BTCUSD_1h_17_12_17_to_10_03_23.csv,BTC_USD,HOUR,101372.97,0.094,27/07/2022 15:00:00,27/07/2022 17:00:00,27/07/2022 17:00:00,EXPIRED,LONG,21468.0,21635.0,23150.06,0.0,0.02,7.27,0.0,158.11,2,0.1,15.7
19/06/2020 06:00:00,16/06/2023 15:50:24,Gemini_BTCUSD_1h_17_12_17_to_10_03_23.csv,BTC_USD,HOUR,101388.67,0.218,19/06/2020 09:00:00,19/06/2020 09:00:00,19/06/2020 09:00:00,EXPIRED,LONG,9301.0,9357.0,9884.91,0.0,0.02,5.91,0.0,127.29,2,0.1,12.21
18/02/2021 02:00:00,16/06/2023 15:50:24,Gemini_BTCUSD_1h_17_12_17_to_10_03_23.csv,BTC_USD,HOUR,101400.88,0.039,18/02/2021 03:00:00,18/02/2021 05:00:00,18/02/2021 05:00:00,EXPIRED,LONG,52361.0,52224.0,55243.18,0.0,0.02,5.22,0.0,112.41,2,0.1,-5.34
02/09/2019 15:00:00,16/06/2023 15:50:24,Gemini_BTCUSD_1h_17_12_17_to_10_03_23.csv,BTC_USD,HOUR,101395.54,0.205,02/09/2019 16:00:00,02/09/2019 18:00:00,02/09/2019 18:00:00,EXPIRED,LONG,9905.0,10149.0,10619.19,0.0,0.02,6.73,0.0,146.41,2,0.1,50.02
23/06/2020 00:00:00,16/06/2023 15:50:24,Gemini_BTCUSD_1h_17_12_17_to_10_03_23.csv,BTC_USD,HOUR,101445.56,0.21,23/06/2020 01:00:00,23/06/2020 03:00:00,23/06/2020 03:00:00,EXPIRED,LONG,9662.0,9657.0,9887.45,0.0,0.02,2.28,0.0,47.34,2,0.0,-1.05
16/02/2018 23:00:00,16/06/2023 15:50:24,Gemini_BTCUSD_1h_17_12_17_to_10_03_23.csv,BTC_USD,HOUR,101444.51,0.199,17/02/2018 00:00:00,17/02/2018 02:00:00,17/02/2018 02:00:00,EXPIRED,LONG,10184.0,10375.0,11105.24,0.0,0.02,8.3,0.0,183.33,2,0.1,38.01
28/07/2019 15:00:00,16/06/2023 15:50:25,Gemini_BTCUSD_1h_17_12_17_to_10_03_23.csv,BTC_USD,HOUR,101482.52,0.213,28/07/2019 16:00:00,28/07/2019 18:00:00,28/07/2019 18:00:00,EXPIRED,LONG,9510.0,9529.0,9964.06,0.0,0.02,4.56,0.0,96.71,2,0.0,4.05
24/05/2021 21:00:00,16/06/2023 15:50:25,Gemini_BTCUSD_1h_17_12_17_to_10_03_23.csv,BTC_USD,HOUR,101486.57,0.053,24/05/2021 23:00:00,25/05/2021 00:00:00,25/05/2021 00:00:00,EXPIRED,LONG,38528.0,39474.0,39991.77,0.0,0.02,3.66,0.0,77.58,2,0.0,50.14
27/01/2021 21:00:00,16/06/2023 15:50:25,Gemini_BTCUSD_1h_17_12_17_to_10_03_23.csv,BTC_USD,HOUR,101536.71,0.065,27/01/2021 22:00:00,28/01/2021 00:00:00,28/01/2021 00:00:00,EXPIRED,LONG,31011.0,30744.0,32875.99,0.0,0.02,5.67,0.0,121.22,2,0.1,-17.35
10/04/2018 00:00:00,16/06/2023 15:50:25,Gemini_BTCUSD_1h_17_12_17_to_10_03_23.csv,BTC_USD,HOUR,101519.36,0.3,10/04/2018 01:00:00,10/04/2018 03:00:00,10/04/2018 03:00:00,EXPIRED,LONG,6770.0,6793.0,7054.42,0.0,0.02,4.03,0.0,85.33,2,0.0,6.9
24/07/2022 22:00:00,16/06/2023 15:50:25,Gemini_BTCUSD_1h_17_12_17_to_10_03_23.csv,BTC_USD,HOUR,101526.26,0.09,24/07/2022 23:00:00,25/07/2022 01:00:00,25/07/2022 01:00:00,EXPIRED,LONG,22668.0,22214.0,23588.43,0.0,0.02,3.9,0.0,82.84,2,0.0,-40.86
18/01/2021 08:00:00,16/06/2023 15:50:25,Gemini_BTCUSD_1h_17_12_17_to_10_03_23.csv,BTC_USD,HOUR,101485.4,0.056,18/01/2021 11:00:00,18/01/2021 11:00:00,18/01/2021 11:00:00,EXPIRED,LONG,36229.0,36416.0,38156.57,0.0,0.02,5.05,0.0,107.94,2,0.1,10.47
11/11/2019 19:00:00,16/06/2023 15:50:25,Gemini_BTCUSD_1h_17_12_17_to_10_03_23.csv,BTC_USD,HOUR,101495.87,0.232,11/11/2019 20:00:00,11/11/2019 22:00:00,11/11/2019 22:00:00,EXPIRED,LONG,8749.0,8702.0,9135.23,0.0,0.02,4.23,0.0,89.61,2,0.0,-10.9
09/09/2022 11:00:00,16/06/2023 15:50:25,Gemini_BTCUSD_1h_17_12_17_to_10_03_23.csv,BTC_USD,HOUR,101484.97,0.097,09/09/2022 12:00:00,09/09/2022 14:00:00,09/09/2022 14:00:00,EXPIRED,LONG,20948.0,21111.0,21387.43,0.0,0.02,2.05,0.0,42.62,2,0.0,15.81
23/02/2018 05:00:00,16/06/2023 15:50:25,Gemini_BTCUSD_1h_17_12_17_to_10_03_23.csv,BTC_USD,HOUR,101500.78,0.207,23/02/2018 09:00:00,23/02/2018 08:00:00,23/02/2018 08:00:00,EXPIRED,LONG,9829.0,9934.0,10114.12,0.0,0.02,2.82,0.0,59.02,2,0.0,21.74
26/04/2020 14:00:00,16/06/2023 15:50:25,Gemini_BTCUSD_1h_17_12_17_to_10_03_23.csv,BTC_USD,HOUR,101522.52,0.266,26/04/2020 15:00:00,26/04/2020 17:00:00,26/04/2020 17:00:00,EXPIRED,LONG,7647.0,7585.0,8078.11,0.0,0.02,5.34,0.0,114.68,2,0.1,-16.49
20/05/2022 02:00:00,16/06/2023 15:50:25,Gemini_BTCUSD_1h_17_12_17_to_10_03_23.csv,BTC_USD,HOUR,101506.03,0.067,20/05/2022 06:00:00,20/05/2022 05:00:00,20/05/2022 05:00:00,EXPIRED,LONG,30299.0,30157.0,31747.11,0.0,0.02,4.56,0.0,97.02,2,0.0,-9.51
17/04/2019 11:00:00,16/06/2023 15:50:25,Gemini_BTCUSD_1h_17_12_17_to_10_03_23.csv,BTC_USD,HOUR,101496.52,0.387,17/04/2019 13:00:00,17/04/2019 14:00:00,17/04/2019 14:00:00,EXPIRED,LONG,5245.0,5212.0,5645.77,0.0,0.02,7.1,0.0,155.1,2,0.1,-12.77
25/06/2019 02:00:00,16/06/2023 15:50:25,Gemini_BTCUSD_1h_17_12_17_to_10_03_23.csv,BTC_USD,HOUR,101483.75,0.182,25/06/2019 03:00:00,25/06/2019 05:00:00,25/06/2019 05:00:00,EXPIRED,LONG,11129.0,11303.0,11889.71,0.0,0.02,6.4,0.0,138.45,2,0.1,31.67
22/07/2020 16:00:00,16/06/2023 15:50:25,Gemini_BTCUSD_1h_17_12_17_to_10_03_23.csv,BTC_USD,HOUR,101515.42,0.217,22/07/2020 19:00:00,22/07/2020 19:00:00,22/07/2020 19:00:00,EXPIRED,LONG,9341.0,9379.0,9690.79,0.0,0.02,3.61,0.0,75.9,2,0.0,8.25
23/12/2021 07:00:00,16/06/2023 15:50:25,Gemini_BTCUSD_1h_17_12_17_to_10_03_23.csv,BTC_USD,HOUR,101523.67,0.042,23/12/2021 11:00:00,23/12/2021 10:00:00,23/12/2021 10:00:00,EXPIRED,LONG,48148.0,48446.0,49183.7,0.0,0.02,2.11,0.0,43.5,2,0.0,12.52
24/01/2023 16:00:00,16/06/2023 15:50:25,Gemini_BTCUSD_1h_17_12_17_to_10_03_23.csv,BTC_USD,HOUR,101536.19,0.089,24/01/2023 20:00:00,24/01/2023 19:00:00,24/01/2023 19:00:00,EXPIRED,LONG,22883.0,23028.0,24210.27,0.0,0.02,5.48,0.0,118.13,2,0.1,12.91
02/10/2019 02:00:00,16/06/2023 15:50:25,Gemini_BTCUSD_1h_17_12_17_to_10_03_23.csv,BTC_USD,HOUR,101549.1,0.246,02/10/2019 03:00:00,02/10/2019 05:00:00,02/10/2019 05:00:00,EXPIRED,LONG,8272.0,8189.0,8464.42,0.0,0.02,2.27,0.0,47.34,2,0.0,-20.42
19/03/2021 17:00:00,16/06/2023 15:50:25,Gemini_BTCUSD_1h_17_12_17_to_10_03_23.csv,BTC_USD,HOUR,101528.68,0.034,19/03/2021 20:00:00,19/03/2021 20:00:00,19/03/2021 20:00:00,EXPIRED,LONG,58918.0,58437.0,61186.06,0.0,0.02,3.71,0.0,77.11,2,0.0,-16.35
06/11/2020 22:00:00,16/06/2023 15:50:25,Gemini_BTCUSD_1h_17_12_17_to_10_03_23.csv,BTC_USD,HOUR,101512.33,0.13,07/11/2020 02:00:00,07/11/2020 01:00:00,07/11/2020 01:00:00,EXPIRED,LONG,15618.0,15713.0,16198.19,0.0,0.02,3.58,0.0,75.42,2,0.0,12.35
16/05/2020 23:00:00,16/06/2023 15:50:25,Gemini_BTCUSD_1h_17_12_17_to_10_03_23.csv,BTC_USD,HOUR,101524.68,0.216,17/05/2020 00:00:00,17/05/2020 02:00:00,17/05/2020 02:00:00,EXPIRED,LONG,9390.0,9522.0,10214.39,0.0,0.02,8.07,0.0,178.07,2,0.1,28.51
31/10/2019 18:00:00,16/06/2023 15:50:25,Gemini_BTCUSD_1h_17_12_17_to_10_03_23.csv,BTC_USD,HOUR,101553.19,0.22,31/10/2019 19:00:00,31/10/2019 21:00:00,31/10/2019 21:00:00,EXPIRED,LONG,9245.0,9140.0,9465.53,0.0,0.02,2.33,0.0,48.52,2,0.0,-23.1
15/01/2020 23:00:00,16/06/2023 15:50:25,Gemini_BTCUSD_1h_17_12_17_to_10_03_23.csv,BTC_USD,HOUR,101530.09,0.23,16/01/2020 00:00:00,16/01/2020 02:00:00,16/01/2020 02:00:00,EXPIRED,LONG,8814.0,8640.0,9537.59,0.0,0.02,7.59,0.0,166.43,2,0.1,-40.02
13/10/2019 04:00:00,16/06/2023 15:50:25,Gemini_BTCUSD_1h_17_12_17_to_10_03_23.csv,BTC_USD,HOUR,101490.07,0.243,13/10/2019 08:00:00,13/10/2019 07:00:00,13/10/2019 07:00:00,EXPIRED,LONG,8344.0,8333.0,8744.87,0.0,0.02,4.58,0.0,97.41,2,0.0,-2.67
15/12/2018 21:00:00,16/06/2023 15:50:25,Gemini_BTCUSD_1h_17_12_17_to_10_03_23.csv,BTC_USD,HOUR,101487.4,0.634,15/12/2018 22:00:00,16/12/2018 00:00:00,16/12/2018 00:00:00,EXPIRED,LONG,3204.0,3184.0,3407.5,0.0,0.02,5.97,0.0,129.02,2,0.1,-12.68
31/05/2018 08:00:00,16/06/2023 15:50:25,Gemini_BTCUSD_1h_17_12_17_to_10_03_23.csv,BTC_USD,HOUR,101474.72,0.269,31/05/2018 09:00:00,31/05/2018 11:00:00,31/05/2018 11:00:00,EXPIRED,LONG,7542.0,7537.0,7999.51,0.0,0.02,5.72,0.0,123.07,2,0.1,-1.35
28/12/2018 13:00:00,16/06/2023 15:50:25,Gemini_BTCUSD_1h_17_12_17_to_10_03_23.csv,BTC_USD,HOUR,101473.37,0.562,28/12/2018 17:00:00,28/12/2018 16:00:00,28/12/2018 15:00:00,TAKE_PROFIT_HIT,LONG,3612.0,3749.5,3749.5,0.0,0.02,3.67,0.0,77.28,2,0.0,77.28
14/03/2022 13:00:00,16/06/2023 15:50:25,Gemini_BTCUSD_1h_17_12_17_to_10_03_23.csv,BTC_USD,HOUR,101550.65,0.052,14/03/2022 14:00:00,14/03/2022 16:00:00,14/03/2022 16:00:00,EXPIRED,LONG,38888.0,38841.0,39781.72,0.0,0.02,2.25,0.0,46.47,2,0.0,-2.44
22/03/2021 05:00:00,16/06/2023 15:50:25,Gemini_BTCUSD_1h_17_12_17_to_10_03_23.csv,BTC_USD,HOUR,101548.21,0.035,22/03/2021 07:00:00,22/03/2021 08:00:00,22/03/2021 08:00:00,EXPIRED,LONG,57608.0,57219.0,58993.69,0.0,0.02,2.35,0.0,48.5,2,0.0,-13.62
22/01/2023 18:00:00,16/06/2023 15:50:25,Gemini_BTCUSD_1h_17_12_17_to_10_03_23.csv,BTC_USD,HOUR,101534.59,0.089,22/01/2023 22:00:00,22/01/2023 21:00:00,22/01/2023 21:00:00,EXPIRED,LONG,22844.0,22597.0,24207.0,0.0,0.02,5.63,0.0,121.31,2,0.1,-21.98
05/08/2019 14:00:00,16/06/2023 15:50:25,Gemini_BTCUSD_1h_17_12_17_to_10_03_23.csv,BTC_USD,HOUR,101512.61,0.172,05/08/2019 15:00:00,05/08/2019 17:00:00,05/08/2019 17:00:00,EXPIRED,LONG,11790.0,11793.0,12501.38,0.0,0.02,5.69,0.0,122.36,2,0.1,0.52
18/10/2022 02:00:00,16/06/2023 15:50:25,Gemini_BTCUSD_1h_17_12_17_to_10_03_23.csv,BTC_USD,HOUR,101513.13,0.104,18/10/2022 03:00:00,18/10/2022 05:00:00,18/10/2022 05:00:00,EXPIRED,LONG,19490.0,19561.0,21247.03,0.0,0.02,8.27,0.0,182.73,2,0.1,7.38
31/10/2020 09:00:00,16/06/2023 15:50:25,Gemini_BTCUSD_1h_17_12_17_to_10_03_23.csv,BTC_USD,HOUR,101520.51,0.146,31/10/2020 10:00:00,31/10/2020 12:00:00,31/10/2020 10:00:00,TAKE_PROFIT_HIT,LONG,13908.0,13911.13,13911.13,0.0,0.02,0.02,0.0,0.46,2,0.0,0.46
01/05/2019 03:00:00,16/06/2023 15:50:25,Gemini_BTCUSD_1h_17_12_17_to_10_03_23.csv,BTC_USD,HOUR,101520.97,0.382,01/05/2019 04:00:00,01/05/2019 06:00:00,01/05/2019 06:00:00,EXPIRED,LONG,5317.0,5323.0,5662.9,0.0,0.02,6.11,0.0,132.13,2,0.1,2.29
29/04/2020 03:00:00,16/06/2023 15:50:25,Gemini_BTCUSD_1h_17_12_17_to_10_03_23.csv,BTC_USD,HOUR,101523.26,0.259,29/04/2020 07:00:00,29/04/2020 06:00:00,29/04/2020 06:00:00,EXPIRED,LONG,7828.0,7961.0,8477.73,0.0,0.02,7.66,0.0,168.28,2,0.1,34.45
20/10/2019 19:00:00,16/06/2023 15:50:25,Gemini_BTCUSD_1h_17_12_17_to_10_03_23.csv,BTC_USD,HOUR,101557.71,0.247,20/10/2019 21:00:00,20/10/2019 22:00:00,20/10/2019 22:00:00,EXPIRED,LONG,8239.0,8212.0,8793.66,0.0,0.02,6.31,0.0,137.0,2,0.1,-6.67
16/09/2022 05:00:00,16/06/2023 15:50:25,Gemini_BTCUSD_1h_17_12_17_to_10_03_23.csv,BTC_USD,HOUR,101551.04,0.103,16/09/2022 06:00:00,16/09/2022 08:00:00,16/09/2022 08:00:00,EXPIRED,LONG,19751.0,19693.0,20163.95,0.0,0.02,2.05,0.0,42.53,2,0.0,-5.97
21/05/2018 23:00:00,16/06/2023 15:50:25,Gemini_BTCUSD_1h_17_12_17_to_10_03_23.csv,BTC_USD,HOUR,101545.07,0.242,22/05/2018 01:00:00,22/05/2018 02:00:00,22/05/2018 02:00:00,EXPIRED,LONG,8396.0,8301.0,8730.42,0.0,0.02,3.83,0.0,80.93,2,0.0,-22.99
03/11/2022 03:00:00,16/06/2023 15:50:25,Gemini_BTCUSD_1h_17_12_17_to_10_03_23.csv,BTC_USD,HOUR,101522.08,0.1,03/11/2022 07:00:00,03/11/2022 06:00:00,03/11/2022 06:00:00,EXPIRED,LONG,20310.0,20311.0,20780.05,0.0,0.02,2.26,0.0,47.0,2,0.0,0.1
21/06/2022 01:00:00,16/06/2023 15:50:25,Gemini_BTCUSD_1h_17_12_17_to_10_03_23.csv,BTC_USD,HOUR,101522.18,0.098,21/06/2022 02:00:00,21/06/2022 04:00:00,21/06/2022 04:00:00,EXPIRED,LONG,20671.0,20621.0,22246.08,0.0,0.02,7.08,0.0,154.36,2,0.1,-4.9
16/07/2021 07:00:00,16/06/2023 15:50:25,Gemini_BTCUSD_1h_17_12_17_to_10_03_23.csv,BTC_USD,HOUR,101517.28,0.064,16/07/2021 11:00:00,16/07/2021 10:00:00,16/07/2021 10:00:00,EXPIRED,LONG,31805.0,31327.0,32554.63,0.0,0.02,2.3,0.0,47.98,2,0.0,-30.59
10/02/2023 08:00:00,16/06/2023 15:50:25,Gemini_BTCUSD_1h_17_12_17_to_10_03_23.csv,BTC_USD,HOUR,101486.69,0.093,10/02/2023 09:00:00,10/02/2023 11:00:00,10/02/2023 11:00:00,EXPIRED,LONG,21900.0,21739.0,23591.37,0.0,0.02,7.17,0.0,157.3,2,0.1,-14.97
23/02/2018 20:00:00,16/06/2023 15:50:25,Gemini_BTCUSD_1h_17_12_17_to_10_03_23.csv,BTC_USD,HOUR,101471.72,0.204,23/02/2018 21:00:00,23/02/2018 23:00:00,23/02/2018 23:00:00,EXPIRED,LONG,9970.0,10162.0,10365.66,0.0,0.02,3.82,0.0,80.71,2,0.0,39.17
05/03/2020 00:00:00,16/06/2023 15:50:25,Gemini_BTCUSD_1h_17_12_17_to_10_03_23.csv,BTC_USD,HOUR,101510.89,0.229,05/03/2020 01:00:00,05/03/2020 03:00:00,05/03/2020 03:00:00,EXPIRED,LONG,8865.0,8882.0,9458.86,0.0,0.02,6.28,0.0,135.99,2,0.1,3.89
20/03/2018 00:00:00,16/06/2023 15:50:25,Gemini_BTCUSD_1h_17_12_17_to_10_03_23.csv,BTC_USD,HOUR,101514.78,0.238,20/03/2018 01:00:00,20/03/2018 03:00:00,20/03/2018 03:00:00,EXPIRED,LONG,8515.0,8603.0,9233.34,0.0,0.02,7.78,0.0,170.96,2,0.1,20.94
07/04/2020 10:00:00,16/06/2023 15:50:25,Gemini_BTCUSD_1h_17_12_17_to_10_03_23.csv,BTC_USD,HOUR,101535.72,0.273,07/04/2020 11:00:00,07/04/2020 13:00:00,07/04/2020 13:00:00,EXPIRED,LONG,7441.0,7363.0,7867.13,0.0,0.02,5.42,0.0,116.33,2,0.1,-21.29
23/04/2022 14:00:00,16/06/2023 15:50:25,Gemini_BTCUSD_1h_17_12_17_to_10_03_23.csv,BTC_USD,HOUR,101514.43,0.051,23/04/2022 16:00:00,23/04/2022 17:00:00,23/04/2022 17:00:00,EXPIRED,LONG,39724.0,39830.0,42883.63,0.0,0.02,7.37,0.0,161.14,2,0.1,5.41
10/08/2019 21:00:00,16/06/2023 15:50:25,Gemini_BTCUSD_1h_17_12_17_to_10_03_23.csv,BTC_USD,HOUR,101519.84,0.18,10/08/2019 22:00:00,11/08/2019 00:00:00,11/08/2019 00:00:00,EXPIRED,LONG,11300.0,11375.0,11571.2,0.0,0.02,2.34,0.0,48.82,2,0.0,13.5
12/11/2022 09:00:00,16/06/2023 15:50:25,Gemini_BTCUSD_1h_17_12_17_to_10_03_23.csv,BTC_USD,HOUR,101533.34,0.121,12/11/2022 10:00:00,12/11/2022 12:00:00,12/11/2022 12:00:00,EXPIRED,LONG,16795.0,16755.0,17428.91,0.0,0.02,3.64,0.0,76.7,2,0.0,-4.84
13/06/2021 19:00:00,16/06/2023 15:50:25,Gemini_BTCUSD_1h_17_12_17_to_10_03_23.csv,BTC_USD,HOUR,101528.5,0.054,13/06/2021 21:00:00,13/06/2021 22:00:00,13/06/2021 20:00:00,TAKE_PROFIT_HIT,LONG,37676.0,38573.43,38573.43,0.0,0.02,2.33,0.0,48.46,2,0.0,48.46
25/08/2022 08:00:00,16/06/2023 15:50:25,Gemini_BTCUSD_1h_17_12_17_to_10_03_23.csv,BTC_USD,HOUR,101576.96,0.094,25/08/2022 09:00:00,25/08/2022 11:00:00,25/08/2022 11:00:00,EXPIRED,LONG,21697.0,21725.0,23353.1,0.0,0.02,7.09,0.0,155.67,2,0.1,2.63
06/11/2020 00:00:00,16/06/2023 15:50:25,Gemini_BTCUSD_1h_17_12_17_to_10_03_23.csv,BTC_USD,HOUR,101579.59,0.128,06/11/2020 02:00:00,06/11/2020 03:00:00,06/11/2020 03:00:00,EXPIRED,LONG,15871.0,15464.0,16346.78,0.0,0.02,2.91,0.0,60.9,2,0.0,-52.1
19/12/2018 09:00:00,16/06/2023 15:50:25,Gemini_BTCUSD_1h_17_12_17_to_10_03_23.csv,BTC_USD,HOUR,101527.49,0.544,19/12/2018 10:00:00,19/12/2018 12:00:00,19/12/2018 12:00:00,EXPIRED,LONG,3734.0,3827.0,3876.17,0.0,0.02,3.67,0.0,77.34,2,0.0,50.59
08/08/2020 01:00:00,16/06/2023 15:50:25,Gemini_BTCUSD_1h_17_12_17_to_10_03_23.csv,BTC_USD,HOUR,101578.08,0.174,08/08/2020 02:00:00,08/08/2020 04:00:00,08/08/2020 04:00:00,EXPIRED,LONG,11650.0,11550.0,12307.3,0.0,0.02,5.34,0.0,114.37,2,0.1,-17.4
03/06/2021 07:00:00,16/06/2023 15:50:25,Gemini_BTCUSD_1h_17_12_17_to_10_03_23.csv,BTC_USD,HOUR,101560.68,0.053,03/06/2021 08:00:00,03/06/2021 10:00:00,03/06/2021 10:00:00,EXPIRED,LONG,38637.0,39289.0,40794.77,0.0,0.02,5.29,0.0,114.36,2,0.1,34.56
27/01/2020 21:00:00,16/06/2023 15:50:25,Gemini_BTCUSD_1h_17_12_17_to_10_03_23.csv,BTC_USD,HOUR,101595.24,0.227,27/01/2020 22:00:00,28/01/2020 00:00:00,28/01/2020 00:00:00,EXPIRED,LONG,8945.0,9053.0,9558.65,0.0,0.02,6.42,0.0,139.3,2,0.1,24.52
12/08/2022 16:00:00,16/06/2023 15:50:25,Gemini_BTCUSD_1h_17_12_17_to_10_03_23.csv,BTC_USD,HOUR,101619.76,0.085,12/08/2022 17:00:00,12/08/2022 19:00:00,12/08/2022 19:00:00,EXPIRED,LONG,23993.0,24199.0,26039.78,0.0,0.02,7.86,0.0,173.98,2,0.1,17.51
13/05/2020 23:00:00,16/06/2023 15:50:25,Gemini_BTCUSD_1h_17_12_17_to_10_03_23.csv,BTC_USD,HOUR,101637.27,0.218,14/05/2020 00:00:00,14/05/2020 02:00:00,14/05/2020 02:00:00,EXPIRED,LONG,9312.0,9345.0,9882.68,0.0,0.02,5.77,0.0,124.41,2,0.1,7.19
22/12/2018 10:00:00,16/06/2023 15:50:25,Gemini_BTCUSD_1h_17_12_17_to_10_03_23.csv,BTC_USD,HOUR,101644.46,0.521,22/12/2018 11:00:00,22/12/2018 13:00:00,22/12/2018 13:00:00,EXPIRED,LONG,3903.0,3833.0,4119.39,0.0,0.02,5.25,0.0,112.74,2,0.1,-36.47
05/09/2019 13:00:00,16/06/2023 15:50:25,Gemini_BTCUSD_1h_17_12_17_to_10_03_23.csv,BTC_USD,HOUR,101607.99,0.191,05/09/2019 14:00:00,05/09/2019 16:00:00,05/09/2019 16:00:00,EXPIRED,LONG,10614.0,10537.0,11139.52,0.0,0.02,4.72,0.0,100.37,2,0.0,-14.71
31/12/2018 11:00:00,16/06/2023 15:50:25,Gemini_BTCUSD_1h_17_12_17_to_10_03_23.csv,BTC_USD,HOUR,101593.28,0.543,31/12/2018 13:00:00,31/12/2018 14:00:00,31/12/2018 14:00:00,EXPIRED,LONG,3745.0,3782.0,3954.3,0.0,0.02,5.29,0.0,113.65,2,0.1,20.09
04/06/2020 00:00:00,16/06/2023 15:50:25,Gemini_BTCUSD_1h_17_12_17_to_10_03_23.csv,BTC_USD,HOUR,101613.37,0.211,04/06/2020 01:00:00,04/06/2020 03:00:00,04/06/2020 03:00:00,EXPIRED,LONG,9633.0,9673.0,10397.66,0.0,0.02,7.35,0.0,161.34,2,0.1,8.44
02/10/2021 14:00:00,16/06/2023 15:50:25,Gemini_BTCUSD_1h_17_12_17_to_10_03_23.csv,BTC_USD,HOUR,101621.81,0.042,02/10/2021 18:00:00,02/10/2021 17:00:00,02/10/2021 17:00:00,EXPIRED,LONG,48047.0,47906.0,50489.43,0.0,0.02,4.84,0.0,102.58,2,0.1,-5.92
24/02/2019 02:00:00,16/06/2023 15:50:25,Gemini_BTCUSD_1h_17_12_17_to_10_03_23.csv,BTC_USD,HOUR,101615.89,0.49,24/02/2019 03:00:00,24/02/2019 05:00:00,24/02/2019 05:00:00,EXPIRED,LONG,4148.0,4155.0,4254.09,0.0,0.02,2.49,0.0,51.98,2,0.0,3.43
01/04/2021 14:00:00,16/06/2023 15:50:25,Gemini_BTCUSD_1h_17_12_17_to_10_03_23.csv,BTC_USD,HOUR,101619.32,0.034,01/04/2021 18:00:00,01/04/2021 17:00:00,01/04/2021 17:00:00,EXPIRED,LONG,59032.0,58529.0,60326.97,0.0,0.02,2.15,0.0,44.03,2,0.0,-17.1
06/04/2020 11:00:00,16/06/2023 15:50:25,Gemini_BTCUSD_1h_17_12_17_to_10_03_23.csv,BTC_USD,HOUR,101602.22,0.286,06/04/2020 13:00:00,06/04/2020 14:00:00,06/04/2020 14:00:00,EXPIRED,LONG,7108.0,7111.0,7281.18,0.0,0.02,2.38,0.0,49.53,2,0.0,0.86
17/12/2019 05:00:00,16/06/2023 15:50:25,Gemini_BTCUSD_1h_17_12_17_to_10_03_23.csv,BTC_USD,HOUR,101603.08,0.295,17/12/2019 08:00:00,17/12/2019 08:00:00,17/12/2019 08:00:00,EXPIRED,LONG,6882.0,6869.0,7081.2,0.0,0.02,2.81,0.0,58.76,2,0.0,-3.83
08/03/2023 00:00:00,16/06/2023 15:50:25,Gemini_BTCUSD_1h_17_12_17_to_10_03_23.csv,BTC_USD,HOUR,101599.25,0.091,08/03/2023 04:00:00,08/03/2023 03:00:00,08/03/2023 03:00:00,EXPIRED,LONG,22243.0,22148.0,22742.86,0.0,0.02,2.2,0.0,45.49,2,0.0,-8.64
12/01/2023 05:00:00,16/06/2023 15:50:25,Gemini_BTCUSD_1h_17_12_17_to_10_03_23.csv,BTC_USD,HOUR,101590.61,0.112,12/01/2023 07:00:00,12/01/2023 08:00:00,12/01/2023 08:00:00,EXPIRED,LONG,18094.0,18138.0,18532.43,0.0,0.02,2.37,0.0,49.1,2,0.0,4.93
09/05/2021 02:00:00,16/06/2023 15:50:25,Gemini_BTCUSD_1h_17_12_17_to_10_03_23.csv,BTC_USD,HOUR,101595.54,0.035,09/05/2021 06:00:00,09/05/2021 05:00:00,09/05/2021 05:00:00,EXPIRED,LONG,58729.0,58516.0,60958.63,0.0,0.02,3.66,0.0,78.04,2,0.0,-7.46
16/03/2021 20:00:00,16/06/2023 15:50:25,Gemini_BTCUSD_1h_17_12_17_to_10_03_23.csv,BTC_USD,HOUR,101588.08,0.036,16/03/2021 21:00:00,16/03/2021 23:00:00,16/03/2021 23:00:00,EXPIRED,LONG,56370.0,56944.0,59864.55,0.0,0.02,5.84,0.0,125.8,2,0.1,20.66
27/04/2019 04:00:00,16/06/2023 15:50:25,Gemini_BTCUSD_1h_17_12_17_to_10_03_23.csv,BTC_USD,HOUR,101608.74,0.395,27/04/2019 05:00:00,27/04/2019 07:00:00,27/04/2019 07:00:00,EXPIRED,LONG,5139.0,5178.0,5387.93,0.0,0.02,4.62,0.0,98.33,2,0.0,15.41
26/07/2021 03:00:00,16/06/2023 15:50:25,Gemini_BTCUSD_1h_17_12_17_to_10_03_23.csv,BTC_USD,HOUR,101624.15,0.053,26/07/2021 05:00:00,26/07/2021 06:00:00,26/07/2021 06:00:00,TAKE_PROFIT_HIT,LONG,38313.0,39134.42,39134.42,0.0,0.02,2.1,0.0,43.54,2,0.0,43.54
19/01/2020 05:00:00,16/06/2023 15:50:25,Gemini_BTCUSD_1h_17_12_17_to_10_03_23.csv,BTC_USD,HOUR,101667.69,0.223,19/01/2020 06:00:00,19/01/2020 08:00:00,19/01/2020 08:00:00,EXPIRED,LONG,9112.0,9082.0,9335.99,0.0,0.02,2.4,0.0,49.95,2,0.0,-6.69
08/03/2022 10:00:00,16/06/2023 15:50:25,Gemini_BTCUSD_1h_17_12_17_to_10_03_23.csv,BTC_USD,HOUR,101661.0,0.052,08/03/2022 11:00:00,08/03/2022 13:00:00,08/03/2022 13:00:00,EXPIRED,LONG,39068.0,38872.0,42410.57,0.0,0.02,7.88,0.0,173.81,2,0.1,-10.19
13/03/2018 03:00:00,16/06/2023 15:50:25,Gemini_BTCUSD_1h_17_12_17_to_10_03_23.csv,BTC_USD,HOUR,101650.81,0.224,13/03/2018 04:00:00,13/03/2018 06:00:00,13/03/2018 04:00:00,TAKE_PROFIT_HIT,LONG,9062.0,9265.29,9265.29,0.0,0.02,2.19,0.0,45.54,2,0.0,45.54
27/06/2018 13:00:00,16/06/2023 15:50:25,Gemini_BTCUSD_1h_17_12_17_to_10_03_23.csv,BTC_USD,HOUR,101696.35,0.334,27/06/2018 14:00:00,27/06/2018 16:00:00,27/06/2018 16:00:00,EXPIRED,LONG,6087.0,6122.0,6540.76,0.0,0.02,6.94,0.0,151.56,2,0.1,11.69
30/04/2021 04:00:00,16/06/2023 15:50:25,Gemini_BTCUSD_1h_17_12_17_to_10_03_23.csv,BTC_USD,HOUR,101708.04,0.038,30/04/2021 07:00:00,30/04/2021 07:00:00,30/04/2021 07:00:00,EXPIRED,LONG,54195.0,54369.0,56540.66,0.0,0.02,4.15,0.0,89.14,2,0.0,6.61
15/03/2019 07:00:00,16/06/2023 15:50:25,Gemini_BTCUSD_1h_17_12_17_to_10_03_23.csv,BTC_USD,HOUR,101714.65,0.528,15/03/2019 08:00:00,15/03/2019 10:00:00,15/03/2019 10:00:00,EXPIRED,LONG,3854.0,3864.0,4000.58,0.0,0.02,3.66,0.0,77.39,2,0.0,5.28
15/02/2021 21:00:00,16/06/2023 15:50:25,Gemini_BTCUSD_1h_17_12_17_to_10_03_23.csv,BTC_USD,HOUR,101719.93,0.042,16/02/2021 00:00:00,16/02/2021 00:00:00,16/02/2021 00:00:00,EXPIRED,LONG,48191.0,47718.0,49440.45,0.0,0.02,2.53,0.0,52.48,2,0.0,-19.87
10/11/2020 14:00:00,16/06/2023 15:50:25,Gemini_BTCUSD_1h_17_12_17_to_10_03_23.csv,BTC_USD,HOUR,101700.06,0.133,10/11/2020 15:00:00,10/11/2020 17:00:00,10/11/2020 17:00:00,EXPIRED,LONG,15244.0,15324.0,15839.69,0.0,0.02,3.76,0.0,79.23,2,0.0,10.64
05/05/2019 11:00:00,16/06/2023 15:50:25,Gemini_BTCUSD_1h_17_12_17_to_10_03_23.csv,BTC_USD,HOUR,101710.7,0.356,05/05/2019 13:00:00,05/05/2019 14:00:00,05/05/2019 14:00:00,EXPIRED,LONG,5711.0,5723.0,5922.58,0.0,0.02,3.57,0.0,75.32,2,0.0,4.27
27/05/2020 20:00:00,16/06/2023 15:50:25,Gemini_BTCUSD_1h_17_12_17_to_10_03_23.csv,BTC_USD,HOUR,101714.97,0.222,27/05/2020 21:00:00,27/05/2020 23:00:00,27/05/2020 23:00:00,EXPIRED,LONG,9167.0,9210.0,9762.34,0.0,0.02,6.1,0.0,132.17,2,0.1,9.55
30/10/2018 18:00:00,16/06/2023 15:50:25,Gemini_BTCUSD_1h_17_12_17_to_10_03_23.csv,BTC_USD,HOUR,101724.52,0.325,30/10/2018 19:00:00,30/10/2018 21:00:00,30/10/2018 21:00:00,EXPIRED,LONG,6253.0,6269.0,6490.03,0.0,0.02,3.65,0.0,77.03,2,0.0,5.2
01/08/2019 23:00:00,16/06/2023 15:50:25,Gemini_BTCUSD_1h_17_12_17_to_10_03_23.csv,BTC_USD,HOUR,101729.72,0.195,02/08/2019 03:00:00,02/08/2019 02:00:00,02/08/2019 02:00:00,EXPIRED,LONG,10410.0,10397.0,10637.74,0.0,0.02,2.14,0.0,44.41,2,0.0,-2.53
03/03/2020 18:00:00,16/06/2023 15:50:25,Gemini_BTCUSD_1h_17_12_17_to_10_03_23.csv,BTC_USD,HOUR,101727.19,0.234,03/03/2020 19:00:00,03/03/2020 21:00:00,03/03/2020 21:00:00,EXPIRED,LONG,8713.0,8738.0,9066.96,0.0,0.02,3.9,0.0,82.83,2,0.0,5.85
07/09/2022 16:00:00,16/06/2023 15:50:25,Gemini_BTCUSD_1h_17_12_17_to_10_03_23.csv,BTC_USD,HOUR,101733.04,0.108,07/09/2022 17:00:00,07/09/2022 19:00:00,07/09/2022 19:00:00,EXPIRED,LONG,18922.0,19000.0,20640.7,0.0,0.02,8.33,0.0,185.62,2,0.1,8.42
10/01/2022 06:00:00,16/06/2023 15:50:25,Gemini_BTCUSD_1h_17_12_17_to_10_03_23.csv,BTC_USD,HOUR,101741.46,0.049,10/01/2022 07:00:00,10/01/2022 09:00:00,10/01/2022 09:00:00,EXPIRED,LONG,41953.0,41819.0,43066.66,0.0,0.02,2.59,0.0,54.57,2,0.0,-6.57
16/08/2019 16:00:00,16/06/2023 15:50:25,Gemini_BTCUSD_1h_17_12_17_to_10_03_23.csv,BTC_USD,HOUR,101734.89,0.195,16/08/2019 17:00:00,16/08/2019 19:00:00,16/08/2019 19:00:00,EXPIRED,LONG,10410.0,10469.0,10803.23,0.0,0.02,3.64,0.0,76.68,2,0.0,11.51
15/01/2020 16:00:00,16/06/2023 15:50:25,Gemini_BTCUSD_1h_17_12_17_to_10_03_23.csv,BTC_USD,HOUR,101746.4,0.232,15/01/2020 17:00:00,15/01/2020 19:00:00,15/01/2020 19:00:00,EXPIRED,LONG,8773.0,8752.0,9273.38,0.0,0.02,5.4,0.0,116.09,2,0.1,-4.87
03/12/2019 15:00:00,16/06/2023 15:50:25,Gemini_BTCUSD_1h_17_12_17_to_10_03_23.csv,BTC_USD,HOUR,101741.53,0.277,03/12/2019 16:00:00,03/12/2019 18:00:00,03/12/2019 18:00:00,EXPIRED,LONG,7341.0,7361.0,7960.11,0.0,0.02,7.78,0.0,171.49,2,0.1,5.54
01/03/2018 09:00:00,16/06/2023 15:50:25,Gemini_BTCUSD_1h_17_12_17_to_10_03_23.csv,BTC_USD,HOUR,101747.07,0.192,01/03/2018 10:00:00,01/03/2018 12:00:00,01/03/2018 12:00:00,EXPIRED,LONG,10593.0,10629.0,11066.14,0.0,0.02,4.28,0.0,90.84,2,0.0,6.91
27/02/2021 03:00:00,16/06/2023 15:50:25,Gemini_BTCUSD_1h_17_12_17_to_10_03_23.csv,BTC_USD,HOUR,101753.98,0.043,27/02/2021 04:00:00,27/02/2021 06:00:00,27/02/2021 06:00:00,EXPIRED,LONG,47440.0,47556.0,50593.79,0.0,0.02,6.23,0.0,135.61,2,0.1,4.99
05/09/2022 02:00:00,16/06/2023 15:50:25,Gemini_BTCUSD_1h_17_12_17_to_10_03_23.csv,BTC_USD,HOUR,101758.97,0.102,05/09/2022 03:00:00,05/09/2022 05:00:00,05/09/2022 05:00:00,EXPIRED,LONG,19856.0,19722.0,20371.49,0.0,0.02,2.53,0.0,52.58,2,0.0,-13.67
29/07/2019 01:00:00,16/06/2023 15:50:25,Gemini_BTCUSD_1h_17_12_17_to_10_03_23.csv,BTC_USD,HOUR,101745.3,0.21,29/07/2019 02:00:00,29/07/2019 04:00:00,29/07/2019 04:00:00,EXPIRED,LONG,9669.0,9637.0,10277.8,0.0,0.02,5.92,0.0,127.85,2,0.1,-6.72
12/11/2019 05:00:00,16/06/2023 15:50:25,Gemini_BTCUSD_1h_17_12_17_to_10_03_23.csv,BTC_USD,HOUR,101738.58,0.233,12/11/2019 06:00:00,12/11/2019 08:00:00,12/11/2019 08:00:00,EXPIRED,LONG,8736.0,8744.0,9150.51,0.0,0.02,4.53,0.0,96.58,2,0.0,1.86
20/04/2020 03:00:00,16/06/2023 15:50:25,Gemini_BTCUSD_1h_17_12_17_to_10_03_23.csv,BTC_USD,HOUR,101740.44,0.283,20/04/2020 04:00:00,20/04/2020 06:00:00,20/04/2020 06:00:00,EXPIRED,LONG,7180.0,7180.0,7444.36,0.0,0.02,3.55,0.0,74.81,2,0.0,0.0
12/04/2018 09:00:00,16/06/2023 15:50:25,Gemini_BTCUSD_1h_17_12_17_to_10_03_23.csv,BTC_USD,HOUR,101740.44,0.297,12/04/2018 12:00:00,12/04/2018 12:00:00,12/04/2018 11:00:00,TAKE_PROFIT_HIT,LONG,6857.0,7176.82,7176.82,0.0,0.02,4.46,0.0,94.99,2,0.0,94.99
21/05/2022 16:00:00,16/06/2023 15:50:25,Gemini_BTCUSD_1h_17_12_17_to_10_03_23.csv,BTC_USD,HOUR,101835.43,0.069,21/05/2022 18:00:00,21/05/2022 19:00:00,21/05/2022 19:00:00,EXPIRED,LONG,29533.0,29437.0,32228.9,0.0,0.02,8.36,0.0,186.02,2,0.1,-6.62
27/09/2019 12:00:00,16/06/2023 15:50:25,Gemini_BTCUSD_1h_17_12_17_to_10_03_23.csv,BTC_USD,HOUR,101828.81,0.255,27/09/2019 13:00:00,27/09/2019 15:00:00,27/09/2019 15:00:00,EXPIRED,LONG,7995.0,7992.0,8245.04,0.0,0.02,3.03,0.0,63.76,2,0.0,-0.76
18/08/2020 13:00:00,16/06/2023 15:50:25,Gemini_BTCUSD_1h_17_12_17_to_10_03_23.csv,BTC_USD,HOUR,101828.05,0.167,18/08/2020 14:00:00,18/08/2020 16:00:00,18/08/2020 16:00:00,EXPIRED,LONG,12171.0,11999.0,12555.68,0.0,0.02,3.06,0.0,64.24,2,0.0,-28.72
22/05/2022 20:00:00,16/06/2023 15:50:25,Gemini_BTCUSD_1h_17_12_17_to_10_03_23.csv,BTC_USD,HOUR,101799.33,0.068,22/05/2022 21:00:00,22/05/2022 23:00:00,22/05/2022 23:00:00,EXPIRED,LONG,29892.0,30263.0,30548.54,0.0,0.02,2.15,0.0,44.64,2,0.0,25.23
08/05/2019 15:00:00,16/06/2023 15:50:25,Gemini_BTCUSD_1h_17_12_17_to_10_03_23.csv,BTC_USD,HOUR,101824.56,0.346,08/05/2019 16:00:00,08/05/2019 18:00:00,08/05/2019 18:00:00,EXPIRED,LONG,5891.0,5884.0,6287.51,0.0,0.02,6.31,0.0,137.19,2,0.1,-2.42
12/02/2023 17:00:00,16/06/2023 15:50:25,Gemini_BTCUSD_1h_17_12_17_to_10_03_23.csv,BTC_USD,HOUR,101822.14,0.093,12/02/2023 18:00:00,12/02/2023 20:00:00,12/02/2023 20:00:00,EXPIRED,LONG,21991.0,21969.0,23639.48,0.0,0.02,6.97,0.0,153.31,2,0.1,-2.05
31/12/2022 13:00:00,16/06/2023 15:50:25,Gemini_BTCUSD_1h_17_12_17_to_10_03_23.csv,BTC_USD,HOUR,101820.09,0.123,31/12/2022 14:00:00,31/12/2022 16:00:00,31/12/2022 16:00:00,EXPIRED,LONG,16577.0,16581.0,18016.41,0.0,0.02,7.99,0.0,177.05,2,0.1,0.49
30/05/2022 12:00:00,16/06/2023 15:50:25,Gemini_BTCUSD_1h_17_12_17_to_10_03_23.csv,BTC_USD,HOUR,101820.58,0.067,30/05/2022 13:00:00,30/05/2022 15:00:00,30/05/2022 15:00:00,EXPIRED,LONG,30510.0,30616.0,31307.33,0.0,0.02,2.55,0.0,53.42,2,0.0,7.1
14/01/2018 20:00:00,16/06/2023 15:50:25,Gemini_BTCUSD_1h_17_12_17_to_10_03_23.csv,BTC_USD,HOUR,101827.68,0.151,14/01/2018 21:00:00,14/01/2018 23:00:00,14/01/2018 23:00:00,EXPIRED,LONG,13522.0,13626.0,14656.94,0.0,0.02,7.74,0.0,171.38,2,0.1,15.7
13/10/2020 09:00:00,16/06/2023 15:50:25,Gemini_BTCUSD_1h_17_12_17_to_10_03_23.csv,BTC_USD,HOUR,101843.38,0.178,13/10/2020 13:00:00,13/10/2020 12:00:00,13/10/2020 12:00:00,EXPIRED,LONG,11474.0,11449.0,11928.12,0.0,0.02,3.81,0.0,80.83,2,0.0,-4.45
22/09/2020 18:00:00,16/06/2023 15:50:25,Gemini_BTCUSD_1h_17_12_17_to_10_03_23.csv,BTC_USD,HOUR,101838.93,0.194,22/09/2020 20:00:00,22/09/2020 21:00:00,22/09/2020 21:00:00,EXPIRED,LONG,10498.0,10560.0,11345.05,0.0,0.02,7.47,0.0,164.33,2,0.1,12.03
24/06/2019 07:00:00,16/06/2023 15:50:25,Gemini_BTCUSD_1h_17_12_17_to_10_03_23.csv,BTC_USD,HOUR,101850.96,0.189,24/06/2019 08:00:00,24/06/2019 10:00:00,24/06/2019 10:00:00,EXPIRED,LONG,10772.0,10873.0,11195.54,0.0,0.02,3.78,0.0,80.05,2,0.0,19.09
06/10/2018 10:00:00,16/06/2023 15:50:25,Gemini_BTCUSD_1h_17_12_17_to_10_03_23.csv,BTC_USD,HOUR,101870.05,0.31,06/10/2018 11:00:00,06/10/2018 13:00:00,06/10/2018 13:00:00,EXPIRED,LONG,6568.0,6540.0,6747.13,0.0,0.02,2.65,0.0,55.53,2,0.0,-8.68
12/05/2018 15:00:00,16/06/2023 15:50:25,Gemini_BTCUSD_1h_17_12_17_to_10_03_23.csv,BTC_USD,HOUR,101861.37,0.244,12/05/2018 18:00:00,12/05/2018 18:00:00,12/05/2018 18:00:00,EXPIRED,LONG,8353.0,8367.0,8649.71,0.0,0.02,3.43,0.0,72.4,2,0.0,3.42
15/02/2021 20:00:00,16/06/2023 15:50:25,Gemini_BTCUSD_1h_17_12_17_to_10_03_23.csv,BTC_USD,HOUR,101864.79,0.042,15/02/2021 21:00:00,15/02/2021 23:00:00,15/02/2021 21:00:00,TAKE_PROFIT_HIT,LONG,48610.0,48632.33,48632.33,0.0,0.02,0.05,0.0,0.94,2,0.0,0.94
10/08/2021 04:00:00,16/06/2023 15:50:25,Gemini_BTCUSD_1h_17_12_17_to_10_03_23.csv,BTC_USD,HOUR,101865.73,0.045,10/08/2021 05:00:00,10/08/2021 07:00:00,10/08/2021 07:00:00,EXPIRED,LONG,45481.0,45999.0,46592.39,0.0,0.02,2.39,0.0,50.01,2,0.0,23.31
05/08/2020 13:00:00,16/06/2023 15:50:25,Gemini_BTCUSD_1h_17_12_17_to_10_03_23.csv,BTC_USD,HOUR,101889.04,0.175,05/08/2020 14:00:00,05/08/2020 16:00:00,05/08/2020 16:00:00,EXPIRED,LONG,11627.0,11651.0,12600.41,0.0,0.02,7.73,0.0,170.35,2,0.1,4.2
19/02/2022 18:00:00,16/06/2023 15:50:25,Gemini_BTCUSD_1h_17_12_17_to_10_03_23.csv,BTC_USD,HOUR,101893.24,0.051,19/02/2022 19:00:00,19/02/2022 21:00:00,19/02/2022 21:00:00,EXPIRED,LONG,40149.0,39940.0,41255.32,0.0,0.02,2.68,0.0,56.42,2,0.0,-10.66
01/04/2022 16:00:00,16/06/2023 15:50:25,Gemini_BTCUSD_1h_17_12_17_to_10_03_23.csv,BTC_USD,HOUR,101882.58,0.044,01/04/2022 17:00:00,01/04/2022 19:00:00,01/04/2022 19:00:00,EXPIRED,LONG,46050.0,46402.0,49247.91,0.0,0.02,6.49,0.0,140.71,2,0.1,15.49
02/06/2021 20:00:00,16/06/2023 15:50:25,Gemini_BTCUSD_1h_17_12_17_to_10_03_23.csv,BTC_USD,HOUR,101898.07,0.054,03/06/2021 00:00:00,02/06/2021 23:00:00,02/06/2021 23:00:00,EXPIRED,LONG,37750.0,37589.0,39337.26,0.0,0.02,4.04,0.0,85.71,2,0.0,-8.69
08/01/2022 01:00:00,16/06/2023 15:50:25,Gemini_BTCUSD_1h_17_12_17_to_10_03_23.csv,BTC_USD,HOUR,101889.38,0.049,08/01/2022 05:00:00,08/01/2022 04:00:00,08/01/2022 04:00:00,EXPIRED,LONG,41886.0,41904.0,43476.49,0.0,0.02,3.66,0.0,77.93,2,0.0,0.88
28/05/2022 09:00:00,16/06/2023 15:50:25,Gemini_BTCUSD_1h_17_12_17_to_10_03_23.csv,BTC_USD,HOUR,101890.26,0.071,28/05/2022 11:00:00,28/05/2022 12:00:00,28/05/2022 12:00:00,EXPIRED,LONG,28780.0,28944.0,29674.91,0.0,0.02,3.02,0.0,63.54,2,0.0,11.64
15/01/2021 02:00:00,16/06/2023 15:50:25,Gemini_BTCUSD_1h_17_12_17_to_10_03_23.csv,BTC_USD,HOUR,101901.9,0.052,15/01/2021 03:00:00,15/01/2021 05:00:00,15/01/2021 05:00:00,EXPIRED,LONG,39248.0,37793.0,42162.99,0.0,0.02,6.91,0.0,151.58,2,0.1,-75.66
08/04/2021 17:00:00,16/06/2023 15:50:25,Gemini_BTCUSD_1h_17_12_17_to_10_03_23.csv,BTC_USD,HOUR,101826.24,0.035,08/04/2021 18:00:00,08/04/2021 20:00:00,08/04/2021 20:00:00,EXPIRED,LONG,57761.0,57674.0,59521.27,0.0,0.02,2.96,0.0,61.61,2,0.0,-3.05
13/01/2023 19:00:00,16/06/2023 15:50:25,Gemini_BTCUSD_1h_17_12_17_to_10_03_23.csv,BTC_USD,HOUR,101823.19,0.105,13/01/2023 20:00:00,13/01/2023 22:00:00,13/01/2023 22:00:00,EXPIRED,LONG,19361.0,19869.0,20341.65,0.0,0.02,4.82,0.0,102.97,2,0.1,53.34
11/09/2019 19:00:00,16/06/2023 15:50:25,Gemini_BTCUSD_1h_17_12_17_to_10_03_23.csv,BTC_USD,HOUR,101876.53,0.202,11/09/2019 20:00:00,11/09/2019 22:00:00,11/09/2019 22:00:00,EXPIRED,LONG,10081.0,10149.0,10782.76,0.0,0.02,6.51,0.0,141.76,2,0.1,13.74
05/09/2020 03:00:00,16/06/2023 15:50:25,Gemini_BTCUSD_1h_17_12_17_to_10_03_23.csv,BTC_USD,HOUR,101890.27,0.196,05/09/2020 07:00:00,05/09/2020 06:00:00,05/09/2020 06:00:00,EXPIRED,LONG,10412.0,10483.0,10794.77,0.0,0.02,3.55,0.0,75.02,2,0.0,13.92
21/07/2022 21:00:00,16/06/2023 15:50:25,Gemini_BTCUSD_1h_17_12_17_to_10_03_23.csv,BTC_USD,HOUR,101904.19,0.088,21/07/2022 23:00:00,22/07/2022 00:00:00,22/07/2022 00:00:00,EXPIRED,LONG,23220.0,23271.0,24289.66,0.0,0.02,4.4,0.0,94.13,2,0.0,4.49
20/06/2018 13:00:00,16/06/2023 15:50:25,Gemini_BTCUSD_1h_17_12_17_to_10_03_23.csv,BTC_USD,HOUR,101908.68,0.303,20/06/2018 14:00:00,20/06/2018 16:00:00,20/06/2018 16:00:00,EXPIRED,LONG,6734.0,6759.0,6892.4,0.0,0.02,2.3,0.0,48.0,2,0.0,7.58
02/04/2020 14:00:00,16/06/2023 15:50:25,Gemini_BTCUSD_1h_17_12_17_to_10_03_23.csv,BTC_USD,HOUR,101916.26,0.3,02/04/2020 15:00:00,02/04/2020 17:00:00,02/04/2020 17:00:00,TAKE_PROFIT_HIT,LONG,6796.0,7249.91,7249.91,0.0,0.02,6.26,0.0,136.17,2,0.1,136.17
02/09/2018 12:00:00,16/06/2023 15:50:25,Gemini_BTCUSD_1h_17_12_17_to_10_03_23.csv,BTC_USD,HOUR,102052.43,0.282,02/09/2018 13:00:00,02/09/2018 15:00:00,02/09/2018 15:00:00,EXPIRED,LONG,7241.0,7217.0,7664.19,0.0,0.02,5.52,0.0,119.34,2,0.1,-6.77
08/07/2019 05:00:00,16/06/2023 15:50:25,Gemini_BTCUSD_1h_17_12_17_to_10_03_23.csv,BTC_USD,HOUR,102045.66,0.178,08/07/2019 09:00:00,08/07/2019 08:00:00,08/07/2019 08:00:00,EXPIRED,LONG,11477.0,11768.0,12100.95,0.0,0.02,5.16,0.0,111.06,2,0.1,51.8
14/09/2021 09:00:00,16/06/2023 15:50:25,Gemini_BTCUSD_1h_17_12_17_to_10_03_23.csv,BTC_USD,HOUR,102097.46,0.045,14/09/2021 10:00:00,14/09/2021 12:00:00,14/09/2021 12:00:00,EXPIRED,LONG,45860.0,46545.0,49568.53,0.0,0.02,7.48,0.0,166.88,2,0.1,30.83
11/05/2021 18:00:00,16/06/2023 15:50:25,Gemini_BTCUSD_1h_17_12_17_to_10_03_23.csv,BTC_USD,HOUR,102128.29,0.036,11/05/2021 19:00:00,11/05/2021 21:00:00,11/05/2021 21:00:00,EXPIRED,LONG,56444.0,56618.0,57866.39,0.0,0.02,2.46,0.0,51.21,2,0.0,6.26
07/07/2020 13:00:00,16/06/2023 15:50:25,Gemini_BTCUSD_1h_17_12_17_to_10_03_23.csv,BTC_USD,HOUR,102134.55,0.22,07/07/2020 16:00:00,07/07/2020 16:00:00,07/07/2020 16:00:00,EXPIRED,LONG,9264.0,9268.0,9496.81,0.0,0.02,2.45,0.0,51.22,2,0.0,0.88
10/01/2020 15:00:00,16/06/2023 15:50:25,Gemini_BTCUSD_1h_17_12_17_to_10_03_23.csv,BTC_USD,HOUR,102135.43,0.253,10/01/2020 16:00:00,10/01/2020 18:00:00,10/01/2020 18:00:00,EXPIRED,LONG,8063.0,8017.0,8658.13,0.0,0.02,6.87,0.0,150.57,2,0.1,-11.64
25/08/2018 02:00:00,16/06/2023 15:50:25,Gemini_BTCUSD_1h_17_12_17_to_10_03_23.csv,BTC_USD,HOUR,102123.79,0.302,25/08/2018 04:00:00,25/08/2018 05:00:00,25/08/2018 05:00:00,EXPIRED,LONG,6770.0,6732.0,7229.72,0.0,0.02,6.36,0.0,138.84,2,0.1,-11.48
14/02/2018 04:00:00,16/06/2023 15:50:25,Gemini_BTCUSD_1h_17_12_17_to_10_03_23.csv,BTC_USD,HOUR,102112.31,0.232,14/02/2018 05:00:00,14/02/2018 07:00:00,14/02/2018 07:00:00,EXPIRED,LONG,8807.0,8901.0,9566.32,0.0,0.02,7.94,0.0,176.16,2,0.1,21.81
22/10/2020 23:00:00,16/06/2023 15:50:25,Gemini_BTCUSD_1h_17_12_17_to_10_03_23.csv,BTC_USD,HOUR,102134.12,0.157,23/10/2020 00:00:00,23/10/2020 02:00:00,23/10/2020 02:00:00,EXPIRED,LONG,12989.0,13006.0,13459.46,0.0,0.02,3.5,0.0,73.86,2,0.0,2.67
06/09/2020 09:00:00,16/06/2023 15:50:25,Gemini_BTCUSD_1h_17_12_17_to_10_03_23.csv,BTC_USD,HOUR,102136.79,0.2,06/09/2020 10:00:00,06/09/2020 12:00:00,06/09/2020 12:00:00,EXPIRED,LONG,10210.0,10254.0,11146.11,0.0,0.02,8.4,0.0,187.22,2,0.1,8.8
29/04/2020 17:00:00,16/06/2023 15:50:25,Gemini_BTCUSD_1h_17_12_17_to_10_03_23.csv,BTC_USD,HOUR,102145.59,0.234,29/04/2020 18:00:00,29/04/2020 20:00:00,29/04/2020 20:00:00,EXPIRED,LONG,8733.0,8940.0,9103.62,0.0,0.02,4.07,0.0,86.73,2,0.0,48.44
27/07/2022 13:00:00,16/06/2023 15:50:25,Gemini_BTCUSD_1h_17_12_17_to_10_03_23.csv,BTC_USD,HOUR,102194.03,0.095,27/07/2022 17:00:00,27/07/2022 16:00:00,27/07/2022 16:00:00,EXPIRED,LONG,21460.0,21534.0,22261.33,0.0,0.02,3.6,0.0,76.13,2,0.0,7.03
02/08/2022 14:00:00,16/06/2023 15:50:25,Gemini_BTCUSD_1h_17_12_17_to_10_03_23.csv,BTC_USD,HOUR,102201.06,0.089,02/08/2022 15:00:00,02/08/2022 17:00:00,02/08/2022 17:00:00,EXPIRED,LONG,23034.0,23187.0,24362.54,0.0,0.02,5.45,0.0,118.24,2,0.1,13.62
04/09/2020 09:00:00,16/06/2023 15:50:25,Gemini_BTCUSD_1h_17_12_17_to_10_03_23.csv,BTC_USD,HOUR,102214.68,0.194,04/09/2020 10:00:00,04/09/2020 12:00:00,04/09/2020 12:00:00,EXPIRED,LONG,10561.0,10478.0,11100.43,0.0,0.02,4.86,0.0,104.65,2,0.1,-16.1
14/08/2022 01:00:00,16/06/2023 15:50:25,Gemini_BTCUSD_1h_17_12_17_to_10_03_23.csv,BTC_USD,HOUR,102198.58,0.083,14/08/2022 04:00:00,14/08/2022 04:00:00,14/08/2022 04:00:00,EXPIRED,LONG,24606.0,24573.0,26090.62,0.0,0.02,5.69,0.0,123.22,2,0.1,-2.74
09/10/2020 17:00:00,16/06/2023 15:50:25,Gemini_BTCUSD_1h_17_12_17_to_10_03_23.csv,BTC_USD,HOUR,102195.84,0.185,09/10/2020 18:00:00,09/10/2020 20:00:00,09/10/2020 20:00:00,EXPIRED,LONG,11073.0,11048.0,11631.08,0.0,0.02,4.8,0.0,103.24,2,0.1,-4.62
09/02/2022 16:00:00,16/06/2023 15:50:25,Gemini_BTCUSD_1h_17_12_17_to_10_03_23.csv,BTC_USD,HOUR,102191.22,0.046,09/02/2022 17:00:00,09/02/2022 19:00:00,09/02/2022 19:00:00,EXPIRED,LONG,44120.0,44504.0,45941.1,0.0,0.02,3.96,0.0,83.77,2,0.0,17.66
16/05/2021 13:00:00,16/06/2023 15:50:25,Gemini_BTCUSD_1h_17_12_17_to_10_03_23.csv,BTC_USD,HOUR,102208.88,0.042,16/05/2021 14:00:00,16/05/2021 16:00:00,16/05/2021 16:00:00,EXPIRED,LONG,48958.0,47311.0,50398.38,0.0,0.02,2.86,0.0,60.5,2,0.0,-69.17
15/01/2018 14:00:00,16/06/2023 15:50:25,Gemini_BTCUSD_1h_17_12_17_to_10_03_23.csv,BTC_USD,HOUR,102139.71,0.145,15/01/2018 15:00:00,15/01/2018 17:00:00,15/01/2018 17:00:00,EXPIRED,LONG,14100.0,13880.0,15155.57,0.0,0.02,6.96,0.0,153.06,2,0.1,-31.9
30/08/2019 22:00:00,16/06/2023 15:50:25,Gemini_BTCUSD_1h_17_12_17_to_10_03_23.csv,BTC_USD,HOUR,102107.81,0.213,31/08/2019 00:00:00,31/08/2019 01:00:00,31/08/2019 01:00:00,EXPIRED,LONG,9599.0,9627.0,9989.55,0.0,0.02,3.91,0.0,83.19,2,0.0,5.96
13/01/2020 21:00:00,16/06/2023 15:50:25,Gemini_BTCUSD_1h_17_12_17_to_10_03_23.csv,BTC_USD,HOUR,102113.77,0.251,13/01/2020 22:00:00,14/01/2020 00:00:00,14/01/2020 00:00:00,EXPIRED,LONG,8133.0,8267.0,8579.01,0.0,0.02,5.2,0.0,111.95,2,0.1,33.63
03/10/2020 17:00:00,16/06/2023 15:50:25,Gemini_BTCUSD_1h_17_12_17_to_10_03_23.csv,BTC_USD,HOUR,102147.4,0.193,03/10/2020 18:00:00,03/10/2020 20:00:00,03/10/2020 20:00:00,EXPIRED,LONG,10589.0,10578.0,11277.31,0.0,0.02,6.1,0.0,132.84,2,0.1,-2.12
30/07/2019 09:00:00,16/06/2023 15:50:25,Gemini_BTCUSD_1h_17_12_17_to_10_03_23.csv,BTC_USD,HOUR,102145.28,0.215,30/07/2019 10:00:00,30/07/2019 12:00:00,30/07/2019 12:00:00,EXPIRED,LONG,9493.0,9548.0,9967.75,0.0,0.02,4.76,0.0,102.07,2,0.1,11.83
24/10/2022 02:00:00,16/06/2023 15:50:25,Gemini_BTCUSD_1h_17_12_17_to_10_03_23.csv,BTC_USD,HOUR,102157.11,0.105,24/10/2022 03:00:00,24/10/2022 05:00:00,24/10/2022 05:00:00,EXPIRED,LONG,19418.0,19337.0,19950.11,0.0,0.02,2.67,0.0,55.87,2,0.0,-8.5
21/08/2021 14:00:00,16/06/2023 15:50:25,Gemini_BTCUSD_1h_17_12_17_to_10_03_23.csv,BTC_USD,HOUR,102148.61,0.042,21/08/2021 15:00:00,21/08/2021 17:00:00,21/08/2021 17:00:00,EXPIRED,LONG,49063.0,49705.0,50128.83,0.0,0.02,2.13,0.0,44.76,2,0.0,26.96
20/08/2020 01:00:00,16/06/2023 15:50:25,Gemini_BTCUSD_1h_17_12_17_to_10_03_23.csv,BTC_USD,HOUR,102175.57,0.174,20/08/2020 02:00:00,20/08/2020 04:00:00,20/08/2020 04:00:00,EXPIRED,LONG,11760.0,11723.0,12015.65,0.0,0.02,2.13,0.0,44.48,2,0.0,-6.44
23/10/2021 05:00:00,16/06/2023 15:50:25,Gemini_BTCUSD_1h_17_12_17_to_10_03_23.csv,BTC_USD,HOUR,102169.13,0.034,23/10/2021 06:00:00,23/10/2021 08:00:00,23/10/2021 08:00:00,EXPIRED,LONG,60981.0,61073.0,62348.85,0.0,0.02,2.19,0.0,46.51,2,0.0,3.13
22/12/2021 20:00:00,16/06/2023 15:50:25,Gemini_BTCUSD_1h_17_12_17_to_10_03_23.csv,BTC_USD,HOUR,102172.26,0.042,22/12/2021 21:00:00,22/12/2021 23:00:00,22/12/2021 23:00:00,EXPIRED,LONG,48991.0,48620.0,51027.21,0.0,0.02,3.99,0.0,85.52,2,0.0,-15.58
30/10/2020 17:00:00,16/06/2023 15:50:25,Gemini_BTCUSD_1h_17_12_17_to_10_03_23.csv,BTC_USD,HOUR,102156.68,0.151,30/10/2020 19:00:00,30/10/2020 20:00:00,30/10/2020 20:00:00,EXPIRED,LONG,13548.0,13664.0,13870.76,0.0,0.02,2.33,0.0,48.74,2,0.0,17.52
27/02/2021 03:00:00,16/06/2023 15:50:25,Gemini_BTCUSD_1h_17_12_17_to_10_03_23.csv,BTC_USD,HOUR,102174.2,0.043,27/02/2021 04:00:00,27/02/2021 06:00:00,27/02/2021 06:00:00,EXPIRED,LONG,47440.0,47556.0,50593.79,0.0,0.02,6.23,0.0,135.61,2,0.1,4.99
19/10/2018 23:00:00,16/06/2023 15:50:25,Gemini_BTCUSD_1h_17_12_17_to_10_03_23.csv,BTC_USD,HOUR,102179.19,0.32,20/10/2018 00:00:00,20/10/2018 02:00:00,20/10/2018 02:00:00,EXPIRED,LONG,6386.0,6386.0,6680.61,0.0,0.02,4.41,0.0,94.28,2,0.0,0.0
22/02/2020 23:00:00,16/06/2023 15:50:25,Gemini_BTCUSD_1h_17_12_17_to_10_03_23.csv,BTC_USD,HOUR,102179.19,0.211,23/02/2020 02:00:00,23/02/2020 02:00:00,23/02/2020 02:00:00,EXPIRED,LONG,9676.0,9701.0,9936.28,0.0,0.02,2.62,0.0,54.92,2,0.0,5.28
17/10/2021 17:00:00,16/06/2023 15:50:25,Gemini_BTCUSD_1h_17_12_17_to_10_03_23.csv,BTC_USD,HOUR,102184.47,0.033,17/10/2021 18:00:00,17/10/2021 20:00:00,17/10/2021 20:00:00,EXPIRED,LONG,61033.0,59420.0,62566.12,0.0,0.02,2.45,0.0,50.59,2,0.0,-53.23
21/06/2018 13:00:00,16/06/2023 15:50:25,Gemini_BTCUSD_1h_17_12_17_to_10_03_23.csv,BTC_USD,HOUR,102131.24,0.304,21/06/2018 14:00:00,21/06/2018 16:00:00,21/06/2018 16:00:00,EXPIRED,LONG,6726.0,6723.0,7070.86,0.0,0.02,4.88,0.0,104.84,2,0.1,-0.91
22/04/2021 14:00:00,16/06/2023 15:50:25,Gemini_BTCUSD_1h_17_12_17_to_10_03_23.csv,BTC_USD,HOUR,102130.33,0.037,22/04/2021 16:00:00,22/04/2021 17:00:00,22/04/2021 17:00:00,EXPIRED,LONG,54785.0,53385.0,59434.15,0.0,0.02,7.82,0.0,172.02,2,0.1,-51.8
27/09/2020 00:00:00,16/06/2023 15:50:25,Gemini_BTCUSD_1h_17_12_17_to_10_03_23.csv,BTC_USD,HOUR,102078.53,0.189,27/09/2020 01:00:00,27/09/2020 03:00:00,27/09/2020 03:00:00,EXPIRED,LONG,10783.0,10787.0,11122.2,0.0,0.02,3.05,0.0,64.11,2,0.0,0.76
17/02/2021 18:00:00,16/06/2023 15:50:25,Gemini_BTCUSD_1h_17_12_17_to_10_03_23.csv,BTC_USD,HOUR,102079.29,0.04,17/02/2021 19:00:00,17/02/2021 21:00:00,17/02/2021 21:00:00,EXPIRED,LONG,51413.0,52412.0,55078.71,0.0,0.02,6.66,0.0,146.63,2,0.1,39.96
13/05/2020 23:00:00,16/06/2023 15:50:25,Gemini_BTCUSD_1h_17_12_17_to_10_03_23.csv,BTC_USD,HOUR,102119.25,0.219,14/05/2020 00:00:00,14/05/2020 02:00:00,14/05/2020 02:00:00,EXPIRED,LONG,9312.0,9345.0,9882.68,0.0,0.02,5.77,0.0,124.98,2,0.1,7.23
25/03/2018 19:00:00,16/06/2023 15:50:25,Gemini_BTCUSD_1h_17_12_17_to_10_03_23.csv,BTC_USD,HOUR,102126.48,0.237,25/03/2018 20:00:00,25/03/2018 22:00:00,25/03/2018 22:00:00,EXPIRED,LONG,8616.0,8442.0,9141.45,0.0,0.02,5.75,0.0,124.53,2,0.1,-41.24
26/12/2018 07:00:00,16/06/2023 15:50:25,Gemini_BTCUSD_1h_17_12_17_to_10_03_23.csv,BTC_USD,HOUR,102085.24,0.54,26/12/2018 10:00:00,26/12/2018 10:00:00,26/12/2018 10:00:00,EXPIRED,LONG,3779.0,3749.0,3935.49,0.0,0.02,3.98,0.0,84.5,2,0.0,-16.2
04/10/2018 12:00:00,16/06/2023 15:50:25,Gemini_BTCUSD_1h_17_12_17_to_10_03_23.csv,BTC_USD,HOUR,102069.04,0.313,04/10/2018 13:00:00,04/10/2018 15:00:00,04/10/2018 15:00:00,EXPIRED,LONG,6531.0,6540.0,6910.74,0.0,0.02,5.49,0.0,118.86,2,0.1,2.82
17/01/2021 15:00:00,16/06/2023 15:50:25,Gemini_BTCUSD_1h_17_12_17_to_10_03_23.csv,BTC_USD,HOUR,102071.86,0.057,17/01/2021 17:00:00,17/01/2021 18:00:00,17/01/2021 18:00:00,EXPIRED,LONG,35756.0,35656.0,36555.56,0.0,0.02,2.19,0.0,45.57,2,0.0,-5.7
05/03/2021 15:00:00,16/06/2023 15:50:25,Gemini_BTCUSD_1h_17_12_17_to_10_03_23.csv,BTC_USD,HOUR,102066.16,0.043,05/03/2021 16:00:00,05/03/2021 18:00:00,05/03/2021 18:00:00,EXPIRED,LONG,47888.0,48486.0,51821.08,0.0,0.02,7.59,0.0,169.12,2,0.1,25.71
20/05/2020 20:00:00,16/06/2023 15:50:25,Gemini_BTCUSD_1h_17_12_17_to_10_03_23.csv,BTC_USD,HOUR,102091.87,0.213,20/05/2020 22:00:00,20/05/2020 23:00:00,20/05/2020 23:00:00,EXPIRED,LONG,9591.0,9515.0,9873.92,0.0,0.02,2.87,0.0,60.26,2,0.0,-16.19
04/06/2019 10:00:00,16/06/2023 15:50:25,Gemini_BTCUSD_1h_17_12_17_to_10_03_23.csv,BTC_USD,HOUR,102075.68,0.257,04/06/2019 11:00:00,04/06/2019 13:00:00,04/06/2019 13:00:00,EXPIRED,LONG,7950.0,7995.0,8121.01,0.0,0.02,2.11,0.0,43.95,2,0.0,11.57
11/10/2021 13:00:00,16/06/2023 15:50:25,Gemini_BTCUSD_1h_17_12_17_to_10_03_23.csv,BTC_USD,HOUR,102087.25,0.036,11/10/2021 15:00:00,11/10/2021 16:00:00,11/10/2021 16:00:00,EXPIRED,LONG,57315.0,57321.0,60239.07,0.0,0.02,4.85,0.0,105.27,2,0.1,0.22
02/11/2018 20:00:00,16/06/2023 15:50:25,Gemini_BTCUSD_1h_17_12_17_to_10_03_23.csv,BTC_USD,HOUR,102087.47,0.321,02/11/2018 21:00:00,02/11/2018 23:00:00,02/11/2018 23:00:00,EXPIRED,LONG,6355.0,6351.0,6489.63,0.0,0.02,2.07,0.0,43.22,2,0.0,-1.28
19/06/2019 22:00:00,16/06/2023 15:50:25,Gemini_BTCUSD_1h_17_12_17_to_10_03_23.csv,BTC_USD,HOUR,102086.19,0.22,19/06/2019 23:00:00,20/06/2019 01:00:00,20/06/2019 01:00:00,EXPIRED,LONG,9260.0,9261.0,10004.99,0.0,0.02,7.45,0.0,163.9,2,0.1,0.22
09/11/2020 01:00:00,16/06/2023 15:50:25,Gemini_BTCUSD_1h_17_12_17_to_10_03_23.csv,BTC_USD,HOUR,102086.41,0.131,09/11/2020 02:00:00,09/11/2020 04:00:00,09/11/2020 04:00:00,EXPIRED,LONG,15536.0,15402.0,15954.63,0.0,0.02,2.62,0.0,54.84,2,0.0,-17.55
02/04/2022 23:00:00,16/06/2023 15:50:25,Gemini_BTCUSD_1h_17_12_17_to_10_03_23.csv,BTC_USD,HOUR,102068.86,0.045,03/04/2022 00:00:00,03/04/2022 02:00:00,03/04/2022 02:00:00,EXPIRED,LONG,45811.0,45803.0,47571.94,0.0,0.02,3.7,0.0,79.24,2,0.0,-0.36
23/12/2019 12:00:00,16/06/2023 15:50:25,Gemini_BTCUSD_1h_17_12_17_to_10_03_23.csv,BTC_USD,HOUR,102068.5,0.27,23/12/2019 13:00:00,23/12/2019 15:00:00,23/12/2019 15:00:00,EXPIRED,LONG,7561.0,7586.0,7730.41,0.0,0.02,2.19,0.0,45.74,2,0.0,6.75
06/12/2022 18:00:00,16/06/2023 15:50:25,Gemini_BTCUSD_1h_17_12_17_to_10_03_23.csv,BTC_USD,HOUR,102075.25,0.12,06/12/2022 19:00:00,06/12/2022 21:00:00,06/12/2022 21:00:00,EXPIRED,LONG,16981.0,16998.0,17675.48,0.0,0.02,3.93,0.0,83.34,2,0.0,2.04
15/03/2021 05:00:00,16/06/2023 15:50:25,Gemini_BTCUSD_1h_17_12_17_to_10_03_23.csv,BTC_USD,HOUR,102077.29,0.035,15/03/2021 06:00:00,15/03/2021 08:00:00,15/03/2021 08:00:00,EXPIRED,LONG,59013.0,57777.0,62001.03,0.0,0.02,4.82,0.0,104.58,2,0.1,-43.26
16/12/2021 10:00:00,16/06/2023 15:50:25,Gemini_BTCUSD_1h_17_12_17_to_10_03_23.csv,BTC_USD,HOUR,102034.03,0.041,16/12/2021 11:00:00,16/12/2021 13:00:00,16/12/2021 13:00:00,EXPIRED,LONG,49190.0,49015.0,53381.1,0.0,0.02,7.85,0.0,171.84,2,0.1,-7.18
05/07/2019 11:00:00,16/06/2023 15:50:25,Gemini_BTCUSD_1h_17_12_17_to_10_03_23.csv,BTC_USD,HOUR,102026.85,0.182,05/07/2019 12:00:00,05/07/2019 14:00:00,05/07/2019 14:00:00,EXPIRED,LONG,11203.0,11373.0,11950.78,0.0,0.02,6.26,0.0,136.1,2,0.1,30.94
06/01/2021 02:00:00,16/06/2023 15:50:25,Gemini_BTCUSD_1h_17_12_17_to_10_03_23.csv,BTC_USD,HOUR,102057.79,0.06,06/01/2021 03:00:00,06/01/2021 05:00:00,06/01/2021 04:00:00,TAKE_PROFIT_HIT,LONG,33970.0,34787.11,34787.11,0.0,0.02,2.35,0.0,49.03,2,0.0,49.03
19/07/2020 17:00:00,16/06/2023 15:50:25,Gemini_BTCUSD_1h_17_12_17_to_10_03_23.csv,BTC_USD,HOUR,102106.82,0.223,19/07/2020 21:00:00,19/07/2020 20:00:00,19/07/2020 20:00:00,EXPIRED,LONG,9157.0,9175.0,9597.76,0.0,0.02,4.59,0.0,98.29,2,0.0,4.01
12/04/2020 03:00:00,16/06/2023 15:50:25,Gemini_BTCUSD_1h_17_12_17_to_10_03_23.csv,BTC_USD,HOUR,102110.83,0.299,12/04/2020 06:00:00,12/04/2020 06:00:00,12/04/2020 06:00:00,EXPIRED,LONG,6819.0,6835.0,7113.68,0.0,0.02,4.14,0.0,88.11,2,0.0,4.78
01/02/2019 12:00:00,16/06/2023 15:50:25,Gemini_BTCUSD_1h_17_12_17_to_10_03_23.csv,BTC_USD,HOUR,102115.61,0.596,01/02/2019 13:00:00,01/02/2019 15:00:00,01/02/2019 15:00:00,EXPIRED,LONG,3426.0,3431.0,3639.36,0.0,0.02,5.86,0.0,127.16,2,0.1,2.98
29/12/2021 16:00:00,16/06/2023 15:50:25,Gemini_BTCUSD_1h_17_12_17_to_10_03_23.csv,BTC_USD,HOUR,102118.59,0.043,29/12/2021 20:00:00,29/12/2021 19:00:00,29/12/2021 19:00:00,EXPIRED,LONG,47744.0,47152.0,48945.21,0.0,0.02,2.45,0.0,51.65,2,0.0,-25.46
30/04/2019 00:00:00,16/06/2023 15:50:25,Gemini_BTCUSD_1h_17_12_17_to_10_03_23.csv,BTC_USD,HOUR,102093.13,0.396,30/04/2019 04:00:00,30/04/2019 03:00:00,30/04/2019 03:00:00,EXPIRED,LONG,5153.0,5154.0,5286.48,0.0,0.02,2.52,0.0,52.86,2,0.0,0.4
10/10/2020 15:00:00,16/06/2023 15:50:25,Gemini_BTCUSD_1h_17_12_17_to_10_03_23.csv,BTC_USD,HOUR,102093.53,0.18,10/10/2020 16:00:00,10/10/2020 18:00:00,10/10/2020 18:00:00,EXPIRED,LONG,11353.0,11376.0,11951.64,0.0,0.02,5.01,0.0,107.76,2,0.1,4.14
21/11/2021 16:00:00,16/06/2023 15:50:25,Gemini_BTCUSD_1h_17_12_17_to_10_03_23.csv,BTC_USD,HOUR,102097.67,0.034,21/11/2021 17:00:00,21/11/2021 19:00:00,21/11/2021 19:00:00,EXPIRED,LONG,59919.0,59363.0,65293.3,0.0,0.02,8.23,0.0,182.73,2,0.1,-18.9
07/03/2022 14:00:00,16/06/2023 15:50:25,Gemini_BTCUSD_1h_17_12_17_to_10_03_23.csv,BTC_USD,HOUR,102078.77,0.053,07/03/2022 15:00:00,07/03/2022 17:00:00,07/03/2022 17:00:00,EXPIRED,LONG,38864.0,38627.0,41781.03,0.0,0.02,6.98,0.0,154.6,2,0.1,-12.56
10/04/2019 20:00:00,16/06/2023 15:50:25,Gemini_BTCUSD_1h_17_12_17_to_10_03_23.csv,BTC_USD,HOUR,102066.21,0.385,11/04/2019 00:00:00,10/04/2019 23:00:00,10/04/2019 23:00:00,EXPIRED,LONG,5304.0,5320.0,5500.06,0.0,0.02,3.56,0.0,75.48,2,0.0,6.16
16/05/2019 03:00:00,16/06/2023 15:50:25,Gemini_BTCUSD_1h_17_12_17_to_10_03_23.csv,BTC_USD,HOUR,102072.37,0.248,16/05/2019 04:00:00,16/05/2019 06:00:00,16/05/2019 06:00:00,EXPIRED,LONG,8247.0,8126.0,8591.29,0.0,0.02,4.01,0.0,85.38,2,0.0,-30.01
04/08/2020 03:00:00,16/06/2023 15:50:26,Gemini_BTCUSD_1h_17_12_17_to_10_03_23.csv,BTC_USD,HOUR,102042.36,0.181,04/08/2020 04:00:00,04/08/2020 06:00:00,04/08/2020 06:00:00,EXPIRED,LONG,11266.0,11270.0,12022.32,0.0,0.02,6.29,0.0,136.89,2,0.1,0.72
03/07/2018 08:00:00,16/06/2023 15:50:26,Gemini_BTCUSD_1h_17_12_17_to_10_03_23.csv,BTC_USD,HOUR,102043.08,0.308,03/07/2018 09:00:00,03/07/2018 11:00:00,03/07/2018 11:00:00,EXPIRED,LONG,6636.0,6586.0,6942.03,0.0,0.02,4.41,0.0,94.26,2,0.0,-15.4
01/08/2022 10:00:00,16/06/2023 15:50:26,Gemini_BTCUSD_1h_17_12_17_to_10_03_23.csv,BTC_USD,HOUR,102027.68,0.089,01/08/2022 11:00:00,01/08/2022 13:00:00,01/08/2022 13:00:00,EXPIRED,LONG,23048.0,23267.0,23566.58,0.0,0.02,2.2,0.0,46.15,2,0.0,19.49
07/10/2019 18:00:00,16/06/2023 15:50:26,Gemini_BTCUSD_1h_17_12_17_to_10_03_23.csv,BTC_USD,HOUR,102047.17,0.247,07/10/2019 19:00:00,07/10/2019 21:00:00,07/10/2019 21:00:00,EXPIRED,LONG,8251.0,8205.0,8580.33,0.0,0.02,3.84,0.0,81.34,2,0.0,-11.36
16/12/2020 10:00:00,16/06/2023 15:50:26,Gemini_BTCUSD_1h_17_12_17_to_10_03_23.csv,BTC_USD,HOUR,102035.81,0.103,16/12/2020 11:00:00,16/12/2020 13:00:00,16/12/2020 13:00:00,EXPIRED,LONG,19796.0,20346.0,21277.04,0.0,0.02,6.96,0.0,152.55,2,0.1,56.65
04/10/2018 00:00:00,16/06/2023 15:50:26,Gemini_BTCUSD_1h_17_12_17_to_10_03_23.csv,BTC_USD,HOUR,102092.46,0.315,04/10/2018 04:00:00,04/10/2018 03:00:00,04/10/2018 03:00:00,EXPIRED,LONG,6475.0,6554.0,6617.5,0.0,0.02,2.15,0.0,44.89,2,0.0,24.89
23/04/2021 16:00:00,16/06/2023 15:50:26,Gemini_BTCUSD_1h_17_12_17_to_10_03_23.csv,BTC_USD,HOUR,102117.35,0.041,23/04/2021 20:00:00,23/04/2021 19:00:00,23/04/2021 19:00:00,EXPIRED,LONG,49911.0,50955.0,51206.77,0.0,0.02,2.53,0.0,53.13,2,0.0,42.8
03/10/2020 20:00:00,16/06/2023 15:50:26,Gemini_BTCUSD_1h_17_12_17_to_10_03_23.csv,BTC_USD,HOUR,102160.15,0.193,03/10/2020 21:00:00,03/10/2020 23:00:00,03/10/2020 23:00:00,EXPIRED,LONG,10578.0,10557.0,10925.87,0.0,0.02,3.18,0.0,67.14,2,0.0,-4.05
27/03/2021 19:00:00,16/06/2023 15:50:26,Gemini_BTCUSD_1h_17_12_17_to_10_03_23.csv,BTC_USD,HOUR,102156.1,0.037,27/03/2021 20:00:00,27/03/2021 22:00:00,27/03/2021 22:00:00,EXPIRED,LONG,55826.0,56422.0,58407.67,0.0,0.02,4.42,0.0,95.52,2,0.0,22.05
04/04/2022 22:00:00,16/06/2023 15:50:26,Gemini_BTCUSD_1h_17_12_17_to_10_03_23.csv,BTC_USD,HOUR,102178.15,0.044,04/04/2022 23:00:00,05/04/2022 01:00:00,05/04/2022 01:00:00,EXPIRED,LONG,46699.0,46642.0,50423.14,0.0,0.02,7.39,0.0,163.86,2,0.1,-2.51
16/05/2022 23:00:00,16/06/2023 15:50:26,Gemini_BTCUSD_1h_17_12_17_to_10_03_23.csv,BTC_USD,HOUR,102175.64,0.068,17/05/2022 01:00:00,17/05/2022 02:00:00,17/05/2022 02:00:00,EXPIRED,LONG,29833.0,30023.0,30935.82,0.0,0.02,3.56,0.0,74.99,2,0.0,12.92
25/05/2020 08:00:00,16/06/2023 15:50:26,Gemini_BTCUSD_1h_17_12_17_to_10_03_23.csv,BTC_USD,HOUR,102188.56,0.232,25/05/2020 09:00:00,25/05/2020 11:00:00,25/05/2020 11:00:00,EXPIRED,LONG,8823.0,8750.0,9139.74,0.0,0.02,3.47,0.0,73.48,2,0.0,-16.94
31/12/2020 00:00:00,16/06/2023 15:50:26,Gemini_BTCUSD_1h_17_12_17_to_10_03_23.csv,BTC_USD,HOUR,102171.62,0.07,31/12/2020 02:00:00,31/12/2020 03:00:00,31/12/2020 03:00:00,EXPIRED,LONG,29097.0,29041.0,30531.28,0.0,0.02,4.7,0.0,100.4,2,0.0,-3.92
29/12/2022 01:00:00,16/06/2023 15:50:26,Gemini_BTCUSD_1h_17_12_17_to_10_03_23.csv,BTC_USD,HOUR,102167.7,0.124,29/12/2022 05:00:00,29/12/2022 04:00:00,29/12/2022 04:00:00,EXPIRED,LONG,16545.0,16563.0,16961.97,0.0,0.02,2.46,0.0,51.7,2,0.0,2.23
04/06/2020 05:00:00,16/06/2023 15:50:26,Gemini_BTCUSD_1h_17_12_17_to_10_03_23.csv,BTC_USD,HOUR,102169.93,0.212,04/06/2020 09:00:00,04/06/2020 08:00:00,04/06/2020 08:00:00,EXPIRED,LONG,9645.0,9641.0,10046.69,0.0,0.02,4.0,0.0,85.16,2,0.0,-0.85
18/02/2020 03:00:00,16/06/2023 15:50:26,Gemini_BTCUSD_1h_17_12_17_to_10_03_23.csv,BTC_USD,HOUR,102169.08,0.21,18/02/2020 04:00:00,18/02/2020 06:00:00,18/02/2020 06:00:00,EXPIRED,LONG,9729.0,9783.0,10430.54,0.0,0.02,6.73,0.0,147.32,2,0.1,11.34
02/11/2021 04:00:00,16/06/2023 15:50:26,Gemini_BTCUSD_1h_17_12_17_to_10_03_23.csv,BTC_USD,HOUR,102180.42,0.033,02/11/2021 05:00:00,02/11/2021 07:00:00,02/11/2021 07:00:00,EXPIRED,LONG,61467.0,61579.0,66482.54,0.0,0.02,7.54,0.0,165.51,2,0.1,3.7
29/06/2022 16:00:00,16/06/2023 15:50:26,Gemini_BTCUSD_1h_17_12_17_to_10_03_23.csv,BTC_USD,HOUR,102184.12,0.102,29/06/2022 17:00:00,29/06/2022 19:00:00,29/06/2022 19:00:00,EXPIRED,LONG,19996.0,20197.0,21569.51,0.0,0.02,7.3,0.0,160.5,2,0.1,20.5
14/03/2021 10:00:00,16/06/2023 15:50:26,Gemini_BTCUSD_1h_17_12_17_to_10_03_23.csv,BTC_USD,HOUR,102204.62,0.034,14/03/2021 13:00:00,14/03/2021 13:00:00,14/03/2021 13:00:00,EXPIRED,LONG,60344.0,59998.0,61821.8,0.0,0.02,2.39,0.0,50.25,2,0.0,-11.76
25/10/2019 03:00:00,16/06/2023 15:50:26,Gemini_BTCUSD_1h_17_12_17_to_10_03_23.csv,BTC_USD,HOUR,102192.86,0.274,25/10/2019 05:00:00,25/10/2019 06:00:00,25/10/2019 06:00:00,EXPIRED,LONG,7460.0,7460.0,7632.65,0.0,0.02,2.26,0.0,47.31,2,0.0,0.0
17/09/2020 02:00:00,16/06/2023 15:50:26,Gemini_BTCUSD_1h_17_12_17_to_10_03_23.csv,BTC_USD,HOUR,102192.86,0.187,17/09/2020 06:00:00,17/09/2020 05:00:00,17/09/2020 05:00:00,EXPIRED,LONG,10939.0,10918.0,11280.7,0.0,0.02,3.03,0.0,63.9,2,0.0,-3.93
08/05/2019 17:00:00,16/06/2023 15:50:26,Gemini_BTCUSD_1h_17_12_17_to_10_03_23.csv,BTC_USD,HOUR,102188.93,0.348,08/05/2019 18:00:00,08/05/2019 20:00:00,08/05/2019 20:00:00,EXPIRED,LONG,5878.0,5903.0,6007.36,0.0,0.02,2.15,0.0,45.02,2,0.0,8.7
19/09/2018 21:00:00,16/06/2023 15:50:26,Gemini_BTCUSD_1h_17_12_17_to_10_03_23.csv,BTC_USD,HOUR,102197.63,0.32,19/09/2018 22:00:00,20/09/2018 00:00:00,20/09/2018 00:00:00,EXPIRED,LONG,6386.0,6415.0,6534.99,0.0,0.02,2.28,0.0,47.68,2,0.0,9.28
03/04/2018 09:00:00,16/06/2023 15:50:26,Gemini_BTCUSD_1h_17_12_17_to_10_03_23.csv,BTC_USD,HOUR,102206.91,0.278,03/04/2018 10:00:00,03/04/2018 12:00:00,03/04/2018 12:00:00,EXPIRED,LONG,7363.0,7357.0,7534.36,0.0,0.02,2.27,0.0,47.64,2,0.0,-1.67
31/07/2019 00:00:00,16/06/2023 15:50:26,Gemini_BTCUSD_1h_17_12_17_to_10_03_23.csv,BTC_USD,HOUR,102205.24,0.21,31/07/2019 04:00:00,31/07/2019 03:00:00,31/07/2019 03:00:00,EXPIRED,LONG,9715.0,9690.0,10255.52,0.0,0.02,5.27,0.0,113.51,2,0.1,-5.25
06/04/2022 09:00:00,16/06/2023 15:50:26,Gemini_BTCUSD_1h_17_12_17_to_10_03_23.csv,BTC_USD,HOUR,102199.99,0.045,06/04/2022 13:00:00,06/04/2022 12:00:00,06/04/2022 12:00:00,EXPIRED,LONG,45333.0,44775.0,47489.49,0.0,0.02,4.54,0.0,97.04,2,0.0,-25.11
23/11/2019 16:00:00,16/06/2023 15:50:26,Gemini_BTCUSD_1h_17_12_17_to_10_03_23.csv,BTC_USD,HOUR,102174.88,0.279,23/11/2019 17:00:00,23/11/2019 19:00:00,23/11/2019 19:00:00,EXPIRED,LONG,7312.0,7291.0,7856.72,0.0,0.02,6.93,0.0,151.98,2,0.1,-5.86
15/09/2021 08:00:00,16/06/2023 15:50:26,Gemini_BTCUSD_1h_17_12_17_to_10_03_23.csv,BTC_USD,HOUR,102169.02,0.043,15/09/2021 12:00:00,15/09/2021 11:00:00,15/09/2021 11:00:00,EXPIRED,LONG,47073.0,47572.0,49600.64,0.0,0.02,5.1,0.0,108.69,2,0.1,21.46
08/11/2021 23:00:00,16/06/2023 15:50:26,Gemini_BTCUSD_1h_17_12_17_to_10_03_23.csv,BTC_USD,HOUR,102190.48,0.03,09/11/2021 00:00:00,09/11/2021 02:00:00,09/11/2021 02:00:00,EXPIRED,LONG,67552.0,67655.0,73576.64,0.0,0.02,8.19,0.0,180.74,2,0.1,3.09
24/12/2021 10:00:00,16/06/2023 15:50:26,Gemini_BTCUSD_1h_17_12_17_to_10_03_23.csv,BTC_USD,HOUR,102193.57,0.04,24/12/2021 12:00:00,24/12/2021 13:00:00,24/12/2021 13:00:00,EXPIRED,LONG,51217.0,51079.0,55296.26,0.0,0.02,7.38,0.0,163.17,2,0.1,-5.52
12/02/2021 12:00:00,16/06/2023 15:50:26,Gemini_BTCUSD_1h_17_12_17_to_10_03_23.csv,BTC_USD,HOUR,102188.05,0.043,12/02/2021 13:00:00,12/02/2021 15:00:00,12/02/2021 15:00:00,EXPIRED,LONG,47769.0,47151.0,50628.87,0.0,0.02,5.65,0.0,122.97,2,0.1,-26.57
16/02/2020 05:00:00,16/06/2023 15:50:26,Gemini_BTCUSD_1h_17_12_17_to_10_03_23.csv,BTC_USD,HOUR,102161.48,0.205,16/02/2020 07:00:00,16/02/2020 08:00:00,16/02/2020 08:00:00,EXPIRED,LONG,9964.0,9985.0,10358.54,0.0,0.02,3.81,0.0,80.88,2,0.0,4.31
12/09/2022 23:00:00,16/06/2023 15:50:26,Gemini_BTCUSD_1h_17_12_17_to_10_03_23.csv,BTC_USD,HOUR,102165.79,0.091,13/09/2022 02:00:00,13/09/2022 02:00:00,13/09/2022 02:00:00,EXPIRED,LONG,22407.0,22262.0,22912.71,0.0,0.02,2.21,0.0,46.02,2,0.0,-13.19
15/01/2020 03:00:00,16/06/2023 15:50:26,Gemini_BTCUSD_1h_17_12_17_to_10_03_23.csv,BTC_USD,HOUR,102152.6,0.234,15/01/2020 04:00:00,15/01/2020 06:00:00,15/01/2020 06:00:00,EXPIRED,LONG,8727.0,8659.0,9084.64,0.0,0.02,3.94,0.0,83.69,2,0.0,-15.91
11/04/2020 23:00:00,16/06/2023 15:50:26,Gemini_BTCUSD_1h_17_12_17_to_10_03_23.csv,BTC_USD,HOUR,102136.69,0.296,12/04/2020 01:00:00,12/04/2020 02:00:00,12/04/2020 02:00:00,EXPIRED,LONG,6892.0,6826.0,7139.29,0.0,0.02,3.46,0.0,73.2,2,0.0,-19.54
29/07/2019 18:00:00,16/06/2023 15:50:26,Gemini_BTCUSD_1h_17_12_17_to_10_03_23.csv,BTC_USD,HOUR,102117.15,0.215,29/07/2019 22:00:00,29/07/2019 21:00:00,29/07/2019 21:00:00,EXPIRED,LONG,9505.0,9505.0,9710.97,0.0,0.02,2.12,0.0,44.28,2,0.0,0.0
13/02/2021 23:00:00,16/06/2023 15:50:26,Gemini_BTCUSD_1h_17_12_17_to_10_03_23.csv,BTC_USD,HOUR,102117.15,0.043,14/02/2021 02:00:00,14/02/2021 02:00:00,14/02/2021 02:00:00,EXPIRED,LONG,47262.0,47496.0,51316.88,0.0,0.02,7.9,0.0,174.36,2,0.1,10.06
06/01/2021 16:00:00,16/06/2023 15:50:26,Gemini_BTCUSD_1h_17_12_17_to_10_03_23.csv,BTC_USD,HOUR,102127.21,0.059,06/01/2021 18:00:00,06/01/2021 19:00:00,06/01/2021 19:00:00,TAKE_PROFIT_HIT,LONG,34720.0,35624.55,35624.55,0.0,0.02,2.54,0.0,53.37,2,0.0,53.37
23/04/2018 12:00:00,16/06/2023 15:50:26,Gemini_BTCUSD_1h_17_12_17_to_10_03_23.csv,BTC_USD,HOUR,102180.58,0.228,23/04/2018 16:00:00,23/04/2018 15:00:00,23/04/2018 15:00:00,EXPIRED,LONG,8944.0,8900.0,9171.25,0.0,0.02,2.48,0.0,51.81,2,0.0,-10.03
29/06/2021 06:00:00,16/06/2023 15:50:26,Gemini_BTCUSD_1h_17_12_17_to_10_03_23.csv,BTC_USD,HOUR,102170.55,0.058,29/06/2021 08:00:00,29/06/2021 09:00:00,29/06/2021 09:00:00,EXPIRED,LONG,35312.0,35230.0,36050.29,0.0,0.02,2.05,0.0,42.82,2,0.0,-4.76
29/06/2018 17:00:00,16/06/2023 15:50:26,Gemini_BTCUSD_1h_17_12_17_to_10_03_23.csv,BTC_USD,HOUR,102165.79,0.347,29/06/2018 18:00:00,29/06/2018 20:00:00,29/06/2018 20:00:00,EXPIRED,LONG,5893.0,5892.0,6174.16,0.0,0.02,4.55,0.0,97.56,2,0.0,-0.35
24/03/2021 14:00:00,16/06/2023 15:50:26,Gemini_BTCUSD_1h_17_12_17_to_10_03_23.csv,BTC_USD,HOUR,102165.44,0.036,24/03/2021 15:00:00,24/03/2021 17:00:00,24/03/2021 17:00:00,EXPIRED,LONG,56494.0,56150.0,57777.41,0.0,0.02,2.22,0.0,46.2,2,0.0,-12.38
21/08/2021 18:00:00,16/06/2023 15:50:26,Gemini_BTCUSD_1h_17_12_17_to_10_03_23.csv,BTC_USD,HOUR,102153.06,0.041,21/08/2021 19:00:00,21/08/2021 21:00:00,21/08/2021 21:00:00,EXPIRED,LONG,49538.0,49200.0,51873.67,0.0,0.02,4.5,0.0,95.76,2,0.0,-13.86
10/02/2022 11:00:00,16/06/2023 15:50:26,Gemini_BTCUSD_1h_17_12_17_to_10_03_23.csv,BTC_USD,HOUR,102139.2,0.046,10/02/2022 12:00:00,10/02/2022 14:00:00,10/02/2022 14:00:00,EXPIRED,LONG,44875.0,44358.0,48117.13,0.0,0.02,6.74,0.0,149.14,2,0.1,-23.78
20/07/2021 13:00:00,16/06/2023 15:50:26,Gemini_BTCUSD_1h_17_12_17_to_10_03_23.csv,BTC_USD,HOUR,102115.42,0.069,20/07/2021 16:00:00,20/07/2021 16:00:00,20/07/2021 16:00:00,EXPIRED,LONG,29524.0,29669.0,31428.52,0.0,0.02,6.06,0.0,131.41,2,0.1,10.01
27/07/2020 11:00:00,16/06/2023 15:50:26,Gemini_BTCUSD_1h_17_12_17_to_10_03_23.csv,BTC_USD,HOUR,102125.43,0.199,27/07/2020 12:00:00,27/07/2020 14:00:00,27/07/2020 14:00:00,EXPIRED,LONG,10268.0,10429.0,10709.01,0.0,0.02,4.12,0.0,87.76,2,0.0,32.04
11/09/2018 00:00:00,16/06/2023 15:50:26,Gemini_BTCUSD_1h_17_12_17_to_10_03_23.csv,BTC_USD,HOUR,102157.47,0.324,11/09/2018 03:00:00,11/09/2018 03:00:00,11/09/2018 03:00:00,EXPIRED,LONG,6311.0,6347.0,6577.99,0.0,0.02,4.06,0.0,86.5,2,0.0,11.66
10/06/2022 07:00:00,16/06/2023 15:50:26,Gemini_BTCUSD_1h_17_12_17_to_10_03_23.csv,BTC_USD,HOUR,102169.13,0.068,10/06/2022 08:00:00,10/06/2022 10:00:00,10/06/2022 10:00:00,EXPIRED,LONG,30028.0,29961.0,31331.97,0.0,0.02,4.16,0.0,88.67,2,0.0,-4.56
01/03/2019 11:00:00,16/06/2023 15:50:26,Gemini_BTCUSD_1h_17_12_17_to_10_03_23.csv,BTC_USD,HOUR,102164.57,0.536,01/03/2019 12:00:00,01/03/2019 14:00:00,01/03/2019 14:00:00,EXPIRED,LONG,3810.0,3818.0,4089.13,0.0,0.02,6.83,0.0,149.61,2,0.1,4.29
24/07/2018 20:00:00,16/06/2023 15:50:26,Gemini_BTCUSD_1h_17_12_17_to_10_03_23.csv,BTC_USD,HOUR,102168.86,0.248,24/07/2018 21:00:00,24/07/2018 23:00:00,24/07/2018 23:00:00,TAKE_PROFIT_HIT,LONG,8227.0,8405.72,8405.72,0.0,0.02,2.13,0.0,44.32,2,0.0,44.32
08/10/2021 03:00:00,16/06/2023 15:50:26,Gemini_BTCUSD_1h_17_12_17_to_10_03_23.csv,BTC_USD,HOUR,102213.18,0.038,08/10/2021 06:00:00,08/10/2021 06:00:00,08/10/2021 06:00:00,EXPIRED,LONG,53827.0,54154.0,55314.31,0.0,0.02,2.69,0.0,56.52,2,0.0,12.43
07/06/2019 20:00:00,16/06/2023 15:50:26,Gemini_BTCUSD_1h_17_12_17_to_10_03_23.csv,BTC_USD,HOUR,102225.61,0.259,07/06/2019 21:00:00,07/06/2019 23:00:00,07/06/2019 23:00:00,EXPIRED,LONG,7904.0,8003.0,8221.63,0.0,0.02,3.86,0.0,82.27,2,0.0,25.64
05/01/2018 12:00:00,16/06/2023 15:50:26,Gemini_BTCUSD_1h_17_12_17_to_10_03_23.csv,BTC_USD,HOUR,102251.25,0.129,05/01/2018 13:00:00,05/01/2018 15:00:00,05/01/2018 15:00:00,EXPIRED,LONG,15864.0,16042.0,17076.88,0.0,0.02,7.1,0.0,156.46,2,0.1,22.96
20/04/2021 00:00:00,16/06/2023 15:50:26,Gemini_BTCUSD_1h_17_12_17_to_10_03_23.csv,BTC_USD,HOUR,102274.21,0.037,20/04/2021 04:00:00,20/04/2021 03:00:00,20/04/2021 03:00:00,EXPIRED,LONG,54718.0,54587.0,56130.94,0.0,0.02,2.52,0.0,52.28,2,0.0,-4.85
05/02/2022 11:00:00,16/06/2023 15:50:26,Gemini_BTCUSD_1h_17_12_17_to_10_03_23.csv,BTC_USD,HOUR,102269.36,0.049,05/02/2022 12:00:00,05/02/2022 14:00:00,05/02/2022 14:00:00,EXPIRED,LONG,41484.0,41507.0,45101.65,0.0,0.02,8.02,0.0,177.26,2,0.1,1.13
02/12/2018 23:00:00,16/06/2023 15:50:26,Gemini_BTCUSD_1h_17_12_17_to_10_03_23.csv,BTC_USD,HOUR,102270.49,0.499,03/12/2018 00:00:00,03/12/2018 02:00:00,03/12/2018 02:00:00,EXPIRED,LONG,4101.0,3939.0,4359.46,0.0,0.02,5.93,0.0,128.97,2,0.1,-80.84
16/02/2018 22:00:00,16/06/2023 15:50:26,Gemini_BTCUSD_1h_17_12_17_to_10_03_23.csv,BTC_USD,HOUR,102189.65,0.2,16/02/2018 23:00:00,17/02/2018 01:00:00,17/02/2018 01:00:00,EXPIRED,LONG,10210.0,10350.0,10608.19,0.0,0.02,3.75,0.0,79.64,2,0.0,28.0
15/07/2019 17:00:00,16/06/2023 15:50:26,Gemini_BTCUSD_1h_17_12_17_to_10_03_23.csv,BTC_USD,HOUR,102217.65,0.194,15/07/2019 18:00:00,15/07/2019 20:00:00,15/07/2019 20:00:00,EXPIRED,LONG,10522.0,10832.0,11179.14,0.0,0.02,5.88,0.0,127.49,2,0.1,60.14
20/11/2020 09:00:00,16/06/2023 15:50:26,Gemini_BTCUSD_1h_17_12_17_to_10_03_23.csv,BTC_USD,HOUR,102277.79,0.112,20/11/2020 10:00:00,20/11/2020 12:00:00,20/11/2020 12:00:00,EXPIRED,LONG,18210.0,18248.0,18901.9,0.0,0.02,3.66,0.0,77.49,2,0.0,4.26
08/12/2018 10:00:00,16/06/2023 15:50:26,Gemini_BTCUSD_1h_17_12_17_to_10_03_23.csv,BTC_USD,HOUR,102282.05,0.604,08/12/2018 11:00:00,08/12/2018 13:00:00,08/12/2018 13:00:00,EXPIRED,LONG,3385.0,3327.0,3462.86,0.0,0.02,2.25,0.0,47.03,2,0.0,-35.03
05/06/2018 19:00:00,16/06/2023 15:50:26,Gemini_BTCUSD_1h_17_12_17_to_10_03_23.csv,BTC_USD,HOUR,102247.02,0.269,05/06/2018 20:00:00,05/06/2018 22:00:00,05/06/2018 22:00:00,EXPIRED,LONG,7605.0,7624.0,7801.24,0.0,0.02,2.52,0.0,52.79,2,0.0,5.11
22/10/2021 09:00:00,16/06/2023 15:50:26,Gemini_BTCUSD_1h_17_12_17_to_10_03_23.csv,BTC_USD,HOUR,102252.13,0.032,22/10/2021 12:00:00,22/10/2021 12:00:00,22/10/2021 12:00:00,EXPIRED,LONG,63316.0,63653.0,64959.48,0.0,0.02,2.53,0.0,52.59,2,0.0,10.78
23/07/2021 03:00:00,16/06/2023 15:50:26,Gemini_BTCUSD_1h_17_12_17_to_10_03_23.csv,BTC_USD,HOUR,102262.91,0.063,23/07/2021 04:00:00,23/07/2021 06:00:00,23/07/2021 06:00:00,EXPIRED,LONG,32598.0,32592.0,34998.7,0.0,0.02,6.86,0.0,151.24,2,0.1,-0.38
18/02/2021 16:00:00,16/06/2023 15:50:26,Gemini_BTCUSD_1h_17_12_17_to_10_03_23.csv,BTC_USD,HOUR,102262.53,0.039,18/02/2021 18:00:00,18/02/2021 19:00:00,18/02/2021 19:00:00,EXPIRED,LONG,52066.0,51770.0,56789.51,0.0,0.02,8.32,0.0,184.22,2,0.1,-11.54
03/01/2020 17:00:00,16/06/2023 15:50:26,Gemini_BTCUSD_1h_17_12_17_to_10_03_23.csv,BTC_USD,HOUR,102250.99,0.278,03/01/2020 18:00:00,03/01/2020 20:00:00,03/01/2020 20:00:00,EXPIRED,LONG,7352.0,7312.0,7737.4,0.0,0.02,4.98,0.0,107.14,2,0.1,-11.12
24/06/2021 03:00:00,16/06/2023 15:50:26,Gemini_BTCUSD_1h_17_12_17_to_10_03_23.csv,BTC_USD,HOUR,102239.87,0.063,24/06/2021 06:00:00,24/06/2021 06:00:00,24/06/2021 06:00:00,EXPIRED,LONG,32607.0,33012.0,33356.46,0.0,0.02,2.25,0.0,47.22,2,0.0,25.52
15/03/2022 19:00:00,16/06/2023 15:50:26,Gemini_BTCUSD_1h_17_12_17_to_10_03_23.csv,BTC_USD,HOUR,102265.39,0.051,15/03/2022 21:00:00,15/03/2022 22:00:00,15/03/2022 22:00:00,EXPIRED,LONG,39737.0,39489.0,42946.33,0.0,0.02,7.47,0.0,163.68,2,0.1,-12.65
12/02/2018 09:00:00,16/06/2023 15:50:26,Gemini_BTCUSD_1h_17_12_17_to_10_03_23.csv,BTC_USD,HOUR,102252.74,0.232,12/02/2018 10:00:00,12/02/2018 12:00:00,12/02/2018 12:00:00,EXPIRED,LONG,8800.0,8781.0,9503.99,0.0,0.02,7.41,0.0,163.33,2,0.1,-4.41
17/05/2018 17:00:00,16/06/2023 15:50:26,Gemini_BTCUSD_1h_17_12_17_to_10_03_23.csv,BTC_USD,HOUR,102248.33,0.248,17/05/2018 18:00:00,17/05/2018 20:00:00,17/05/2018 20:00:00,EXPIRED,LONG,8250.0,8205.0,8701.1,0.0,0.02,5.18,0.0,111.87,2,0.1,-11.16
27/12/2021 07:00:00,16/06/2023 15:50:26,Gemini_BTCUSD_1h_17_12_17_to_10_03_23.csv,BTC_USD,HOUR,102237.17,0.04,27/12/2021 11:00:00,27/12/2021 10:00:00,27/12/2021 10:00:00,EXPIRED,LONG,50735.0,50829.0,52911.1,0.0,0.02,4.11,0.0,87.04,2,0.0,3.76
06/07/2021 03:00:00,16/06/2023 15:50:26,Gemini_BTCUSD_1h_17_12_17_to_10_03_23.csv,BTC_USD,HOUR,102240.93,0.06,06/07/2021 04:00:00,06/07/2021 06:00:00,06/07/2021 04:00:00,TAKE_PROFIT_HIT,LONG,33942.0,34786.23,34786.23,0.0,0.02,2.43,0.0,50.65,2,0.0,50.65
18/12/2020 07:00:00,16/06/2023 15:50:26,Gemini_BTCUSD_1h_17_12_17_to_10_03_23.csv,BTC_USD,HOUR,102291.58,0.089,18/12/2020 10:00:00,18/12/2020 10:00:00,18/12/2020 10:00:00,EXPIRED,LONG,23049.0,22960.0,23566.98,0.0,0.02,2.2,0.0,46.1,2,0.0,-7.92
21/10/2020 14:00:00,16/06/2023 15:50:26,Gemini_BTCUSD_1h_17_12_17_to_10_03_23.csv,BTC_USD,HOUR,102283.66,0.16,21/10/2020 15:00:00,21/10/2020 17:00:00,21/10/2020 17:00:00,EXPIRED,LONG,12755.0,12786.0,13819.99,0.0,0.02,7.71,0.0,170.4,2,0.1,4.96
22/11/2018 18:00:00,16/06/2023 15:50:26,Gemini_BTCUSD_1h_17_12_17_to_10_03_23.csv,BTC_USD,HOUR,102288.62,0.461,22/11/2018 21:00:00,22/11/2018 21:00:00,22/11/2018 21:00:00,EXPIRED,LONG,4434.0,4430.0,4598.28,0.0,0.02,3.57,0.0,75.73,2,0.0,-1.84
25/12/2021 08:00:00,16/06/2023 15:50:26,Gemini_BTCUSD_1h_17_12_17_to_10_03_23.csv,BTC_USD,HOUR,102286.78,0.04,25/12/2021 09:00:00,25/12/2021 11:00:00,25/12/2021 11:00:00,EXPIRED,LONG,50925.0,50680.0,53236.68,0.0,0.02,4.34,0.0,92.47,2,0.0,-9.8
19/12/2018 01:00:00,16/06/2023 15:50:26,Gemini_BTCUSD_1h_17_12_17_to_10_03_23.csv,BTC_USD,HOUR,102276.98,0.554,19/12/2018 02:00:00,19/12/2018 04:00:00,19/12/2018 04:00:00,EXPIRED,LONG,3691.0,3713.0,3861.49,0.0,0.02,4.42,0.0,94.45,2,0.0,12.19
02/07/2022 18:00:00,16/06/2023 15:50:26,Gemini_BTCUSD_1h_17_12_17_to_10_03_23.csv,BTC_USD,HOUR,102289.17,0.106,02/07/2022 22:00:00,02/07/2022 21:00:00,02/07/2022 21:00:00,EXPIRED,LONG,19293.0,19332.0,19725.16,0.0,0.02,2.19,0.0,45.81,2,0.0,4.13
04/01/2020 17:00:00,16/06/2023 15:50:26,Gemini_BTCUSD_1h_17_12_17_to_10_03_23.csv,BTC_USD,HOUR,102293.3,0.279,04/01/2020 21:00:00,04/01/2020 20:00:00,04/01/2020 20:00:00,EXPIRED,LONG,7338.0,7330.0,7546.09,0.0,0.02,2.76,0.0,58.06,2,0.0,-2.23
16/01/2023 04:00:00,16/06/2023 15:50:26,Gemini_BTCUSD_1h_17_12_17_to_10_03_23.csv,BTC_USD,HOUR,102291.07,0.097,16/01/2023 05:00:00,16/01/2023 07:00:00,16/01/2023 07:00:00,EXPIRED,LONG,21164.0,21129.0,22873.42,0.0,0.02,7.47,0.0,165.81,2,0.1,-3.39
29/12/2019 07:00:00,16/06/2023 15:50:26,Gemini_BTCUSD_1h_17_12_17_to_10_03_23.csv,BTC_USD,HOUR,102287.68,0.28,29/12/2019 10:00:00,29/12/2019 10:00:00,29/12/2019 10:00:00,EXPIRED,LONG,7304.0,7305.0,7473.56,0.0,0.02,2.27,0.0,47.48,2,0.0,0.28
26/03/2019 23:00:00,16/06/2023 15:50:26,Gemini_BTCUSD_1h_17_12_17_to_10_03_23.csv,BTC_USD,HOUR,102287.96,0.522,27/03/2019 03:00:00,27/03/2019 02:00:00,27/03/2019 02:00:00,EXPIRED,LONG,3920.0,3976.0,4120.5,0.0,0.02,4.87,0.0,104.66,2,0.1,29.23
13/01/2018 18:00:00,16/06/2023 15:50:26,Gemini_BTCUSD_1h_17_12_17_to_10_03_23.csv,BTC_USD,HOUR,102317.19,0.143,13/01/2018 20:00:00,13/01/2018 21:00:00,13/01/2018 21:00:00,EXPIRED,LONG,14268.0,14167.0,14603.28,0.0,0.02,2.3,0.0,47.95,2,0.0,-14.44
12/01/2021 08:00:00,16/06/2023 15:50:26,Gemini_BTCUSD_1h_17_12_17_to_10_03_23.csv,BTC_USD,HOUR,102302.75,0.057,12/01/2021 09:00:00,12/01/2021 11:00:00,12/01/2021 11:00:00,EXPIRED,LONG,35743.0,35391.0,37954.86,0.0,0.02,5.83,0.0,126.08,2,0.1,-20.06
15/05/2022 01:00:00,16/06/2023 15:50:26,Gemini_BTCUSD_1h_17_12_17_to_10_03_23.csv,BTC_USD,HOUR,102282.69,0.068,15/05/2022 02:00:00,15/05/2022 04:00:00,15/05/2022 04:00:00,EXPIRED,LONG,29898.0,29582.0,32235.6,0.0,0.02,7.25,0.0,158.96,2,0.1,-21.49
09/02/2023 15:00:00,16/06/2023 15:50:26,Gemini_BTCUSD_1h_17_12_17_to_10_03_23.csv,BTC_USD,HOUR,102261.2,0.09,09/02/2023 16:00:00,09/02/2023 18:00:00,09/02/2023 18:00:00,EXPIRED,LONG,22616.0,22512.0,24135.63,0.0,0.02,6.3,0.0,136.77,2,0.1,-9.36
15/05/2022 23:00:00,16/06/2023 15:50:26,Gemini_BTCUSD_1h_17_12_17_to_10_03_23.csv,BTC_USD,HOUR,102251.84,0.065,16/05/2022 00:00:00,16/05/2022 02:00:00,16/05/2022 02:00:00,EXPIRED,LONG,31291.0,30458.0,32824.72,0.0,0.02,4.67,0.0,99.69,2,0.0,-54.14
18/02/2022 05:00:00,16/06/2023 15:50:26,Gemini_BTCUSD_1h_17_12_17_to_10_03_23.csv,BTC_USD,HOUR,102197.7,0.05,18/02/2022 09:00:00,18/02/2022 08:00:00,18/02/2022 08:00:00,EXPIRED,LONG,40651.0,40908.0,41675.41,0.0,0.02,2.46,0.0,51.22,2,0.0,12.85
01/11/2020 17:00:00,16/06/2023 15:50:26,Gemini_BTCUSD_1h_17_12_17_to_10_03_23.csv,BTC_USD,HOUR,102210.55,0.148,01/11/2020 18:00:00,01/11/2020 20:00:00,01/11/2020 20:00:00,EXPIRED,LONG,13824.0,13835.0,14689.95,0.0,0.02,5.89,0.0,128.16,2,0.1,1.63
11/02/2023 13:00:00,16/06/2023 15:50:26,Gemini_BTCUSD_1h_17_12_17_to_10_03_23.csv,BTC_USD,HOUR,102212.18,0.094,11/02/2023 17:00:00,11/02/2023 16:00:00,11/02/2023 16:00:00,EXPIRED,LONG,21759.0,21702.0,23611.61,0.0,0.02,7.85,0.0,174.15,2,0.1,-5.36
22/08/2022 11:00:00,16/06/2023 15:50:26,Gemini_BTCUSD_1h_17_12_17_to_10_03_23.csv,BTC_USD,HOUR,102206.82,0.096,22/08/2022 12:00:00,22/08/2022 14:00:00,22/08/2022 14:00:00,EXPIRED,LONG,21250.0,21197.0,22038.17,0.0,0.02,3.58,0.0,75.66,2,0.0,-5.09
03/06/2021 04:00:00,16/06/2023 15:50:26,Gemini_BTCUSD_1h_17_12_17_to_10_03_23.csv,BTC_USD,HOUR,102201.73,0.054,03/06/2021 08:00:00,03/06/2021 07:00:00,03/06/2021 05:00:00,TAKE_PROFIT_HIT,LONG,37984.0,38864.94,38864.94,0.0,0.02,2.27,0.0,47.57,2,0.0,47.57
28/04/2018 12:00:00,16/06/2023 15:50:26,Gemini_BTCUSD_1h_17_12_17_to_10_03_23.csv,BTC_USD,HOUR,102249.3,0.218,28/04/2018 13:00:00,28/04/2018 15:00:00,28/04/2018 15:00:00,EXPIRED,LONG,9363.0,9348.0,10156.98,0.0,0.02,7.82,0.0,173.09,2,0.1,-3.27
02/03/2022 04:00:00,16/06/2023 15:50:26,Gemini_BTCUSD_1h_17_12_17_to_10_03_23.csv,BTC_USD,HOUR,102246.03,0.046,02/03/2022 07:00:00,02/03/2022 07:00:00,02/03/2022 07:00:00,EXPIRED,LONG,44280.0,43971.0,46894.81,0.0,0.02,5.58,0.0,120.28,2,0.1,-14.21
17/02/2023 16:00:00,16/06/2023 15:50:26,Gemini_BTCUSD_1h_17_12_17_to_10_03_23.csv,BTC_USD,HOUR,102231.82,0.085,17/02/2023 17:00:00,17/02/2023 19:00:00,17/02/2023 19:00:00,EXPIRED,LONG,24084.0,24538.0,25975.38,0.0,0.02,7.28,0.0,160.77,2,0.1,38.59
03/05/2021 02:00:00,16/06/2023 15:50:26,Gemini_BTCUSD_1h_17_12_17_to_10_03_23.csv,BTC_USD,HOUR,102270.41,0.035,03/05/2021 03:00:00,03/05/2021 05:00:00,03/05/2021 05:00:00,EXPIRED,LONG,58086.0,57972.0,59304.47,0.0,0.02,2.05,0.0,42.65,2,0.0,-3.99
04/08/2019 18:00:00,16/06/2023 15:50:26,Gemini_BTCUSD_1h_17_12_17_to_10_03_23.csv,BTC_USD,HOUR,102266.42,0.187,04/08/2019 19:00:00,04/08/2019 21:00:00,04/08/2019 21:00:00,EXPIRED,LONG,10944.0,10969.0,11524.26,0.0,0.02,5.04,0.0,108.51,2,0.1,4.68
01/09/2022 23:00:00,16/06/2023 15:50:26,Gemini_BTCUSD_1h_17_12_17_to_10_03_23.csv,BTC_USD,HOUR,102271.1,0.102,02/09/2022 00:00:00,02/09/2022 02:00:00,02/09/2022 02:00:00,EXPIRED,LONG,20120.0,20035.0,21156.89,0.0,0.02,4.9,0.0,105.76,2,0.1,-8.67
17/02/2023 16:00:00,16/06/2023 15:50:26,Gemini_BTCUSD_1h_17_12_17_to_10_03_23.csv,BTC_USD,HOUR,102262.43,0.085,17/02/2023 17:00:00,17/02/2023 19:00:00,17/02/2023 19:00:00,EXPIRED,LONG,24084.0,24538.0,25975.38,0.0,0.02,7.28,0.0,160.77,2,0.1,38.59
07/01/2019 12:00:00,16/06/2023 15:50:26,Gemini_BTCUSD_1h_17_12_17_to_10_03_23.csv,BTC_USD,HOUR,102301.02,0.512,07/01/2019 14:00:00,07/01/2019 15:00:00,07/01/2019 15:00:00,EXPIRED,LONG,3996.0,4011.0,4229.62,0.0,0.02,5.52,0.0,119.61,2,0.1,7.68
28/01/2021 09:00:00,16/06/2023 15:50:26,Gemini_BTCUSD_1h_17_12_17_to_10_03_23.csv,BTC_USD,HOUR,102308.7,0.065,28/01/2021 12:00:00,28/01/2021 12:00:00,28/01/2021 12:00:00,EXPIRED,LONG,31500.0,31516.0,32224.02,0.0,0.02,2.25,0.0,47.06,2,0.0,1.04
03/04/2022 22:00:00,16/06/2023 15:50:26,Gemini_BTCUSD_1h_17_12_17_to_10_03_23.csv,BTC_USD,HOUR,102309.74,0.044,04/04/2022 01:00:00,04/04/2022 01:00:00,04/04/2022 01:00:00,EXPIRED,LONG,46696.0,45870.0,48347.48,0.0,0.02,3.42,0.0,72.67,2,0.0,-36.34
07/05/2022 02:00:00,16/06/2023 15:50:26,Gemini_BTCUSD_1h_17_12_17_to_10_03_23.csv,BTC_USD,HOUR,102273.4,0.057,07/05/2022 03:00:00,07/05/2022 05:00:00,07/05/2022 05:00:00,EXPIRED,LONG,35943.0,35876.0,38284.95,0.0,0.02,6.12,0.0,133.49,2,0.1,-3.82
15/01/2020 22:00:00,16/06/2023 15:50:26,Gemini_BTCUSD_1h_17_12_17_to_10_03_23.csv,BTC_USD,HOUR,102269.58,0.231,15/01/2020 23:00:00,16/01/2020 01:00:00,16/01/2020 01:00:00,EXPIRED,LONG,8845.0,8649.0,9370.76,0.0,0.02,5.61,0.0,121.45,2,0.1,-45.28
22/02/2022 07:00:00,16/06/2023 15:50:26,Gemini_BTCUSD_1h_17_12_17_to_10_03_23.csv,BTC_USD,HOUR,102224.3,0.056,22/02/2022 10:00:00,22/02/2022 10:00:00,22/02/2022 10:00:00,EXPIRED,LONG,36776.0,37727.0,38168.49,0.0,0.02,3.65,0.0,77.98,2,0.0,53.26
01/08/2019 20:00:00,16/06/2023 15:50:26,Gemini_BTCUSD_1h_17_12_17_to_10_03_23.csv,BTC_USD,HOUR,102277.56,0.197,01/08/2019 21:00:00,01/08/2019 23:00:00,01/08/2019 23:00:00,EXPIRED,LONG,10406.0,10410.0,11234.06,0.0,0.02,7.37,0.0,163.13,2,0.1,0.79
13/06/2019 20:00:00,16/06/2023 15:50:26,Gemini_BTCUSD_1h_17_12_17_to_10_03_23.csv,BTC_USD,HOUR,102278.35,0.248,13/06/2019 22:00:00,13/06/2019 23:00:00,13/06/2019 23:00:00,EXPIRED,LONG,8261.0,8256.0,8566.27,0.0,0.02,3.56,0.0,75.71,2,0.0,-1.24
18/03/2019 18:00:00,16/06/2023 15:50:26,Gemini_BTCUSD_1h_17_12_17_to_10_03_23.csv,BTC_USD,HOUR,102277.11,0.517,18/03/2019 21:00:00,18/03/2019 21:00:00,18/03/2019 21:00:00,EXPIRED,LONG,3959.0,3976.0,4128.66,0.0,0.02,4.11,0.0,87.71,2,0.0,8.79
13/11/2019 20:00:00,16/06/2023 15:50:26,Gemini_BTCUSD_1h_17_12_17_to_10_03_23.csv,BTC_USD,HOUR,102285.9,0.234,13/11/2019 21:00:00,13/11/2019 23:00:00,13/11/2019 23:00:00,EXPIRED,LONG,8745.0,8762.0,9384.14,0.0,0.02,6.81,0.0,149.56,2,0.1,3.98
06/01/2018 17:00:00,16/06/2023 15:50:26,Gemini_BTCUSD_1h_17_12_17_to_10_03_23.csv,BTC_USD,HOUR,102289.88,0.121,06/01/2018 19:00:00,06/01/2018 20:00:00,06/01/2018 20:00:00,EXPIRED,LONG,16876.0,16849.0,18343.35,0.0,0.02,8.0,0.0,177.55,2,0.1,-3.27
23/07/2018 04:00:00,16/06/2023 15:50:26,Gemini_BTCUSD_1h_17_12_17_to_10_03_23.csv,BTC_USD,HOUR,102286.61,0.267,23/07/2018 05:00:00,23/07/2018 07:00:00,23/07/2018 07:00:00,EXPIRED,LONG,7669.0,7741.0,7953.67,0.0,0.02,3.58,0.0,76.01,2,0.0,19.22
18/07/2021 02:00:00,16/06/2023 15:50:26,Gemini_BTCUSD_1h_17_12_17_to_10_03_23.csv,BTC_USD,HOUR,102305.83,0.064,18/07/2021 05:00:00,18/07/2021 05:00:00,18/07/2021 05:00:00,EXPIRED,LONG,32212.0,32070.0,33005.65,0.0,0.02,2.4,0.0,50.79,2,0.0,-9.09
27/05/2022 14:00:00,16/06/2023 15:50:26,Gemini_BTCUSD_1h_17_12_17_to_10_03_23.csv,BTC_USD,HOUR,102296.74,0.071,27/05/2022 16:00:00,27/05/2022 17:00:00,27/05/2022 17:00:00,EXPIRED,LONG,28759.0,28338.0,30478.02,0.0,0.02,5.64,0.0,122.05,2,0.1,-29.89
31/07/2020 12:00:00,16/06/2023 15:50:26,Gemini_BTCUSD_1h_17_12_17_to_10_03_23.csv,BTC_USD,HOUR,102266.85,0.182,31/07/2020 15:00:00,31/07/2020 15:00:00,31/07/2020 15:00:00,EXPIRED,LONG,11240.0,11375.0,11505.35,0.0,0.02,2.31,0.0,48.29,2,0.0,24.57
14/10/2019 19:00:00,16/06/2023 15:50:26,Gemini_BTCUSD_1h_17_12_17_to_10_03_23.csv,BTC_USD,HOUR,102291.42,0.245,14/10/2019 20:00:00,14/10/2019 22:00:00,14/10/2019 22:00:00,EXPIRED,LONG,8335.0,8347.0,8953.76,0.0,0.02,6.91,0.0,151.6,2,0.1,2.94
04/07/2019 13:00:00,16/06/2023 15:50:26,Gemini_BTCUSD_1h_17_12_17_to_10_03_23.csv,BTC_USD,HOUR,102294.36,0.172,04/07/2019 14:00:00,04/07/2019 16:00:00,04/07/2019 16:00:00,EXPIRED,LONG,11872.0,11787.0,12563.78,0.0,0.02,5.51,0.0,118.99,2,0.1,-14.62
19/01/2023 08:00:00,16/06/2023 15:50:26,Gemini_BTCUSD_1h_17_12_17_to_10_03_23.csv,BTC_USD,HOUR,102279.74,0.098,19/01/2023 09:00:00,19/01/2023 11:00:00,19/01/2023 11:00:00,EXPIRED,LONG,20769.0,20735.0,22456.41,0.0,0.02,7.51,0.0,165.37,2,0.1,-3.33
24/02/2019 00:00:00,16/06/2023 15:50:26,Gemini_BTCUSD_1h_17_12_17_to_10_03_23.csv,BTC_USD,HOUR,102276.41,0.496,24/02/2019 01:00:00,24/02/2019 03:00:00,24/02/2019 03:00:00,EXPIRED,LONG,4125.0,4161.0,4233.68,0.0,0.02,2.57,0.0,53.91,2,0.0,17.86
24/01/2019 20:00:00,16/06/2023 15:50:26,Gemini_BTCUSD_1h_17_12_17_to_10_03_23.csv,BTC_USD,HOUR,102294.27,0.573,25/01/2019 00:00:00,24/01/2019 23:00:00,24/01/2019 23:00:00,EXPIRED,LONG,3569.0,3570.0,3703.75,0.0,0.02,3.64,0.0,77.21,2,0.0,0.57
12/05/2019 08:00:00,16/06/2023 15:50:26,Gemini_BTCUSD_1h_17_12_17_to_10_03_23.csv,BTC_USD,HOUR,102294.84,0.275,12/05/2019 09:00:00,12/05/2019 11:00:00,12/05/2019 11:00:00,EXPIRED,LONG,7435.0,7199.0,7843.63,0.0,0.02,5.21,0.0,112.37,2,0.1,-64.9
28/12/2017 13:00:00,16/06/2023 15:50:26,Gemini_BTCUSD_1h_17_12_17_to_10_03_23.csv,BTC_USD,HOUR,102229.94,0.144,28/12/2017 17:00:00,28/12/2017 16:00:00,28/12/2017 16:00:00,EXPIRED,LONG,14221.0,13994.0,15389.65,0.0,0.02,7.59,0.0,168.29,2,0.1,-32.69
22/06/2021 03:00:00,16/06/2023 15:50:26,Gemini_BTCUSD_1h_17_12_17_to_10_03_23.csv,BTC_USD,HOUR,102197.25,0.062,22/06/2021 04:00:00,22/06/2021 06:00:00,22/06/2021 06:00:00,EXPIRED,LONG,33030.0,32849.0,35692.83,0.0,0.02,7.46,0.0,165.1,2,0.1,-11.22
26/12/2017 03:00:00,16/06/2023 15:50:26,Gemini_BTCUSD_1h_17_12_17_to_10_03_23.csv,BTC_USD,HOUR,102186.03,0.139,26/12/2017 04:00:00,26/12/2017 06:00:00,26/12/2017 06:00:00,EXPIRED,LONG,14690.0,15471.0,15630.9,0.0,0.02,6.02,0.0,130.79,2,0.1,108.56
30/06/2020 23:00:00,16/06/2023 15:50:26,Gemini_BTCUSD_1h_17_12_17_to_10_03_23.csv,BTC_USD,HOUR,102294.59,0.224,01/07/2020 00:00:00,01/07/2020 02:00:00,01/07/2020 02:00:00,EXPIRED,LONG,9133.0,9137.0,9534.22,0.0,0.02,4.21,0.0,89.87,2,0.0,0.9
24/12/2022 04:00:00,16/06/2023 15:50:26,Gemini_BTCUSD_1h_17_12_17_to_10_03_23.csv,BTC_USD,HOUR,102295.49,0.122,24/12/2022 05:00:00,24/12/2022 07:00:00,24/12/2022 07:00:00,EXPIRED,LONG,16834.0,16852.0,18034.22,0.0,0.02,6.66,0.0,146.43,2,0.1,2.2
25/10/2018 16:00:00,16/06/2023 15:50:26,Gemini_BTCUSD_1h_17_12_17_to_10_03_23.csv,BTC_USD,HOUR,102297.69,0.32,25/10/2018 18:00:00,25/10/2018 19:00:00,25/10/2018 19:00:00,EXPIRED,LONG,6391.0,6408.0,6530.37,0.0,0.02,2.13,0.0,44.6,2,0.0,5.44
01/09/2021 01:00:00,16/06/2023 15:50:26,Gemini_BTCUSD_1h_17_12_17_to_10_03_23.csv,BTC_USD,HOUR,102303.13,0.044,01/09/2021 02:00:00,01/09/2021 04:00:00,01/09/2021 04:00:00,EXPIRED,LONG,46867.0,47134.0,47963.69,0.0,0.02,2.29,0.0,48.25,2,0.0,11.75
13/05/2020 10:00:00,16/06/2023 15:50:26,Gemini_BTCUSD_1h_17_12_17_to_10_03_23.csv,BTC_USD,HOUR,102314.88,0.228,13/05/2020 12:00:00,13/05/2020 13:00:00,13/05/2020 11:00:00,TAKE_PROFIT_HIT,LONG,8961.0,8982.02,8982.02,0.0,0.02,0.23,0.0,4.79,2,0.0,4.79
24/08/2022 17:00:00,16/06/2023 15:50:26,Gemini_BTCUSD_1h_17_12_17_to_10_03_23.csv,BTC_USD,HOUR,102319.67,0.095,24/08/2022 21:00:00,24/08/2022 20:00:00,24/08/2022 20:00:00,EXPIRED,LONG,21632.0,21692.0,22178.82,0.0,0.02,2.47,0.0,51.95,2,0.0,5.7
10/02/2020 01:00:00,16/06/2023 15:50:26,Gemini_BTCUSD_1h_17_12_17_to_10_03_23.csv,BTC_USD,HOUR,102325.37,0.202,10/02/2020 02:00:00,10/02/2020 04:00:00,10/02/2020 04:00:00,EXPIRED,LONG,10142.0,10057.0,10368.08,0.0,0.02,2.18,0.0,45.67,2,0.0,-17.17
20/01/2018 19:00:00,16/06/2023 15:50:26,Gemini_BTCUSD_1h_17_12_17_to_10_03_23.csv,BTC_USD,HOUR,102308.2,0.161,20/01/2018 21:00:00,20/01/2018 22:00:00,20/01/2018 22:00:00,EXPIRED,LONG,12748.0,12850.0,12976.26,0.0,0.02,1.76,0.0,36.75,2,0.0,16.42
01/10/2020 01:00:00,16/06/2023 15:50:26,Gemini_BTCUSD_1h_17_12_17_to_10_03_23.csv,BTC_USD,HOUR,102324.62,0.189,01/10/2020 02:00:00,01/10/2020 04:00:00,01/10/2020 04:00:00,EXPIRED,LONG,10840.0,10809.0,11089.9,0.0,0.02,2.25,0.0,47.23,2,0.0,-5.86
08/06/2018 18:00:00,16/06/2023 15:50:26,Gemini_BTCUSD_1h_17_12_17_to_10_03_23.csv,BTC_USD,HOUR,102318.76,0.268,08/06/2018 20:00:00,08/06/2018 21:00:00,08/06/2018 21:00:00,EXPIRED,LONG,7647.0,7660.0,8280.34,0.0,0.02,7.65,0.0,169.74,2,0.1,3.48
20/10/2018 10:00:00,16/06/2023 15:50:26,Gemini_BTCUSD_1h_17_12_17_to_10_03_23.csv,BTC_USD,HOUR,102322.24,0.32,20/10/2018 11:00:00,20/10/2018 13:00:00,20/10/2018 13:00:00,EXPIRED,LONG,6402.0,6415.0,6667.61,0.0,0.02,3.98,0.0,85.0,2,0.0,4.16
06/03/2021 22:00:00,16/06/2023 15:50:26,Gemini_BTCUSD_1h_17_12_17_to_10_03_23.csv,BTC_USD,HOUR,102326.4,0.042,07/03/2021 02:00:00,07/03/2021 01:00:00,07/03/2021 01:00:00,EXPIRED,LONG,48983.0,49183.0,50844.36,0.0,0.02,3.66,0.0,78.18,2,0.0,8.4
09/12/2019 15:00:00,16/06/2023 15:50:26,Gemini_BTCUSD_1h_17_12_17_to_10_03_23.csv,BTC_USD,HOUR,102334.8,0.276,09/12/2019 16:00:00,09/12/2019 18:00:00,09/12/2019 18:00:00,EXPIRED,LONG,7428.0,7452.0,8113.24,0.0,0.02,8.45,0.0,189.13,2,0.1,6.62
13/01/2023 16:00:00,16/06/2023 15:50:26,Gemini_BTCUSD_1h_17_12_17_to_10_03_23.csv,BTC_USD,HOUR,102341.42,0.107,13/01/2023 18:00:00,13/01/2023 19:00:00,13/01/2023 19:00:00,EXPIRED,LONG,19135.0,19361.0,20679.79,0.0,0.02,7.47,0.0,165.29,2,0.1,24.18
10/06/2021 16:00:00,16/06/2023 15:50:26,Gemini_BTCUSD_1h_17_12_17_to_10_03_23.csv,BTC_USD,HOUR,102365.6,0.056,10/06/2021 17:00:00,10/06/2021 19:00:00,10/06/2021 19:00:00,EXPIRED,LONG,36840.0,36702.0,37736.85,0.0,0.02,2.38,0.0,50.22,2,0.0,-7.73
24/07/2018 20:00:00,16/06/2023 15:50:26,Gemini_BTCUSD_1h_17_12_17_to_10_03_23.csv,BTC_USD,HOUR,102357.87,0.249,24/07/2018 21:00:00,24/07/2018 23:00:00,24/07/2018 23:00:00,TAKE_PROFIT_HIT,LONG,8227.0,8405.72,8405.72,0.0,0.02,2.13,0.0,44.5,2,0.0,44.5
23/03/2022 23:00:00,16/06/2023 15:50:26,Gemini_BTCUSD_1h_17_12_17_to_10_03_23.csv,BTC_USD,HOUR,102402.37,0.048,24/03/2022 00:00:00,24/03/2022 02:00:00,24/03/2022 02:00:00,EXPIRED,LONG,42907.0,42986.0,46481.19,0.0,0.02,7.69,0.0,171.56,2,0.1,3.79
13/07/2022 11:00:00,16/06/2023 15:50:26,Gemini_BTCUSD_1h_17_12_17_to_10_03_23.csv,BTC_USD,HOUR,102406.16,0.103,13/07/2022 12:00:00,13/07/2022 14:00:00,13/07/2022 14:00:00,EXPIRED,LONG,19833.0,19561.0,20594.95,0.0,0.02,3.7,0.0,78.48,2,0.0,-28.02
25/08/2018 06:00:00,16/06/2023 15:50:26,Gemini_BTCUSD_1h_17_12_17_to_10_03_23.csv,BTC_USD,HOUR,102378.14,0.306,25/08/2018 10:00:00,25/08/2018 09:00:00,25/08/2018 09:00:00,EXPIRED,LONG,6692.0,6690.0,6873.32,0.0,0.02,2.64,0.0,55.48,2,0.0,-0.61
15/07/2019 17:00:00,16/06/2023 15:50:26,Gemini_BTCUSD_1h_17_12_17_to_10_03_23.csv,BTC_USD,HOUR,102377.53,0.195,15/07/2019 18:00:00,15/07/2019 20:00:00,15/07/2019 20:00:00,EXPIRED,LONG,10522.0,10832.0,11179.14,0.0,0.02,5.88,0.0,128.14,2,0.1,60.45
12/11/2020 15:00:00,16/06/2023 15:50:26,Gemini_BTCUSD_1h_17_12_17_to_10_03_23.csv,BTC_USD,HOUR,102437.98,0.127,12/11/2020 16:00:00,12/11/2020 18:00:00,12/11/2020 18:00:00,EXPIRED,LONG,16167.0,16135.0,17182.06,0.0,0.02,5.91,0.0,128.91,2,0.1,-4.06
18/02/2023 22:00:00,16/06/2023 15:50:26,Gemini_BTCUSD_1h_17_12_17_to_10_03_23.csv,BTC_USD,HOUR,102433.92,0.083,18/02/2023 23:00:00,19/02/2023 01:00:00,19/02/2023 01:00:00,EXPIRED,LONG,24637.0,24712.0,25683.29,0.0,0.02,4.07,0.0,86.84,2,0.0,6.23
20/05/2018 16:00:00,16/06/2023 15:50:26,Gemini_BTCUSD_1h_17_12_17_to_10_03_23.csv,BTC_USD,HOUR,102440.15,0.241,20/05/2018 18:00:00,20/05/2018 19:00:00,20/05/2018 19:00:00,EXPIRED,LONG,8487.0,8513.0,8684.42,0.0,0.02,2.27,0.0,47.58,2,0.0,6.27
09/07/2021 19:00:00,16/06/2023 15:50:26,Gemini_BTCUSD_1h_17_12_17_to_10_03_23.csv,BTC_USD,HOUR,102446.42,0.061,09/07/2021 20:00:00,09/07/2021 22:00:00,09/07/2021 22:00:00,EXPIRED,LONG,33454.0,33987.0,34178.92,0.0,0.02,2.12,0.0,44.22,2,0.0,32.51
15/03/2022 01:00:00,16/06/2023 15:50:26,Gemini_BTCUSD_1h_17_12_17_to_10_03_23.csv,BTC_USD,HOUR,102478.93,0.053,15/03/2022 02:00:00,15/03/2022 04:00:00,15/03/2022 04:00:00,EXPIRED,LONG,38843.0,38791.0,41643.61,0.0,0.02,6.73,0.0,148.43,2,0.1,-2.76
17/06/2018 21:00:00,16/06/2023 15:50:26,Gemini_BTCUSD_1h_17_12_17_to_10_03_23.csv,BTC_USD,HOUR,102476.17,0.315,17/06/2018 22:00:00,18/06/2018 00:00:00,18/06/2018 00:00:00,EXPIRED,LONG,6503.0,6395.0,6817.51,0.0,0.02,4.61,0.0,99.07,2,0.0,-34.02
25/02/2022 15:00:00,16/06/2023 15:50:26,Gemini_BTCUSD_1h_17_12_17_to_10_03_23.csv,BTC_USD,HOUR,102442.15,0.052,25/02/2022 16:00:00,25/02/2022 18:00:00,25/02/2022 18:00:00,EXPIRED,LONG,39466.0,38670.0,42244.64,0.0,0.02,6.58,0.0,144.49,2,0.1,-41.39
23/12/2019 04:00:00,16/06/2023 15:50:26,Gemini_BTCUSD_1h_17_12_17_to_10_03_23.csv,BTC_USD,HOUR,102400.76,0.271,23/12/2019 05:00:00,23/12/2019 07:00:00,23/12/2019 07:00:00,EXPIRED,LONG,7571.0,7504.0,7898.58,0.0,0.02,4.15,0.0,88.77,2,0.0,-18.16
08/02/2021 03:00:00,16/06/2023 15:50:26,Gemini_BTCUSD_1h_17_12_17_to_10_03_23.csv,BTC_USD,HOUR,102382.6,0.054,08/02/2021 04:00:00,08/02/2021 06:00:00,08/02/2021 06:00:00,TAKE_PROFIT_HIT,LONG,38107.0,38940.67,38940.67,0.0,0.02,2.14,0.0,45.02,2,0.0,45.02
23/10/2018 22:00:00,16/06/2023 15:50:26,Gemini_BTCUSD_1h_17_12_17_to_10_03_23.csv,BTC_USD,HOUR,102427.62,0.32,23/10/2018 23:00:00,24/10/2018 01:00:00,24/10/2018 01:00:00,EXPIRED,LONG,6394.0,6400.0,6940.6,0.0,0.02,7.88,0.0,174.91,2,0.1,1.92
25/05/2021 20:00:00,16/06/2023 15:50:26,Gemini_BTCUSD_1h_17_12_17_to_10_03_23.csv,BTC_USD,HOUR,102429.54,0.054,25/05/2021 21:00:00,25/05/2021 23:00:00,25/05/2021 22:00:00,TAKE_PROFIT_HIT,LONG,37641.0,38557.87,38557.87,0.0,0.02,2.38,0.0,49.51,2,0.0,49.51
31/01/2022 09:00:00,16/06/2023 15:50:26,Gemini_BTCUSD_1h_17_12_17_to_10_03_23.csv,BTC_USD,HOUR,102479.05,0.055,31/01/2022 10:00:00,31/01/2022 12:00:00,31/01/2022 12:00:00,EXPIRED,LONG,37231.0,37094.0,38742.07,0.0,0.02,3.9,0.0,83.11,2,0.0,-7.53
19/10/2022 12:00:00,16/06/2023 15:50:26,Gemini_BTCUSD_1h_17_12_17_to_10_03_23.csv,BTC_USD,HOUR,102471.52,0.107,19/10/2022 14:00:00,19/10/2022 15:00:00,19/10/2022 15:00:00,EXPIRED,LONG,19164.0,19268.0,19604.48,0.0,0.02,2.25,0.0,47.13,2,0.0,11.13
14/06/2018 12:00:00,16/06/2023 15:50:26,Gemini_BTCUSD_1h_17_12_17_to_10_03_23.csv,BTC_USD,HOUR,102482.65,0.316,14/06/2018 13:00:00,14/06/2018 15:00:00,14/06/2018 15:00:00,EXPIRED,LONG,6481.0,6340.0,6983.36,0.0,0.02,7.19,0.0,158.75,2,0.1,-44.56
09/12/2021 11:00:00,16/06/2023 15:50:26,Gemini_BTCUSD_1h_17_12_17_to_10_03_23.csv,BTC_USD,HOUR,102438.09,0.042,09/12/2021 12:00:00,09/12/2021 14:00:00,09/12/2021 14:00:00,EXPIRED,LONG,49215.0,48619.0,50291.67,0.0,0.02,2.14,0.0,45.22,2,0.0,-25.03
16/06/2018 11:00:00,16/06/2023 15:50:26,Gemini_BTCUSD_1h_17_12_17_to_10_03_23.csv,BTC_USD,HOUR,102413.06,0.317,16/06/2018 15:00:00,16/06/2018 14:00:00,16/06/2018 14:00:00,EXPIRED,LONG,6457.0,6410.0,6607.4,0.0,0.02,2.28,0.0,47.68,2,0.0,-14.9
19/06/2018 10:00:00,16/06/2023 15:50:26,Gemini_BTCUSD_1h_17_12_17_to_10_03_23.csv,BTC_USD,HOUR,102398.16,0.305,19/06/2018 11:00:00,19/06/2018 13:00:00,19/06/2018 13:00:00,EXPIRED,LONG,6709.0,6760.0,7228.89,0.0,0.02,7.19,0.0,158.57,2,0.1,15.56
28/12/2020 18:00:00,16/06/2023 15:50:26,Gemini_BTCUSD_1h_17_12_17_to_10_03_23.csv,BTC_USD,HOUR,102413.72,0.076,28/12/2020 22:00:00,28/12/2020 21:00:00,28/12/2020 21:00:00,EXPIRED,LONG,26993.0,26610.0,27939.8,0.0,0.02,3.39,0.0,71.96,2,0.0,-29.11
28/09/2020 23:00:00,16/06/2023 15:50:26,Gemini_BTCUSD_1h_17_12_17_to_10_03_23.csv,BTC_USD,HOUR,102384.61,0.191,29/09/2020 02:00:00,29/09/2020 02:00:00,29/09/2020 02:00:00,EXPIRED,LONG,10698.0,10688.0,11185.66,0.0,0.02,4.36,0.0,93.14,2,0.0,-1.91
14/10/2020 00:00:00,16/06/2023 15:50:26,Gemini_BTCUSD_1h_17_12_17_to_10_03_23.csv,BTC_USD,HOUR,102382.7,0.178,14/10/2020 04:00:00,14/10/2020 03:00:00,14/10/2020 03:00:00,EXPIRED,LONG,11486.0,11400.0,12195.43,0.0,0.02,5.82,0.0,126.28,2,0.1,-15.31
04/01/2022 02:00:00,16/06/2023 15:50:26,Gemini_BTCUSD_1h_17_12_17_to_10_03_23.csv,BTC_USD,HOUR,102367.39,0.044,04/01/2022 03:00:00,04/01/2022 05:00:00,04/01/2022 05:00:00,EXPIRED,LONG,46120.0,46159.0,48282.26,0.0,0.02,4.48,0.0,95.14,2,0.0,1.72
17/10/2020 04:00:00,16/06/2023 15:50:26,Gemini_BTCUSD_1h_17_12_17_to_10_03_23.csv,BTC_USD,HOUR,102369.11,0.18,17/10/2020 05:00:00,17/10/2020 07:00:00,17/10/2020 07:00:00,EXPIRED,LONG,11357.0,11358.0,11785.66,0.0,0.02,3.64,0.0,77.16,2,0.0,0.18
30/06/2019 02:00:00,16/06/2023 15:50:26,Gemini_BTCUSD_1h_17_12_17_to_10_03_23.csv,BTC_USD,HOUR,102369.29,0.17,30/06/2019 06:00:00,30/06/2019 05:00:00,30/06/2019 05:00:00,EXPIRED,LONG,12066.0,11957.0,12361.12,0.0,0.02,2.39,0.0,50.17,2,0.0,-18.53
23/09/2022 19:00:00,16/06/2023 15:50:26,Gemini_BTCUSD_1h_17_12_17_to_10_03_23.csv,BTC_USD,HOUR,102350.76,0.109,23/09/2022 20:00:00,23/09/2022 22:00:00,23/09/2022 22:00:00,EXPIRED,LONG,18819.0,19343.0,20169.36,0.0,0.02,6.7,0.0,147.19,2,0.1,57.12
09/08/2019 21:00:00,16/06/2023 15:50:26,Gemini_BTCUSD_1h_17_12_17_to_10_03_23.csv,BTC_USD,HOUR,102407.88,0.172,10/08/2019 00:00:00,10/08/2019 00:00:00,10/08/2019 00:00:00,EXPIRED,LONG,11911.0,11899.0,12204.47,0.0,0.02,2.4,0.0,50.48,2,0.0,-2.06
23/01/2022 14:00:00,16/06/2023 15:50:26,Gemini_BTCUSD_1h_17_12_17_to_10_03_23.csv,BTC_USD,HOUR,102405.82,0.058,23/01/2022 15:00:00,23/01/2022 17:00:00,23/01/2022 17:00:00,EXPIRED,LONG,35328.0,35355.0,37232.99,0.0,0.02,5.12,0.0,110.49,2,0.1,1.57
02/01/2018 18:00:00,16/06/2023 15:50:26,Gemini_BTCUSD_1h_17_12_17_to_10_03_23.csv,BTC_USD,HOUR,102407.39,0.142,02/01/2018 19:00:00,02/01/2018 21:00:00,02/01/2018 19:00:00,TAKE_PROFIT_HIT,LONG,14417.0,15084.72,15084.72,0.0,0.02,4.43,0.0,94.82,2,0.0,94.82
31/07/2018 02:00:00,16/06/2023 15:50:26,Gemini_BTCUSD_1h_17_12_17_to_10_03_23.csv,BTC_USD,HOUR,102502.21,0.253,31/07/2018 05:00:00,31/07/2018 05:00:00,31/07/2018 05:00:00,EXPIRED,LONG,8117.0,8123.0,8303.57,0.0,0.02,2.25,0.0,47.2,2,0.0,1.52
15/02/2021 23:00:00,16/06/2023 15:50:26,Gemini_BTCUSD_1h_17_12_17_to_10_03_23.csv,BTC_USD,HOUR,102503.73,0.043,16/02/2021 02:00:00,16/02/2021 02:00:00,16/02/2021 02:00:00,EXPIRED,LONG,47927.0,48467.0,49028.58,0.0,0.02,2.25,0.0,47.37,2,0.0,23.22
30/10/2021 12:00:00,16/06/2023 15:50:26,Gemini_BTCUSD_1h_17_12_17_to_10_03_23.csv,BTC_USD,HOUR,102526.95,0.033,30/10/2021 13:00:00,30/10/2021 15:00:00,30/10/2021 15:00:00,EXPIRED,LONG,61658.0,61393.0,64580.69,0.0,0.02,4.53,0.0,96.45,2,0.0,-8.75
27/03/2018 14:00:00,16/06/2023 15:50:26,Gemini_BTCUSD_1h_17_12_17_to_10_03_23.csv,BTC_USD,HOUR,102518.2,0.254,27/03/2018 15:00:00,27/03/2018 17:00:00,27/03/2018 17:00:00,EXPIRED,LONG,8071.0,7922.0,8435.51,0.0,0.02,4.32,0.0,92.59,2,0.0,-37.85
20/02/2020 13:00:00,16/06/2023 15:50:26,Gemini_BTCUSD_1h_17_12_17_to_10_03_23.csv,BTC_USD,HOUR,102480.35,0.214,20/02/2020 14:00:00,20/02/2020 16:00:00,20/02/2020 16:00:00,EXPIRED,LONG,9590.0,9650.0,9814.67,0.0,0.02,2.29,0.0,48.08,2,0.0,12.84
10/07/2020 11:00:00,16/06/2023 15:50:26,Gemini_BTCUSD_1h_17_12_17_to_10_03_23.csv,BTC_USD,HOUR,102493.19,0.224,10/07/2020 12:00:00,10/07/2020 14:00:00,10/07/2020 14:00:00,EXPIRED,LONG,9159.0,9189.0,9627.76,0.0,0.02,4.87,0.0,105.0,2,0.1,6.72
03/08/2020 12:00:00,16/06/2023 15:50:26,Gemini_BTCUSD_1h_17_12_17_to_10_03_23.csv,BTC_USD,HOUR,102499.91,0.183,03/08/2020 16:00:00,03/08/2020 15:00:00,03/08/2020 15:00:00,EXPIRED,LONG,11228.0,11383.0,11857.32,0.0,0.02,5.31,0.0,115.17,2,0.1,28.37
23/01/2020 21:00:00,16/06/2023 15:50:26,Gemini_BTCUSD_1h_17_12_17_to_10_03_23.csv,BTC_USD,HOUR,102528.28,0.245,24/01/2020 01:00:00,24/01/2020 00:00:00,24/01/2020 00:00:00,EXPIRED,LONG,8381.0,8380.0,8896.09,0.0,0.02,5.79,0.0,126.2,2,0.1,-0.24
22/10/2022 13:00:00,16/06/2023 15:50:26,Gemini_BTCUSD_1h_17_12_17_to_10_03_23.csv,BTC_USD,HOUR,102528.04,0.107,22/10/2022 14:00:00,22/10/2022 16:00:00,22/10/2022 16:00:00,EXPIRED,LONG,19198.0,19193.0,20647.8,0.0,0.02,7.02,0.0,155.13,2,0.1,-0.53
27/08/2020 17:00:00,16/06/2023 15:50:26,Gemini_BTCUSD_1h_17_12_17_to_10_03_23.csv,BTC_USD,HOUR,102527.51,0.183,27/08/2020 18:00:00,27/08/2020 20:00:00,27/08/2020 20:00:00,EXPIRED,LONG,11193.0,11281.0,11660.13,0.0,0.02,4.01,0.0,85.48,2,0.0,16.1
26/09/2022 23:00:00,16/06/2023 15:50:26,Gemini_BTCUSD_1h_17_12_17_to_10_03_23.csv,BTC_USD,HOUR,102543.61,0.107,27/09/2022 03:00:00,27/09/2022 02:00:00,27/09/2022 02:00:00,TAKE_PROFIT_HIT,LONG,19229.0,19909.53,19909.53,0.0,0.02,3.42,0.0,72.82,2,0.0,72.82
31/03/2020 03:00:00,16/06/2023 15:50:26,Gemini_BTCUSD_1h_17_12_17_to_10_03_23.csv,BTC_USD,HOUR,102616.43,0.318,31/03/2020 07:00:00,31/03/2020 06:00:00,31/03/2020 06:00:00,EXPIRED,LONG,6450.0,6475.0,6591.03,0.0,0.02,2.14,0.0,44.85,2,0.0,7.95
27/10/2019 23:00:00,16/06/2023 15:50:26,Gemini_BTCUSD_1h_17_12_17_to_10_03_23.csv,BTC_USD,HOUR,102624.38,0.215,28/10/2019 00:00:00,28/10/2019 02:00:00,28/10/2019 01:00:00,TAKE_PROFIT_HIT,LONG,9547.0,9771.56,9771.56,0.0,0.02,2.3,0.0,48.28,2,0.0,48.28
19/11/2022 17:00:00,16/06/2023 15:50:26,Gemini_BTCUSD_1h_17_12_17_to_10_03_23.csv,BTC_USD,HOUR,102672.66,0.124,19/11/2022 19:00:00,19/11/2022 20:00:00,19/11/2022 20:00:00,EXPIRED,LONG,16599.0,16617.0,17574.84,0.0,0.02,5.55,0.0,121.0,2,0.1,2.23
21/11/2018 06:00:00,16/06/2023 15:50:26,Gemini_BTCUSD_1h_17_12_17_to_10_03_23.csv,BTC_USD,HOUR,102674.89,0.464,21/11/2018 07:00:00,21/11/2018 09:00:00,21/11/2018 08:00:00,TAKE_PROFIT_HIT,LONG,4430.0,4617.03,4617.03,0.0,0.02,4.05,0.0,86.78,2,0.0,86.78
21/01/2021 22:00:00,16/06/2023 15:50:26,Gemini_BTCUSD_1h_17_12_17_to_10_03_23.csv,BTC_USD,HOUR,102761.67,0.066,21/01/2021 23:00:00,22/01/2021 01:00:00,22/01/2021 01:00:00,EXPIRED,LONG,30910.0,30066.0,32181.97,0.0,0.02,3.95,0.0,83.95,2,0.0,-55.7
07/08/2022 23:00:00,16/06/2023 15:50:26,Gemini_BTCUSD_1h_17_12_17_to_10_03_23.csv,BTC_USD,HOUR,102705.97,0.089,08/08/2022 01:00:00,08/08/2022 02:00:00,08/08/2022 02:00:00,EXPIRED,LONG,23182.0,23310.0,24043.94,0.0,0.02,3.58,0.0,76.71,2,0.0,11.39
03/06/2021 21:00:00,16/06/2023 15:50:26,Gemini_BTCUSD_1h_17_12_17_to_10_03_23.csv,BTC_USD,HOUR,102717.36,0.053,04/06/2021 00:00:00,04/06/2021 00:00:00,04/06/2021 00:00:00,EXPIRED,LONG,38763.0,38684.0,39689.2,0.0,0.02,2.33,0.0,49.09,2,0.0,-4.19
02/02/2023 20:00:00,16/06/2023 15:50:26,Gemini_BTCUSD_1h_17_12_17_to_10_03_23.csv,BTC_USD,HOUR,102713.17,0.086,02/02/2023 22:00:00,02/02/2023 23:00:00,02/02/2023 23:00:00,EXPIRED,LONG,23887.0,23487.0,25957.19,0.0,0.02,7.98,0.0,178.04,2,0.1,-34.4
01/10/2019 05:00:00,16/06/2023 15:50:26,Gemini_BTCUSD_1h_17_12_17_to_10_03_23.csv,BTC_USD,HOUR,102678.77,0.243,01/10/2019 06:00:00,01/10/2019 08:00:00,01/10/2019 08:00:00,EXPIRED,LONG,8439.0,8395.0,8628.71,0.0,0.02,2.2,0.0,46.1,2,0.0,-10.69
15/01/2022 03:00:00,16/06/2023 15:50:26,Gemini_BTCUSD_1h_17_12_17_to_10_03_23.csv,BTC_USD,HOUR,102668.08,0.048,15/01/2022 04:00:00,15/01/2022 06:00:00,15/01/2022 06:00:00,EXPIRED,LONG,42948.0,43117.0,44022.15,0.0,0.02,2.44,0.0,51.56,2,0.0,8.11
06/08/2020 09:00:00,16/06/2023 15:50:26,Gemini_BTCUSD_1h_17_12_17_to_10_03_23.csv,BTC_USD,HOUR,102676.19,0.175,06/08/2020 10:00:00,06/08/2020 12:00:00,06/08/2020 12:00:00,EXPIRED,LONG,11756.0,11779.0,12732.21,0.0,0.02,7.67,0.0,170.84,2,0.1,4.02
05/04/2019 12:00:00,16/06/2023 15:50:26,Gemini_BTCUSD_1h_17_12_17_to_10_03_23.csv,BTC_USD,HOUR,102680.21,0.409,05/04/2019 15:00:00,05/04/2019 15:00:00,05/04/2019 15:00:00,EXPIRED,LONG,5027.0,4992.0,5219.2,0.0,0.02,3.68,0.0,78.61,2,0.0,-14.31
03/10/2020 13:00:00,16/06/2023 15:50:26,Gemini_BTCUSD_1h_17_12_17_to_10_03_23.csv,BTC_USD,HOUR,102665.9,0.195,03/10/2020 14:00:00,03/10/2020 16:00:00,03/10/2020 16:00:00,EXPIRED,LONG,10538.0,10589.0,10910.26,0.0,0.02,3.41,0.0,72.59,2,0.0,9.95
20/10/2020 07:00:00,16/06/2023 15:50:26,Gemini_BTCUSD_1h_17_12_17_to_10_03_23.csv,BTC_USD,HOUR,102675.85,0.175,20/10/2020 08:00:00,20/10/2020 10:00:00,20/10/2020 10:00:00,EXPIRED,LONG,11743.0,11834.0,12667.63,0.0,0.02,7.3,0.0,161.81,2,0.1,15.93
29/01/2020 21:00:00,16/06/2023 15:50:26,Gemini_BTCUSD_1h_17_12_17_to_10_03_23.csv,BTC_USD,HOUR,102691.78,0.219,29/01/2020 23:00:00,30/01/2020 00:00:00,30/01/2020 00:00:00,EXPIRED,LONG,9357.0,9255.0,10176.72,0.0,0.02,8.05,0.0,179.52,2,0.1,-22.34
29/05/2018 21:00:00,16/06/2023 15:50:26,Gemini_BTCUSD_1h_17_12_17_to_10_03_23.csv,BTC_USD,HOUR,102669.44,0.274,30/05/2018 00:00:00,30/05/2018 00:00:00,30/05/2018 00:00:00,EXPIRED,LONG,7492.0,7488.0,7753.61,0.0,0.02,3.37,0.0,71.68,2,0.0,-1.1
10/07/2019 02:00:00,16/06/2023 15:50:27,Gemini_BTCUSD_1h_17_12_17_to_10_03_23.csv,BTC_USD,HOUR,102668.34,0.157,10/07/2019 04:00:00,10/07/2019 05:00:00,10/07/2019 05:00:00,EXPIRED,LONG,13063.0,13048.0,13526.66,0.0,0.02,3.43,0.0,72.79,2,0.0,-2.35
08/12/2019 13:00:00,16/06/2023 15:50:27,Gemini_BTCUSD_1h_17_12_17_to_10_03_23.csv,BTC_USD,HOUR,102665.99,0.273,08/12/2019 14:00:00,08/12/2019 16:00:00,08/12/2019 16:00:00,EXPIRED,LONG,7533.0,7525.0,7943.37,0.0,0.02,5.17,0.0,112.03,2,0.1,-2.18
07/05/2020 13:00:00,16/06/2023 15:50:27,Gemini_BTCUSD_1h_17_12_17_to_10_03_23.csv,BTC_USD,HOUR,102663.81,0.216,07/05/2020 17:00:00,07/05/2020 16:00:00,07/05/2020 16:00:00,EXPIRED,LONG,9497.0,9639.0,9710.68,0.0,0.02,2.2,0.0,46.15,2,0.0,30.67
28/06/2019 04:00:00,16/06/2023 15:50:27,Gemini_BTCUSD_1h_17_12_17_to_10_03_23.csv,BTC_USD,HOUR,102694.48,0.186,28/06/2019 07:00:00,28/06/2019 07:00:00,28/06/2019 06:00:00,TAKE_PROFIT_HIT,LONG,11026.0,11304.65,11304.65,0.0,0.02,2.46,0.0,51.83,2,0.0,51.83
21/09/2020 01:00:00,16/06/2023 15:50:27,Gemini_BTCUSD_1h_17_12_17_to_10_03_23.csv,BTC_USD,HOUR,102746.31,0.188,21/09/2020 02:00:00,21/09/2020 04:00:00,21/09/2020 04:00:00,EXPIRED,LONG,10951.0,10966.0,11928.42,0.0,0.02,8.19,0.0,183.75,2,0.1,2.82
23/09/2022 22:00:00,16/06/2023 15:50:27,Gemini_BTCUSD_1h_17_12_17_to_10_03_23.csv,BTC_USD,HOUR,102749.13,0.106,23/09/2022 23:00:00,24/09/2022 01:00:00,24/09/2022 01:00:00,EXPIRED,LONG,19343.0,19117.0,20895.72,0.0,0.02,7.43,0.0,164.59,2,0.1,-23.96
11/09/2020 14:00:00,16/06/2023 15:50:27,Gemini_BTCUSD_1h_17_12_17_to_10_03_23.csv,BTC_USD,HOUR,102725.17,0.2,11/09/2020 16:00:00,11/09/2020 17:00:00,11/09/2020 17:00:00,EXPIRED,LONG,10298.0,10301.0,10551.73,0.0,0.02,2.4,0.0,50.75,2,0.0,0.6
13/07/2021 05:00:00,16/06/2023 15:50:27,Gemini_BTCUSD_1h_17_12_17_to_10_03_23.csv,BTC_USD,HOUR,102725.77,0.063,13/07/2021 06:00:00,13/07/2021 08:00:00,13/07/2021 08:00:00,EXPIRED,LONG,32800.0,33221.0,34265.37,0.0,0.02,4.28,0.0,92.32,2,0.0,26.52
23/07/2020 10:00:00,16/06/2023 15:50:27,Gemini_BTCUSD_1h_17_12_17_to_10_03_23.csv,BTC_USD,HOUR,102752.29,0.216,23/07/2020 11:00:00,23/07/2020 13:00:00,23/07/2020 13:00:00,EXPIRED,LONG,9506.0,9507.0,9758.34,0.0,0.02,2.59,0.0,54.51,2,0.0,0.22
01/09/2022 14:00:00,16/06/2023 15:50:27,Gemini_BTCUSD_1h_17_12_17_to_10_03_23.csv,BTC_USD,HOUR,102752.51,0.104,01/09/2022 18:00:00,01/09/2022 17:00:00,01/09/2022 17:00:00,EXPIRED,LONG,19695.0,19732.0,20429.4,0.0,0.02,3.59,0.0,76.38,2,0.0,3.85
23/01/2022 02:00:00,16/06/2023 15:50:27,Gemini_BTCUSD_1h_17_12_17_to_10_03_23.csv,BTC_USD,HOUR,102756.36,0.059,23/01/2022 05:00:00,23/01/2022 05:00:00,23/01/2022 05:00:00,EXPIRED,LONG,34887.0,35479.0,36209.95,0.0,0.02,3.65,0.0,78.05,2,0.0,34.93
01/07/2022 19:00:00,16/06/2023 15:50:27,Gemini_BTCUSD_1h_17_12_17_to_10_03_23.csv,BTC_USD,HOUR,102791.29,0.106,01/07/2022 20:00:00,01/07/2022 22:00:00,01/07/2022 22:00:00,EXPIRED,LONG,19376.0,19272.0,19903.48,0.0,0.02,2.65,0.0,55.91,2,0.0,-11.02
19/09/2022 14:00:00,16/06/2023 15:50:27,Gemini_BTCUSD_1h_17_12_17_to_10_03_23.csv,BTC_USD,HOUR,102780.27,0.106,19/09/2022 15:00:00,19/09/2022 17:00:00,19/09/2022 17:00:00,EXPIRED,LONG,19312.0,18973.0,20694.81,0.0,0.02,6.68,0.0,146.58,2,0.1,-35.93
21/09/2018 04:00:00,16/06/2023 15:50:27,Gemini_BTCUSD_1h_17_12_17_to_10_03_23.csv,BTC_USD,HOUR,102744.34,0.314,21/09/2018 08:00:00,21/09/2018 07:00:00,21/09/2018 07:00:00,EXPIRED,LONG,6545.0,6640.0,6720.18,0.0,0.02,2.61,0.0,55.01,2,0.0,29.83
27/02/2018 06:00:00,16/06/2023 15:50:27,Gemini_BTCUSD_1h_17_12_17_to_10_03_23.csv,BTC_USD,HOUR,102774.17,0.199,27/02/2018 07:00:00,27/02/2018 09:00:00,27/02/2018 09:00:00,EXPIRED,LONG,10305.0,10725.0,11081.55,0.0,0.02,7.01,0.0,154.53,2,0.1,83.58
18/07/2022 10:00:00,16/06/2023 15:50:27,Gemini_BTCUSD_1h_17_12_17_to_10_03_23.csv,BTC_USD,HOUR,102857.75,0.093,18/07/2022 11:00:00,18/07/2022 13:00:00,18/07/2022 13:00:00,EXPIRED,LONG,22204.0,22143.0,22772.42,0.0,0.02,2.5,0.0,52.86,2,0.0,-5.67
21/06/2019 01:00:00,16/06/2023 15:50:27,Gemini_BTCUSD_1h_17_12_17_to_10_03_23.csv,BTC_USD,HOUR,102852.08,0.211,21/06/2019 04:00:00,21/06/2019 04:00:00,21/06/2019 04:00:00,EXPIRED,LONG,9734.0,9741.0,9881.72,0.0,0.02,1.49,0.0,31.17,2,0.0,1.48
22/06/2021 19:00:00,16/06/2023 15:50:27,Gemini_BTCUSD_1h_17_12_17_to_10_03_23.csv,BTC_USD,HOUR,102853.56,0.063,22/06/2021 20:00:00,22/06/2021 22:00:00,22/06/2021 22:00:00,EXPIRED,LONG,32431.0,32632.0,34050.48,0.0,0.02,4.76,0.0,102.03,2,0.0,12.66
12/08/2020 07:00:00,16/06/2023 15:50:27,Gemini_BTCUSD_1h_17_12_17_to_10_03_23.csv,BTC_USD,HOUR,102866.22,0.18,12/08/2020 08:00:00,12/08/2020 10:00:00,12/08/2020 10:00:00,EXPIRED,LONG,11453.0,11518.0,11727.82,0.0,0.02,2.34,0.0,49.47,2,0.0,11.7
15/08/2019 14:00:00,16/06/2023 15:50:27,Gemini_BTCUSD_1h_17_12_17_to_10_03_23.csv,BTC_USD,HOUR,102877.92,0.206,15/08/2019 15:00:00,15/08/2019 17:00:00,15/08/2019 17:00:00,EXPIRED,LONG,10004.0,10022.0,10244.63,0.0,0.02,2.35,0.0,49.57,2,0.0,3.71
15/06/2021 04:00:00,16/06/2023 15:50:27,Gemini_BTCUSD_1h_17_12_17_to_10_03_23.csv,BTC_USD,HOUR,102881.63,0.051,15/06/2021 06:00:00,15/06/2021 07:00:00,15/06/2021 07:00:00,EXPIRED,LONG,40521.0,40388.0,41410.28,0.0,0.02,2.15,0.0,45.35,2,0.0,-6.78
03/07/2018 21:00:00,16/06/2023 15:50:27,Gemini_BTCUSD_1h_17_12_17_to_10_03_23.csv,BTC_USD,HOUR,102874.85,0.311,03/07/2018 23:00:00,04/07/2018 00:00:00,04/07/2018 00:00:00,EXPIRED,LONG,6610.0,6462.0,7049.87,0.0,0.02,6.24,0.0,136.8,2,0.1,-46.03
31/10/2022 23:00:00,16/06/2023 15:50:27,Gemini_BTCUSD_1h_17_12_17_to_10_03_23.csv,BTC_USD,HOUR,102828.82,0.1,01/11/2022 00:00:00,01/11/2022 02:00:00,01/11/2022 02:00:00,EXPIRED,LONG,20496.0,20578.0,21674.52,0.0,0.02,5.44,0.0,117.85,2,0.1,8.2
17/12/2019 08:00:00,16/06/2023 15:50:27,Gemini_BTCUSD_1h_17_12_17_to_10_03_23.csv,BTC_USD,HOUR,102837.02,0.299,17/12/2019 09:00:00,17/12/2019 11:00:00,17/12/2019 11:00:00,EXPIRED,LONG,6869.0,6923.0,7014.99,0.0,0.02,2.08,0.0,43.65,2,0.0,16.15
04/12/2021 16:00:00,16/06/2023 15:50:27,Gemini_BTCUSD_1h_17_12_17_to_10_03_23.csv,BTC_USD,HOUR,102853.17,0.043,04/12/2021 17:00:00,04/12/2021 19:00:00,04/12/2021 19:00:00,EXPIRED,LONG,47906.0,49340.0,52056.2,0.0,0.02,7.97,0.0,178.46,2,0.1,61.66
17/05/2021 11:00:00,16/06/2023 15:50:27,Gemini_BTCUSD_1h_17_12_17_to_10_03_23.csv,BTC_USD,HOUR,102914.83,0.045,17/05/2021 13:00:00,17/05/2021 14:00:00,17/05/2021 14:00:00,EXPIRED,LONG,45819.0,44474.0,48299.98,0.0,0.02,5.14,0.0,111.64,2,0.1,-60.52
28/09/2021 16:00:00,16/06/2023 15:50:27,Gemini_BTCUSD_1h_17_12_17_to_10_03_23.csv,BTC_USD,HOUR,102854.31,0.05,28/09/2021 17:00:00,28/09/2021 19:00:00,28/09/2021 19:00:00,EXPIRED,LONG,41273.0,41597.0,42952.89,0.0,0.02,3.91,0.0,83.99,2,0.0,16.2
09/10/2022 20:00:00,16/06/2023 15:50:27,Gemini_BTCUSD_1h_17_12_17_to_10_03_23.csv,BTC_USD,HOUR,102870.51,0.106,09/10/2022 23:00:00,09/10/2022 23:00:00,09/10/2022 23:00:00,EXPIRED,LONG,19492.0,19452.0,20042.75,0.0,0.02,2.75,0.0,58.38,2,0.0,-4.24
07/01/2023 19:00:00,16/06/2023 15:50:27,Gemini_BTCUSD_1h_17_12_17_to_10_03_23.csv,BTC_USD,HOUR,102866.27,0.121,07/01/2023 21:00:00,07/01/2023 22:00:00,07/01/2023 22:00:00,EXPIRED,LONG,16941.0,16950.0,17384.55,0.0,0.02,2.55,0.0,53.67,2,0.0,1.09
31/07/2020 00:00:00,16/06/2023 15:50:27,Gemini_BTCUSD_1h_17_12_17_to_10_03_23.csv,BTC_USD,HOUR,102867.36,0.186,31/07/2020 03:00:00,31/07/2020 03:00:00,31/07/2020 03:00:00,EXPIRED,LONG,11067.0,10992.0,11365.09,0.0,0.02,2.62,0.0,55.44,2,0.0,-13.95
23/04/2020 04:00:00,16/06/2023 15:50:27,Gemini_BTCUSD_1h_17_12_17_to_10_03_23.csv,BTC_USD,HOUR,102853.41,0.288,23/04/2020 05:00:00,23/04/2020 07:00:00,23/04/2020 07:00:00,EXPIRED,LONG,7133.0,7066.0,7500.84,0.0,0.02,4.9,0.0,105.94,2,0.1,-19.3
18/01/2022 02:00:00,16/06/2023 15:50:27,Gemini_BTCUSD_1h_17_12_17_to_10_03_23.csv,BTC_USD,HOUR,102834.11,0.049,18/01/2022 03:00:00,18/01/2022 05:00:00,18/01/2022 05:00:00,EXPIRED,LONG,42279.0,42134.0,44236.3,0.0,0.02,4.42,0.0,95.91,2,0.0,-7.1
02/04/2022 12:00:00,16/06/2023 15:50:27,Gemini_BTCUSD_1h_17_12_17_to_10_03_23.csv,BTC_USD,HOUR,102827.01,0.044,02/04/2022 13:00:00,02/04/2022 15:00:00,02/04/2022 15:00:00,EXPIRED,LONG,46748.0,46304.0,48668.42,0.0,0.02,3.95,0.0,84.5,2,0.0,-19.54
20/03/2022 20:00:00,16/06/2023 15:50:27,Gemini_BTCUSD_1h_17_12_17_to_10_03_23.csv,BTC_USD,HOUR,102807.47,0.05,20/03/2022 23:00:00,20/03/2022 23:00:00,20/03/2022 23:00:00,EXPIRED,LONG,41306.0,41291.0,42294.34,0.0,0.02,2.34,0.0,49.42,2,0.0,-0.75
28/04/2018 09:00:00,16/06/2023 15:50:27,Gemini_BTCUSD_1h_17_12_17_to_10_03_23.csv,BTC_USD,HOUR,102806.72,0.222,28/04/2018 13:00:00,28/04/2018 12:00:00,28/04/2018 12:00:00,EXPIRED,LONG,9265.0,9363.0,9489.27,0.0,0.02,2.36,0.0,49.79,2,0.0,21.76
26/02/2023 01:00:00,16/06/2023 15:50:27,Gemini_BTCUSD_1h_17_12_17_to_10_03_23.csv,BTC_USD,HOUR,102828.48,0.089,26/02/2023 02:00:00,26/02/2023 04:00:00,26/02/2023 04:00:00,EXPIRED,LONG,23120.0,23188.0,24560.97,0.0,0.02,5.87,0.0,128.25,2,0.1,6.05
29/08/2020 18:00:00,16/06/2023 15:50:27,Gemini_BTCUSD_1h_17_12_17_to_10_03_23.csv,BTC_USD,HOUR,102834.53,0.178,29/08/2020 19:00:00,29/08/2020 21:00:00,29/08/2020 21:00:00,EXPIRED,LONG,11533.0,11517.0,12229.8,0.0,0.02,5.7,0.0,124.03,2,0.1,-2.85
08/01/2018 08:00:00,16/06/2023 15:50:27,Gemini_BTCUSD_1h_17_12_17_to_10_03_23.csv,BTC_USD,HOUR,102831.68,0.133,08/01/2018 09:00:00,08/01/2018 11:00:00,08/01/2018 11:00:00,EXPIRED,LONG,15479.0,15492.0,16092.89,0.0,0.02,3.81,0.0,81.65,2,0.0,1.73
29/01/2023 15:00:00,16/06/2023 15:50:27,Gemini_BTCUSD_1h_17_12_17_to_10_03_23.csv,BTC_USD,HOUR,102833.41,0.087,29/01/2023 17:00:00,29/01/2023 18:00:00,29/01/2023 18:00:00,EXPIRED,LONG,23536.0,23687.0,25164.58,0.0,0.02,6.47,0.0,141.69,2,0.1,13.14
04/02/2018 05:00:00,16/06/2023 15:50:27,Gemini_BTCUSD_1h_17_12_17_to_10_03_23.csv,BTC_USD,HOUR,102846.55,0.222,04/02/2018 09:00:00,04/02/2018 08:00:00,04/02/2018 08:00:00,EXPIRED,LONG,9250.0,9046.0,9462.11,0.0,0.02,2.24,0.0,47.09,2,0.0,-45.29
04/06/2021 16:00:00,16/06/2023 15:50:27,Gemini_BTCUSD_1h_17_12_17_to_10_03_23.csv,BTC_USD,HOUR,102801.26,0.056,04/06/2021 17:00:00,04/06/2021 19:00:00,04/06/2021 19:00:00,EXPIRED,LONG,36929.0,36840.0,37772.69,0.0,0.02,2.23,0.0,47.25,2,0.0,-4.98
19/01/2023 05:00:00,16/06/2023 15:50:27,Gemini_BTCUSD_1h_17_12_17_to_10_03_23.csv,BTC_USD,HOUR,102796.28,0.099,19/01/2023 06:00:00,19/01/2023 08:00:00,19/01/2023 08:00:00,EXPIRED,LONG,20813.0,20769.0,22349.68,0.0,0.02,6.88,0.0,152.13,2,0.1,-4.36
30/08/2022 04:00:00,16/06/2023 15:50:27,Gemini_BTCUSD_1h_17_12_17_to_10_03_23.csv,BTC_USD,HOUR,102791.92,0.1,30/08/2022 05:00:00,30/08/2022 07:00:00,30/08/2022 07:00:00,EXPIRED,LONG,20463.0,20437.0,21629.66,0.0,0.02,5.39,0.0,116.67,2,0.1,-2.6
19/06/2022 02:00:00,16/06/2023 15:50:27,Gemini_BTCUSD_1h_17_12_17_to_10_03_23.csv,BTC_USD,HOUR,102789.32,0.112,19/06/2022 03:00:00,19/06/2022 05:00:00,19/06/2022 05:00:00,EXPIRED,LONG,18363.0,18105.0,18825.0,0.0,0.02,2.45,0.0,51.74,2,0.0,-28.9
03/11/2022 07:00:00,16/06/2023 15:50:27,Gemini_BTCUSD_1h_17_12_17_to_10_03_23.csv,BTC_USD,HOUR,102760.42,0.101,03/11/2022 10:00:00,03/11/2022 10:00:00,03/11/2022 10:00:00,EXPIRED,LONG,20308.0,20272.0,20927.94,0.0,0.02,2.96,0.0,62.61,2,0.0,-3.64
17/04/2019 04:00:00,16/06/2023 15:50:27,Gemini_BTCUSD_1h_17_12_17_to_10_03_23.csv,BTC_USD,HOUR,102756.78,0.393,17/04/2019 05:00:00,17/04/2019 07:00:00,17/04/2019 07:00:00,EXPIRED,LONG,5236.0,5220.0,5482.18,0.0,0.02,4.49,0.0,96.75,2,0.0,-6.29
18/07/2021 19:00:00,16/06/2023 15:50:27,Gemini_BTCUSD_1h_17_12_17_to_10_03_23.csv,BTC_USD,HOUR,102750.49,0.065,18/07/2021 20:00:00,18/07/2021 22:00:00,18/07/2021 22:00:00,EXPIRED,LONG,31660.0,31566.0,34137.41,0.0,0.02,7.26,0.0,161.03,2,0.1,-6.11
08/10/2020 17:00:00,16/06/2023 15:50:27,Gemini_BTCUSD_1h_17_12_17_to_10_03_23.csv,BTC_USD,HOUR,102744.38,0.189,08/10/2020 18:00:00,08/10/2020 20:00:00,08/10/2020 20:00:00,EXPIRED,LONG,10885.0,10895.0,11471.66,0.0,0.02,5.11,0.0,110.88,2,0.1,1.89
22/12/2019 14:00:00,16/06/2023 15:50:27,Gemini_BTCUSD_1h_17_12_17_to_10_03_23.csv,BTC_USD,HOUR,102746.27,0.287,22/12/2019 15:00:00,22/12/2019 17:00:00,22/12/2019 17:00:00,EXPIRED,LONG,7168.0,7308.0,7486.06,0.0,0.02,4.25,0.0,91.28,2,0.0,40.18
01/05/2020 12:00:00,16/06/2023 15:50:27,Gemini_BTCUSD_1h_17_12_17_to_10_03_23.csv,BTC_USD,HOUR,102786.45,0.231,01/05/2020 13:00:00,01/05/2020 15:00:00,01/05/2020 15:00:00,EXPIRED,LONG,8885.0,8731.0,9622.51,0.0,0.02,7.66,0.0,170.36,2,0.1,-35.57
27/09/2020 00:00:00,16/06/2023 15:50:27,Gemini_BTCUSD_1h_17_12_17_to_10_03_23.csv,BTC_USD,HOUR,102750.88,0.191,27/09/2020 01:00:00,27/09/2020 03:00:00,27/09/2020 03:00:00,EXPIRED,LONG,10783.0,10787.0,11122.2,0.0,0.02,3.05,0.0,64.79,2,0.0,0.76
14/07/2018 23:00:00,16/06/2023 15:50:27,Gemini_BTCUSD_1h_17_12_17_to_10_03_23.csv,BTC_USD,HOUR,102751.64,0.329,15/07/2018 00:00:00,15/07/2018 02:00:00,15/07/2018 02:00:00,EXPIRED,LONG,6250.0,6251.0,6727.08,0.0,0.02,7.09,0.0,156.96,2,0.1,0.33
07/09/2018 19:00:00,16/06/2023 15:50:27,Gemini_BTCUSD_1h_17_12_17_to_10_03_23.csv,BTC_USD,HOUR,102751.97,0.32,07/09/2018 20:00:00,07/09/2018 22:00:00,07/09/2018 22:00:00,EXPIRED,LONG,6417.0,6404.0,6872.84,0.0,0.02,6.63,0.0,145.87,2,0.1,-4.16
27/08/2020 17:00:00,16/06/2023 15:50:27,Gemini_BTCUSD_1h_17_12_17_to_10_03_23.csv,BTC_USD,HOUR,102747.81,0.184,27/08/2020 18:00:00,27/08/2020 20:00:00,27/08/2020 20:00:00,EXPIRED,LONG,11193.0,11281.0,11660.13,0.0,0.02,4.01,0.0,85.95,2,0.0,16.19
26/02/2022 17:00:00,16/06/2023 15:50:27,Gemini_BTCUSD_1h_17_12_17_to_10_03_23.csv,BTC_USD,HOUR,102764.0,0.052,26/02/2022 21:00:00,26/02/2022 20:00:00,26/02/2022 20:00:00,EXPIRED,LONG,39289.0,39362.0,41628.89,0.0,0.02,5.62,0.0,121.67,2,0.1,3.8
13/02/2019 03:00:00,16/06/2023 15:50:27,Gemini_BTCUSD_1h_17_12_17_to_10_03_23.csv,BTC_USD,HOUR,102767.8,0.571,13/02/2019 05:00:00,13/02/2019 06:00:00,13/02/2019 06:00:00,EXPIRED,LONG,3598.0,3597.0,3679.48,0.0,0.02,2.21,0.0,46.53,2,0.0,-0.57
15/02/2019 08:00:00,16/06/2023 15:50:27,Gemini_BTCUSD_1h_17_12_17_to_10_03_23.csv,BTC_USD,HOUR,102767.23,0.575,15/02/2019 09:00:00,15/02/2019 11:00:00,15/02/2019 11:00:00,EXPIRED,LONG,3573.0,3574.0,3655.11,0.0,0.02,2.25,0.0,47.21,2,0.0,0.57
20/12/2020 10:00:00,16/06/2023 15:50:27,Gemini_BTCUSD_1h_17_12_17_to_10_03_23.csv,BTC_USD,HOUR,102767.8,0.088,20/12/2020 11:00:00,20/12/2020 13:00:00,20/12/2020 13:00:00,EXPIRED,LONG,23414.0,23554.0,23971.71,0.0,0.02,2.33,0.0,49.08,2,0.0,12.32
16/04/2021 17:00:00,16/06/2023 15:50:27,Gemini_BTCUSD_1h_17_12_17_to_10_03_23.csv,BTC_USD,HOUR,102780.12,0.033,16/04/2021 18:00:00,16/04/2021 20:00:00,16/04/2021 20:00:00,EXPIRED,LONG,61697.0,62015.0,65810.41,0.0,0.02,6.25,0.0,135.74,2,0.1,10.49
12/04/2018 09:00:00,16/06/2023 15:50:27,Gemini_BTCUSD_1h_17_12_17_to_10_03_23.csv,BTC_USD,HOUR,102790.61,0.3,12/04/2018 12:00:00,12/04/2018 12:00:00,12/04/2018 11:00:00,TAKE_PROFIT_HIT,LONG,6857.0,7176.82,7176.82,0.0,0.02,4.46,0.0,95.95,2,0.0,95.95
17/07/2019 21:00:00,16/06/2023 15:50:27,Gemini_BTCUSD_1h_17_12_17_to_10_03_23.csv,BTC_USD,HOUR,102886.56,0.209,18/07/2019 01:00:00,18/07/2019 00:00:00,18/07/2019 00:00:00,EXPIRED,LONG,9857.0,9624.0,10062.4,0.0,0.02,2.04,0.0,42.93,2,0.0,-48.7
29/08/2022 10:00:00,16/06/2023 15:50:27,Gemini_BTCUSD_1h_17_12_17_to_10_03_23.csv,BTC_USD,HOUR,102837.86,0.104,29/08/2022 11:00:00,29/08/2022 13:00:00,29/08/2022 13:00:00,EXPIRED,LONG,19830.0,20085.0,20340.19,0.0,0.02,2.51,0.0,53.06,2,0.0,26.52
05/04/2018 12:00:00,16/06/2023 15:50:27,Gemini_BTCUSD_1h_17_12_17_to_10_03_23.csv,BTC_USD,HOUR,102864.38,0.309,05/04/2018 13:00:00,05/04/2018 15:00:00,05/04/2018 15:00:00,EXPIRED,LONG,6666.0,6746.0,6943.34,0.0,0.02,3.99,0.0,85.7,2,0.0,24.72
29/01/2023 20:00:00,16/06/2023 15:50:27,Gemini_BTCUSD_1h_17_12_17_to_10_03_23.csv,BTC_USD,HOUR,102889.1,0.087,29/01/2023 21:00:00,29/01/2023 23:00:00,29/01/2023 23:00:00,EXPIRED,LONG,23707.0,23761.0,25548.52,0.0,0.02,7.21,0.0,160.21,2,0.1,4.7
07/09/2020 17:00:00,16/06/2023 15:50:27,Gemini_BTCUSD_1h_17_12_17_to_10_03_23.csv,BTC_USD,HOUR,102893.8,0.202,07/09/2020 18:00:00,07/09/2020 20:00:00,07/09/2020 20:00:00,EXPIRED,LONG,10170.0,10153.0,11012.4,0.0,0.02,7.65,0.0,170.16,2,0.1,-3.43
30/03/2018 20:00:00,16/06/2023 15:50:27,Gemini_BTCUSD_1h_17_12_17_to_10_03_23.csv,BTC_USD,HOUR,102890.37,0.3,31/03/2018 00:00:00,30/03/2018 23:00:00,30/03/2018 23:00:00,EXPIRED,LONG,6850.0,6839.0,7186.54,0.0,0.02,4.68,0.0,100.96,2,0.0,-3.3
07/03/2018 15:00:00,16/06/2023 15:50:27,Gemini_BTCUSD_1h_17_12_17_to_10_03_23.csv,BTC_USD,HOUR,102887.07,0.193,07/03/2018 16:00:00,07/03/2018 18:00:00,07/03/2018 18:00:00,EXPIRED,LONG,10659.0,9677.0,11405.58,0.0,0.02,6.55,0.0,144.09,2,0.1,-189.53
08/06/2020 21:00:00,16/06/2023 15:50:27,Gemini_BTCUSD_1h_17_12_17_to_10_03_23.csv,BTC_USD,HOUR,102697.54,0.211,08/06/2020 22:00:00,09/06/2020 00:00:00,09/06/2020 00:00:00,EXPIRED,LONG,9717.0,9715.0,9941.22,0.0,0.02,2.26,0.0,47.31,2,0.0,-0.42
16/11/2020 08:00:00,16/06/2023 15:50:27,Gemini_BTCUSD_1h_17_12_17_to_10_03_23.csv,BTC_USD,HOUR,102697.12,0.127,16/11/2020 11:00:00,16/11/2020 11:00:00,16/11/2020 11:00:00,EXPIRED,LONG,16233.0,16242.0,17017.85,0.0,0.02,4.61,0.0,99.68,2,0.0,1.14
03/02/2023 13:00:00,16/06/2023 15:50:27,Gemini_BTCUSD_1h_17_12_17_to_10_03_23.csv,BTC_USD,HOUR,102698.26,0.088,03/02/2023 14:00:00,03/02/2023 16:00:00,03/02/2023 16:00:00,EXPIRED,LONG,23348.0,23527.0,24695.75,0.0,0.02,5.46,0.0,118.6,2,0.1,15.75
16/02/2020 04:00:00,16/06/2023 15:50:27,Gemini_BTCUSD_1h_17_12_17_to_10_03_23.csv,BTC_USD,HOUR,102714.01,0.205,16/02/2020 05:00:00,16/02/2020 07:00:00,16/02/2020 07:00:00,EXPIRED,LONG,10027.0,9973.0,10513.26,0.0,0.02,4.63,0.0,99.68,2,0.0,-11.07
10/09/2020 03:00:00,16/06/2023 15:50:27,Gemini_BTCUSD_1h_17_12_17_to_10_03_23.csv,BTC_USD,HOUR,102702.94,0.198,10/09/2020 05:00:00,10/09/2020 06:00:00,10/09/2020 06:00:00,EXPIRED,LONG,10383.0,10347.0,10990.53,0.0,0.02,5.53,0.0,120.29,2,0.1,-7.13
18/05/2018 09:00:00,16/06/2023 15:50:27,Gemini_BTCUSD_1h_17_12_17_to_10_03_23.csv,BTC_USD,HOUR,102695.81,0.253,18/05/2018 10:00:00,18/05/2018 12:00:00,18/05/2018 12:00:00,EXPIRED,LONG,8107.0,8111.0,8645.67,0.0,0.02,6.23,0.0,136.28,2,0.1,1.01
08/09/2021 15:00:00,16/06/2023 15:50:27,Gemini_BTCUSD_1h_17_12_17_to_10_03_23.csv,BTC_USD,HOUR,102696.82,0.045,08/09/2021 18:00:00,08/09/2021 18:00:00,08/09/2021 18:00:00,EXPIRED,LONG,46072.0,46498.0,47111.81,0.0,0.02,2.21,0.0,46.79,2,0.0,19.17
03/06/2021 10:00:00,16/06/2023 15:50:27,Gemini_BTCUSD_1h_17_12_17_to_10_03_23.csv,BTC_USD,HOUR,102715.99,0.052,03/06/2021 12:00:00,03/06/2021 13:00:00,03/06/2021 13:00:00,EXPIRED,LONG,39289.0,38447.0,40241.01,0.0,0.02,2.37,0.0,49.5,2,0.0,-43.78
21/12/2021 00:00:00,16/06/2023 15:50:27,Gemini_BTCUSD_1h_17_12_17_to_10_03_23.csv,BTC_USD,HOUR,102672.21,0.044,21/12/2021 01:00:00,21/12/2021 03:00:00,21/12/2021 03:00:00,EXPIRED,LONG,46792.0,47955.0,48171.67,0.0,0.02,2.86,0.0,60.71,2,0.0,51.17
23/11/2018 23:00:00,16/06/2023 15:50:27,Gemini_BTCUSD_1h_17_12_17_to_10_03_23.csv,BTC_USD,HOUR,102723.38,0.479,24/11/2018 00:00:00,24/11/2018 02:00:00,24/11/2018 02:00:00,EXPIRED,LONG,4288.0,4303.0,4637.12,0.0,0.02,7.53,0.0,167.23,2,0.1,7.19
20/08/2021 03:00:00,16/06/2023 15:50:27,Gemini_BTCUSD_1h_17_12_17_to_10_03_23.csv,BTC_USD,HOUR,102730.57,0.044,20/08/2021 04:00:00,20/08/2021 06:00:00,20/08/2021 06:00:00,EXPIRED,LONG,47042.0,47160.0,50729.27,0.0,0.02,7.27,0.0,162.24,2,0.1,5.19
10/12/2022 08:00:00,16/06/2023 15:50:27,Gemini_BTCUSD_1h_17_12_17_to_10_03_23.csv,BTC_USD,HOUR,102735.76,0.12,10/12/2022 12:00:00,10/12/2022 11:00:00,10/12/2022 11:00:00,EXPIRED,LONG,17151.0,17167.0,18278.99,0.0,0.02,6.17,0.0,135.36,2,0.1,1.92
04/02/2018 08:00:00,16/06/2023 15:50:27,Gemini_BTCUSD_1h_17_12_17_to_10_03_23.csv,BTC_USD,HOUR,102737.68,0.227,04/02/2018 10:00:00,04/02/2018 11:00:00,04/02/2018 11:00:00,EXPIRED,LONG,9046.0,8660.0,9381.74,0.0,0.02,3.58,0.0,76.21,2,0.0,-87.62
25/06/2020 01:00:00,16/06/2023 15:50:27,Gemini_BTCUSD_1h_17_12_17_to_10_03_23.csv,BTC_USD,HOUR,102650.06,0.222,25/06/2020 04:00:00,25/06/2020 04:00:00,25/06/2020 04:00:00,EXPIRED,LONG,9262.0,9102.0,9586.06,0.0,0.02,3.38,0.0,71.94,2,0.0,-35.52
21/08/2019 01:00:00,16/06/2023 15:50:27,Gemini_BTCUSD_1h_17_12_17_to_10_03_23.csv,BTC_USD,HOUR,102614.54,0.192,21/08/2019 05:00:00,21/08/2019 04:00:00,21/08/2019 04:00:00,EXPIRED,LONG,10685.0,10175.0,10937.92,0.0,0.02,2.31,0.0,48.56,2,0.0,-97.92
13/10/2018 12:00:00,16/06/2023 15:50:27,Gemini_BTCUSD_1h_17_12_17_to_10_03_23.csv,BTC_USD,HOUR,102516.62,0.331,13/10/2018 13:00:00,13/10/2018 15:00:00,13/10/2018 15:00:00,EXPIRED,LONG,6200.0,6208.0,6663.07,0.0,0.02,6.95,0.0,153.28,2,0.1,2.65
27/12/2020 11:00:00,16/06/2023 15:50:27,Gemini_BTCUSD_1h_17_12_17_to_10_03_23.csv,BTC_USD,HOUR,102519.27,0.074,27/12/2020 13:00:00,27/12/2020 14:00:00,27/12/2020 14:00:00,EXPIRED,LONG,27619.0,27295.0,28597.28,0.0,0.02,3.42,0.0,72.39,2,0.0,-23.98
25/06/2019 03:00:00,16/06/2023 15:50:27,Gemini_BTCUSD_1h_17_12_17_to_10_03_23.csv,BTC_USD,HOUR,102495.29,0.184,25/06/2019 05:00:00,25/06/2019 06:00:00,25/06/2019 06:00:00,EXPIRED,LONG,11139.0,11273.0,11558.35,0.0,0.02,3.63,0.0,77.16,2,0.0,24.66
01/10/2019 00:00:00,16/06/2023 15:50:27,Gemini_BTCUSD_1h_17_12_17_to_10_03_23.csv,BTC_USD,HOUR,102519.95,0.249,01/10/2019 03:00:00,01/10/2019 03:00:00,01/10/2019 02:00:00,TAKE_PROFIT_HIT,LONG,8224.0,8419.31,8419.31,0.0,0.02,2.32,0.0,48.63,2,0.0,48.63
05/08/2020 04:00:00,16/06/2023 15:50:27,Gemini_BTCUSD_1h_17_12_17_to_10_03_23.csv,BTC_USD,HOUR,102568.58,0.182,05/08/2020 05:00:00,05/08/2020 07:00:00,05/08/2020 07:00:00,EXPIRED,LONG,11257.0,11283.0,11797.68,0.0,0.02,4.58,0.0,98.4,2,0.0,4.73
17/09/2020 07:00:00,16/06/2023 15:50:27,Gemini_BTCUSD_1h_17_12_17_to_10_03_23.csv,BTC_USD,HOUR,102573.31,0.188,17/09/2020 11:00:00,17/09/2020 10:00:00,17/09/2020 10:00:00,EXPIRED,LONG,10894.0,10828.0,11171.3,0.0,0.02,2.48,0.0,52.13,2,0.0,-12.41
12/04/2022 13:00:00,16/06/2023 15:50:27,Gemini_BTCUSD_1h_17_12_17_to_10_03_23.csv,BTC_USD,HOUR,102560.9,0.051,12/04/2022 14:00:00,12/04/2022 16:00:00,12/04/2022 16:00:00,EXPIRED,LONG,40416.0,40099.0,43737.21,0.0,0.02,7.59,0.0,169.38,2,0.1,-16.17
05/04/2018 23:00:00,16/06/2023 15:50:27,Gemini_BTCUSD_1h_17_12_17_to_10_03_23.csv,BTC_USD,HOUR,102544.73,0.303,06/04/2018 00:00:00,06/04/2018 02:00:00,06/04/2018 02:00:00,EXPIRED,LONG,6777.0,6779.0,7026.18,0.0,0.02,3.55,0.0,75.5,2,0.0,0.61
14/03/2022 17:00:00,16/06/2023 15:50:27,Gemini_BTCUSD_1h_17_12_17_to_10_03_23.csv,BTC_USD,HOUR,102545.34,0.053,14/03/2022 18:00:00,14/03/2022 20:00:00,14/03/2022 20:00:00,EXPIRED,LONG,38745.0,38723.0,40760.47,0.0,0.02,4.94,0.0,106.82,2,0.1,-1.17
06/11/2021 20:00:00,16/06/2023 15:50:27,Gemini_BTCUSD_1h_17_12_17_to_10_03_23.csv,BTC_USD,HOUR,102544.17,0.034,06/11/2021 21:00:00,06/11/2021 23:00:00,06/11/2021 23:00:00,EXPIRED,LONG,61200.0,61557.0,64474.91,0.0,0.02,5.08,0.0,111.35,2,0.1,12.14
31/03/2022 06:00:00,16/06/2023 15:50:27,Gemini_BTCUSD_1h_17_12_17_to_10_03_23.csv,BTC_USD,HOUR,102556.31,0.044,31/03/2022 08:00:00,31/03/2022 09:00:00,31/03/2022 09:00:00,EXPIRED,LONG,47143.0,47318.0,48250.79,0.0,0.02,2.3,0.0,48.74,2,0.0,7.7
13/02/2019 21:00:00,16/06/2023 15:50:27,Gemini_BTCUSD_1h_17_12_17_to_10_03_23.csv,BTC_USD,HOUR,102564.01,0.574,13/02/2019 22:00:00,14/02/2019 00:00:00,14/02/2019 00:00:00,EXPIRED,LONG,3572.0,3586.0,3657.71,0.0,0.02,2.34,0.0,49.2,2,0.0,8.04
05/09/2022 00:00:00,16/06/2023 15:50:27,Gemini_BTCUSD_1h_17_12_17_to_10_03_23.csv,BTC_USD,HOUR,102572.05,0.103,05/09/2022 01:00:00,05/09/2022 03:00:00,05/09/2022 03:00:00,EXPIRED,LONG,19922.0,19884.0,20286.87,0.0,0.02,1.8,0.0,37.58,2,0.0,-3.91
27/08/2018 08:00:00,16/06/2023 15:50:27,Gemini_BTCUSD_1h_17_12_17_to_10_03_23.csv,BTC_USD,HOUR,102568.14,0.306,27/08/2018 09:00:00,27/08/2018 11:00:00,27/08/2018 11:00:00,EXPIRED,LONG,6696.0,6701.0,6950.06,0.0,0.02,3.66,0.0,77.74,2,0.0,1.53
18/08/2019 03:00:00,16/06/2023 15:50:27,Gemini_BTCUSD_1h_17_12_17_to_10_03_23.csv,BTC_USD,HOUR,102569.67,0.203,18/08/2019 07:00:00,18/08/2019 06:00:00,18/08/2019 06:00:00,EXPIRED,LONG,10116.0,10169.0,10513.2,0.0,0.02,3.78,0.0,80.63,2,0.0,10.76
09/05/2019 01:00:00,16/06/2023 15:50:27,Gemini_BTCUSD_1h_17_12_17_to_10_03_23.csv,BTC_USD,HOUR,102580.43,0.339,09/05/2019 02:00:00,09/05/2019 04:00:00,09/05/2019 04:00:00,EXPIRED,LONG,6055.0,6059.0,6457.49,0.0,0.02,6.23,0.0,136.44,2,0.1,1.36
19/04/2021 09:00:00,16/06/2023 15:50:27,Gemini_BTCUSD_1h_17_12_17_to_10_03_23.csv,BTC_USD,HOUR,102581.79,0.036,19/04/2021 10:00:00,19/04/2021 12:00:00,19/04/2021 12:00:00,EXPIRED,LONG,56797.0,56602.0,59555.49,0.0,0.02,4.63,0.0,99.31,2,0.0,-7.02
07/02/2022 01:00:00,16/06/2023 15:50:27,Gemini_BTCUSD_1h_17_12_17_to_10_03_23.csv,BTC_USD,HOUR,102574.77,0.049,07/02/2022 03:00:00,07/02/2022 04:00:00,07/02/2022 04:00:00,EXPIRED,LONG,42148.0,42865.0,43147.29,0.0,0.02,2.32,0.0,48.97,2,0.0,35.13
23/01/2022 10:00:00,16/06/2023 15:50:27,Gemini_BTCUSD_1h_17_12_17_to_10_03_23.csv,BTC_USD,HOUR,102609.9,0.057,23/01/2022 12:00:00,23/01/2022 13:00:00,23/01/2022 13:00:00,EXPIRED,LONG,35924.0,36006.0,38606.66,0.0,0.02,6.95,0.0,152.91,2,0.1,4.67
09/08/2021 23:00:00,16/06/2023 15:50:27,Gemini_BTCUSD_1h_17_12_17_to_10_03_23.csv,BTC_USD,HOUR,102614.57,0.044,10/08/2021 00:00:00,10/08/2021 02:00:00,10/08/2021 02:00:00,EXPIRED,LONG,46279.0,46093.0,48740.66,0.0,0.02,5.05,0.0,108.31,2,0.1,-8.18
02/02/2021 12:00:00,16/06/2023 15:50:27,Gemini_BTCUSD_1h_17_12_17_to_10_03_23.csv,BTC_USD,HOUR,102606.39,0.059,02/02/2021 13:00:00,02/02/2021 15:00:00,02/02/2021 15:00:00,EXPIRED,LONG,34818.0,34750.0,35721.93,0.0,0.02,2.53,0.0,53.33,2,0.0,-4.01
16/03/2020 19:00:00,16/06/2023 15:50:27,Gemini_BTCUSD_1h_17_12_17_to_10_03_23.csv,BTC_USD,HOUR,102602.38,0.415,16/03/2020 22:00:00,16/03/2020 22:00:00,16/03/2020 22:00:00,EXPIRED,LONG,4950.0,4937.0,5065.2,0.0,0.02,2.27,0.0,47.81,2,0.0,-5.39
10/10/2021 06:00:00,16/06/2023 15:50:27,Gemini_BTCUSD_1h_17_12_17_to_10_03_23.csv,BTC_USD,HOUR,102596.99,0.037,10/10/2021 07:00:00,10/10/2021 09:00:00,10/10/2021 09:00:00,EXPIRED,LONG,55619.0,54984.0,59543.97,0.0,0.02,6.59,0.0,145.22,2,0.1,-23.49
15/06/2019 06:00:00,16/06/2023 15:50:27,Gemini_BTCUSD_1h_17_12_17_to_10_03_23.csv,BTC_USD,HOUR,102573.5,0.236,15/06/2019 07:00:00,15/06/2019 09:00:00,15/06/2019 09:00:00,EXPIRED,LONG,8691.0,8669.0,9334.96,0.0,0.02,6.9,0.0,151.97,2,0.1,-5.19
28/12/2019 02:00:00,16/06/2023 15:50:27,Gemini_BTCUSD_1h_17_12_17_to_10_03_23.csv,BTC_USD,HOUR,102568.31,0.281,28/12/2019 03:00:00,28/12/2019 05:00:00,28/12/2019 05:00:00,EXPIRED,LONG,7290.0,7313.0,7576.1,0.0,0.02,3.78,0.0,80.39,2,0.0,6.46
20/04/2018 21:00:00,16/06/2023 15:50:27,Gemini_BTCUSD_1h_17_12_17_to_10_03_23.csv,BTC_USD,HOUR,102574.77,0.241,20/04/2018 23:00:00,21/04/2018 00:00:00,21/04/2018 00:00:00,EXPIRED,LONG,8520.0,8847.0,9291.74,0.0,0.02,8.31,0.0,185.99,2,0.1,78.81
29/05/2020 15:00:00,16/06/2023 15:50:27,Gemini_BTCUSD_1h_17_12_17_to_10_03_23.csv,BTC_USD,HOUR,102653.58,0.218,29/05/2020 19:00:00,29/05/2020 18:00:00,29/05/2020 18:00:00,EXPIRED,LONG,9409.0,9433.0,9612.73,0.0,0.02,2.12,0.0,44.41,2,0.0,5.23
29/04/2020 02:00:00,16/06/2023 15:50:27,Gemini_BTCUSD_1h_17_12_17_to_10_03_23.csv,BTC_USD,HOUR,102658.81,0.263,29/04/2020 05:00:00,29/04/2020 05:00:00,29/04/2020 05:00:00,EXPIRED,LONG,7802.0,7876.0,8273.37,0.0,0.02,5.7,0.0,123.97,2,0.1,19.46
15/02/2019 14:00:00,16/06/2023 15:50:27,Gemini_BTCUSD_1h_17_12_17_to_10_03_23.csv,BTC_USD,HOUR,102678.27,0.577,15/02/2019 18:00:00,15/02/2019 17:00:00,15/02/2019 17:00:00,EXPIRED,LONG,3556.0,3565.0,3692.5,0.0,0.02,3.7,0.0,78.76,2,0.0,5.19
27/01/2020 19:00:00,16/06/2023 15:50:27,Gemini_BTCUSD_1h_17_12_17_to_10_03_23.csv,BTC_USD,HOUR,102683.46,0.231,27/01/2020 20:00:00,27/01/2020 22:00:00,27/01/2020 22:00:00,EXPIRED,LONG,8909.0,8888.0,9094.65,0.0,0.02,2.04,0.0,42.89,2,0.0,-4.85
20/06/2018 10:00:00,16/06/2023 15:50:27,Gemini_BTCUSD_1h_17_12_17_to_10_03_23.csv,BTC_USD,HOUR,102678.61,0.31,20/06/2018 11:00:00,20/06/2018 13:00:00,20/06/2018 13:00:00,EXPIRED,LONG,6632.0,6734.0,6773.41,0.0,0.02,2.09,0.0,43.84,2,0.0,31.62
02/09/2021 12:00:00,16/06/2023 15:50:27,Gemini_BTCUSD_1h_17_12_17_to_10_03_23.csv,BTC_USD,HOUR,102710.23,0.041,02/09/2021 16:00:00,02/09/2021 15:00:00,02/09/2021 15:00:00,EXPIRED,LONG,50037.0,49554.0,51241.53,0.0,0.02,2.35,0.0,49.39,2,0.0,-19.8
11/05/2022 17:00:00,16/06/2023 15:50:27,Gemini_BTCUSD_1h_17_12_17_to_10_03_23.csv,BTC_USD,HOUR,102690.43,0.069,11/05/2022 18:00:00,11/05/2022 20:00:00,11/05/2022 20:00:00,EXPIRED,LONG,29870.0,28416.0,30663.69,0.0,0.02,2.59,0.0,54.76,2,0.0,-100.33
24/05/2022 13:00:00,16/06/2023 15:50:27,Gemini_BTCUSD_1h_17_12_17_to_10_03_23.csv,BTC_USD,HOUR,102590.1,0.071,24/05/2022 14:00:00,24/05/2022 16:00:00,24/05/2022 15:00:00,TAKE_PROFIT_HIT,LONG,28900.0,29520.24,29520.24,0.0,0.02,2.1,0.0,44.04,2,0.0,44.04
10/07/2021 00:00:00,16/06/2023 15:50:27,Gemini_BTCUSD_1h_17_12_17_to_10_03_23.csv,BTC_USD,HOUR,102634.14,0.06,10/07/2021 02:00:00,10/07/2021 03:00:00,10/07/2021 03:00:00,EXPIRED,LONG,34036.0,33800.0,36915.4,0.0,0.02,7.8,0.0,172.76,2,0.1,-14.16
07/05/2021 11:00:00,16/06/2023 15:50:27,Gemini_BTCUSD_1h_17_12_17_to_10_03_23.csv,BTC_USD,HOUR,102619.98,0.036,07/05/2021 12:00:00,07/05/2021 14:00:00,07/05/2021 14:00:00,EXPIRED,LONG,56505.0,57216.0,60775.01,0.0,0.02,7.03,0.0,153.72,2,0.1,25.6
18/08/2019 04:00:00,16/06/2023 15:50:27,Gemini_BTCUSD_1h_17_12_17_to_10_03_23.csv,BTC_USD,HOUR,102645.58,0.203,18/08/2019 05:00:00,18/08/2019 07:00:00,18/08/2019 07:00:00,EXPIRED,LONG,10127.0,10139.0,10424.94,0.0,0.02,2.86,0.0,60.48,2,0.0,2.44
18/05/2021 22:00:00,16/06/2023 15:50:27,Gemini_BTCUSD_1h_17_12_17_to_10_03_23.csv,BTC_USD,HOUR,102648.02,0.048,18/05/2021 23:00:00,19/05/2021 01:00:00,19/05/2021 01:00:00,EXPIRED,LONG,42838.0,40878.0,45540.74,0.0,0.02,5.93,0.0,129.73,2,0.1,-94.08
23/08/2018 22:00:00,16/06/2023 15:50:27,Gemini_BTCUSD_1h_17_12_17_to_10_03_23.csv,BTC_USD,HOUR,102553.94,0.315,23/08/2018 23:00:00,24/08/2018 01:00:00,24/08/2018 01:00:00,EXPIRED,LONG,6502.0,6497.0,6652.48,0.0,0.02,2.26,0.0,47.4,2,0.0,-1.57
11/04/2022 07:00:00,16/06/2023 15:50:27,Gemini_BTCUSD_1h_17_12_17_to_10_03_23.csv,BTC_USD,HOUR,102552.37,0.048,11/04/2022 09:00:00,11/04/2022 10:00:00,11/04/2022 10:00:00,EXPIRED,LONG,42322.0,41615.0,44268.49,0.0,0.02,4.4,0.0,93.43,2,0.0,-33.94
25/08/2022 10:00:00,16/06/2023 15:50:27,Gemini_BTCUSD_1h_17_12_17_to_10_03_23.csv,BTC_USD,HOUR,102518.43,0.095,25/08/2022 11:00:00,25/08/2022 13:00:00,25/08/2022 13:00:00,EXPIRED,LONG,21629.0,21714.0,22148.0,0.0,0.02,2.34,0.0,49.31,2,0.0,8.07
28/03/2021 09:00:00,16/06/2023 15:50:27,Gemini_BTCUSD_1h_17_12_17_to_10_03_23.csv,BTC_USD,HOUR,102526.5,0.037,28/03/2021 13:00:00,28/03/2021 12:00:00,28/03/2021 12:00:00,EXPIRED,LONG,56099.0,55514.0,58331.99,0.0,0.02,3.83,0.0,82.62,2,0.0,-21.64
19/07/2021 23:00:00,16/06/2023 15:50:27,Gemini_BTCUSD_1h_17_12_17_to_10_03_23.csv,BTC_USD,HOUR,102504.86,0.066,20/07/2021 00:00:00,20/07/2021 02:00:00,20/07/2021 02:00:00,EXPIRED,LONG,30829.0,30191.0,32744.1,0.0,0.02,5.85,0.0,126.4,2,0.1,-42.11
08/01/2020 16:00:00,16/06/2023 15:50:27,Gemini_BTCUSD_1h_17_12_17_to_10_03_23.csv,BTC_USD,HOUR,102462.75,0.253,08/01/2020 18:00:00,08/01/2020 19:00:00,08/01/2020 19:00:00,EXPIRED,LONG,8107.0,7977.0,8657.91,0.0,0.02,6.36,0.0,139.38,2,0.1,-32.89
22/01/2023 02:00:00,16/06/2023 15:50:27,Gemini_BTCUSD_1h_17_12_17_to_10_03_23.csv,BTC_USD,HOUR,102429.86,0.09,22/01/2023 06:00:00,22/01/2023 05:00:00,22/01/2023 05:00:00,EXPIRED,LONG,22710.0,22881.0,23213.11,0.0,0.02,2.17,0.0,45.28,2,0.0,15.39
13/02/2018 03:00:00,16/06/2023 15:50:27,Gemini_BTCUSD_1h_17_12_17_to_10_03_23.csv,BTC_USD,HOUR,102445.25,0.234,13/02/2018 04:00:00,13/02/2018 06:00:00,13/02/2018 06:00:00,EXPIRED,LONG,8765.0,8736.0,8989.41,0.0,0.02,2.5,0.0,52.51,2,0.0,-6.79
24/03/2020 12:00:00,16/06/2023 15:50:27,Gemini_BTCUSD_1h_17_12_17_to_10_03_23.csv,BTC_USD,HOUR,102438.46,0.306,24/03/2020 16:00:00,24/03/2020 15:00:00,24/03/2020 15:00:00,EXPIRED,LONG,6696.0,6622.0,7106.53,0.0,0.02,5.78,0.0,125.62,2,0.1,-22.64
12/02/2018 11:00:00,16/06/2023 15:50:27,Gemini_BTCUSD_1h_17_12_17_to_10_03_23.csv,BTC_USD,HOUR,102415.82,0.236,12/02/2018 12:00:00,12/02/2018 14:00:00,12/02/2018 14:00:00,EXPIRED,LONG,8665.0,8550.0,9095.34,0.0,0.02,4.73,0.0,101.56,2,0.0,-27.14
24/08/2019 23:00:00,16/06/2023 15:50:27,Gemini_BTCUSD_1h_17_12_17_to_10_03_23.csv,BTC_USD,HOUR,102388.68,0.202,25/08/2019 00:00:00,25/08/2019 02:00:00,25/08/2019 02:00:00,EXPIRED,LONG,10152.0,10136.0,10507.33,0.0,0.02,3.38,0.0,71.78,2,0.0,-3.23
18/12/2017 13:00:00,16/06/2023 15:50:27,Gemini_BTCUSD_1h_17_12_17_to_10_03_23.csv,BTC_USD,HOUR,102385.45,0.109,18/12/2017 15:00:00,18/12/2017 16:00:00,18/12/2017 16:00:00,EXPIRED,LONG,18838.0,18620.0,20127.59,0.0,0.02,6.41,0.0,140.57,2,0.1,-23.76
29/06/2021 03:00:00,16/06/2023 15:50:27,Gemini_BTCUSD_1h_17_12_17_to_10_03_23.csv,BTC_USD,HOUR,102361.69,0.059,29/06/2021 04:00:00,29/06/2021 06:00:00,29/06/2021 06:00:00,EXPIRED,LONG,34592.0,35312.0,37229.61,0.0,0.02,7.08,0.0,155.62,2,0.1,42.48
29/09/2020 23:00:00,16/06/2023 15:50:27,Gemini_BTCUSD_1h_17_12_17_to_10_03_23.csv,BTC_USD,HOUR,102404.17,0.189,30/09/2020 01:00:00,30/09/2020 02:00:00,30/09/2020 02:00:00,EXPIRED,LONG,10846.0,10778.0,11254.7,0.0,0.02,3.63,0.0,77.24,2,0.0,-12.85
24/11/2018 11:00:00,16/06/2023 15:50:27,Gemini_BTCUSD_1h_17_12_17_to_10_03_23.csv,BTC_USD,HOUR,102391.32,0.482,24/11/2018 14:00:00,24/11/2018 14:00:00,24/11/2018 14:00:00,EXPIRED,LONG,4251.0,4247.0,4345.16,0.0,0.02,2.17,0.0,45.39,2,0.0,-1.93
02/01/2021 20:00:00,16/06/2023 15:50:27,Gemini_BTCUSD_1h_17_12_17_to_10_03_23.csv,BTC_USD,HOUR,102389.39,0.067,03/01/2021 00:00:00,02/01/2021 23:00:00,02/01/2021 21:00:00,TAKE_PROFIT_HIT,LONG,30672.0,31868.49,31868.49,0.0,0.02,3.75,0.0,80.16,2,0.0,80.16
22/10/2020 18:00:00,16/06/2023 15:50:27,Gemini_BTCUSD_1h_17_12_17_to_10_03_23.csv,BTC_USD,HOUR,102469.55,0.157,22/10/2020 20:00:00,22/10/2020 21:00:00,22/10/2020 21:00:00,EXPIRED,LONG,13065.0,13167.0,14026.93,0.0,0.02,6.86,0.0,151.02,2,0.1,16.01
24/07/2018 19:00:00,16/06/2023 15:50:27,Gemini_BTCUSD_1h_17_12_17_to_10_03_23.csv,BTC_USD,HOUR,102485.56,0.248,24/07/2018 22:00:00,24/07/2018 22:00:00,24/07/2018 22:00:00,EXPIRED,LONG,8258.0,8309.0,8429.51,0.0,0.02,2.03,0.0,42.53,2,0.0,12.65
04/03/2020 02:00:00,16/06/2023 15:50:27,Gemini_BTCUSD_1h_17_12_17_to_10_03_23.csv,BTC_USD,HOUR,102498.21,0.233,04/03/2020 05:00:00,04/03/2020 05:00:00,04/03/2020 05:00:00,EXPIRED,LONG,8810.0,8843.0,9033.95,0.0,0.02,2.48,0.0,52.18,2,0.0,7.69
02/06/2021 13:00:00,16/06/2023 15:50:27,Gemini_BTCUSD_1h_17_12_17_to_10_03_23.csv,BTC_USD,HOUR,102505.9,0.055,02/06/2021 15:00:00,02/06/2021 16:00:00,02/06/2021 16:00:00,EXPIRED,LONG,37539.0,37880.0,38706.26,0.0,0.02,3.02,0.0,64.2,2,0.0,18.76
27/09/2021 23:00:00,16/06/2023 15:50:27,Gemini_BTCUSD_1h_17_12_17_to_10_03_23.csv,BTC_USD,HOUR,102524.66,0.049,28/09/2021 02:00:00,28/09/2021 02:00:00,28/09/2021 02:00:00,EXPIRED,LONG,42173.0,42457.0,44459.3,0.0,0.02,5.14,0.0,112.03,2,0.1,13.92
19/09/2022 20:00:00,16/06/2023 15:50:27,Gemini_BTCUSD_1h_17_12_17_to_10_03_23.csv,BTC_USD,HOUR,102538.58,0.105,19/09/2022 21:00:00,19/09/2022 23:00:00,19/09/2022 23:00:00,EXPIRED,LONG,19529.0,19534.0,20593.88,0.0,0.02,5.17,0.0,111.81,2,0.1,0.53
02/08/2022 16:00:00,16/06/2023 15:50:27,Gemini_BTCUSD_1h_17_12_17_to_10_03_23.csv,BTC_USD,HOUR,102539.11,0.088,02/08/2022 20:00:00,02/08/2022 19:00:00,02/08/2022 19:00:00,EXPIRED,LONG,23385.0,22950.0,24509.87,0.0,0.02,4.59,0.0,98.99,2,0.0,-38.28
02/11/2020 15:00:00,16/06/2023 15:50:27,Gemini_BTCUSD_1h_17_12_17_to_10_03_23.csv,BTC_USD,HOUR,102500.83,0.152,02/11/2020 19:00:00,02/11/2020 18:00:00,02/11/2020 18:00:00,EXPIRED,LONG,13514.0,13475.0,13954.48,0.0,0.02,3.16,0.0,66.95,2,0.0,-5.93
12/07/2019 23:00:00,16/06/2023 15:50:27,Gemini_BTCUSD_1h_17_12_17_to_10_03_23.csv,BTC_USD,HOUR,102494.9,0.174,13/07/2019 00:00:00,13/07/2019 02:00:00,13/07/2019 02:00:00,EXPIRED,LONG,11776.0,11692.0,12361.54,0.0,0.02,4.74,0.0,101.88,2,0.0,-14.62
26/03/2022 20:00:00,16/06/2023 15:50:27,Gemini_BTCUSD_1h_17_12_17_to_10_03_23.csv,BTC_USD,HOUR,102480.28,0.046,26/03/2022 22:00:00,26/03/2022 23:00:00,26/03/2022 23:00:00,EXPIRED,LONG,44595.0,44548.0,47950.69,0.0,0.02,7.0,0.0,154.36,2,0.1,-2.16
25/02/2021 13:00:00,16/06/2023 15:50:27,Gemini_BTCUSD_1h_17_12_17_to_10_03_23.csv,BTC_USD,HOUR,102478.12,0.04,25/02/2021 14:00:00,25/02/2021 16:00:00,25/02/2021 16:00:00,EXPIRED,LONG,51374.0,50679.0,54253.21,0.0,0.02,5.31,0.0,115.17,2,0.1,-27.8
15/06/2022 14:00:00,16/06/2023 15:50:27,Gemini_BTCUSD_1h_17_12_17_to_10_03_23.csv,BTC_USD,HOUR,102450.32,0.097,15/06/2022 15:00:00,15/06/2022 17:00:00,15/06/2022 17:00:00,EXPIRED,LONG,21189.0,21072.0,22926.89,0.0,0.02,7.58,0.0,168.58,2,0.1,-11.35
12/08/2019 15:00:00,16/06/2023 15:50:27,Gemini_BTCUSD_1h_17_12_17_to_10_03_23.csv,BTC_USD,HOUR,102438.97,0.18,12/08/2019 16:00:00,12/08/2019 18:00:00,12/08/2019 18:00:00,EXPIRED,LONG,11375.0,11404.0,12137.49,0.0,0.02,6.28,0.0,137.25,2,0.1,5.22
06/04/2020 22:00:00,16/06/2023 15:50:27,Gemini_BTCUSD_1h_17_12_17_to_10_03_23.csv,BTC_USD,HOUR,102444.19,0.282,07/04/2020 02:00:00,07/04/2020 01:00:00,07/04/2020 01:00:00,EXPIRED,LONG,7276.0,7353.0,7612.23,0.0,0.02,4.42,0.0,94.82,2,0.0,21.71
14/01/2020 18:00:00,16/06/2023 15:50:27,Gemini_BTCUSD_1h_17_12_17_to_10_03_23.csv,BTC_USD,HOUR,102465.9,0.233,14/01/2020 19:00:00,14/01/2020 21:00:00,14/01/2020 21:00:00,EXPIRED,LONG,8777.0,8745.0,9137.72,0.0,0.02,3.95,0.0,84.05,2,0.0,-7.46
26/09/2019 02:00:00,16/06/2023 15:50:27,Gemini_BTCUSD_1h_17_12_17_to_10_03_23.csv,BTC_USD,HOUR,102458.44,0.245,26/09/2019 04:00:00,26/09/2019 05:00:00,26/09/2019 05:00:00,EXPIRED,LONG,8370.0,8394.0,8561.8,0.0,0.02,2.24,0.0,46.99,2,0.0,5.88
22/09/2018 01:00:00,16/06/2023 15:50:27,Gemini_BTCUSD_1h_17_12_17_to_10_03_23.csv,BTC_USD,HOUR,102464.32,0.303,22/09/2018 04:00:00,22/09/2018 04:00:00,22/09/2018 04:00:00,EXPIRED,LONG,6756.0,6744.0,7013.53,0.0,0.02,3.67,0.0,78.03,2,0.0,-3.64
29/12/2022 15:00:00,16/06/2023 15:50:27,Gemini_BTCUSD_1h_17_12_17_to_10_03_23.csv,BTC_USD,HOUR,102460.68,0.123,29/12/2022 16:00:00,29/12/2022 18:00:00,29/12/2022 18:00:00,EXPIRED,LONG,16610.0,16619.0,17430.57,0.0,0.02,4.71,0.0,100.93,2,0.0,1.11
19/03/2019 03:00:00,16/06/2023 15:50:27,Gemini_BTCUSD_1h_17_12_17_to_10_03_23.csv,BTC_USD,HOUR,102461.79,0.515,19/03/2019 04:00:00,19/03/2019 06:00:00,19/03/2019 06:00:00,EXPIRED,LONG,3976.0,3958.0,4086.98,0.0,0.02,2.72,0.0,57.15,2,0.0,-9.27
25/08/2018 02:00:00,16/06/2023 15:50:27,Gemini_BTCUSD_1h_17_12_17_to_10_03_23.csv,BTC_USD,HOUR,102452.52,0.303,25/08/2018 04:00:00,25/08/2018 05:00:00,25/08/2018 05:00:00,EXPIRED,LONG,6770.0,6732.0,7229.72,0.0,0.02,6.36,0.0,139.3,2,0.1,-11.51
28/12/2018 14:00:00,16/06/2023 15:50:27,Gemini_BTCUSD_1h_17_12_17_to_10_03_23.csv,BTC_USD,HOUR,102441.01,0.568,28/12/2018 18:00:00,28/12/2018 17:00:00,28/12/2018 15:00:00,TAKE_PROFIT_HIT,LONG,3608.0,3695.02,3695.02,0.0,0.02,2.36,0.0,49.43,2,0.0,49.43
16/11/2021 20:00:00,16/06/2023 15:50:27,Gemini_BTCUSD_1h_17_12_17_to_10_03_23.csv,BTC_USD,HOUR,102490.44,0.034,16/11/2021 21:00:00,16/11/2021 23:00:00,16/11/2021 23:00:00,EXPIRED,LONG,59754.0,60122.0,61980.28,0.0,0.02,3.59,0.0,75.69,2,0.0,12.51
11/05/2019 18:00:00,16/06/2023 15:50:27,Gemini_BTCUSD_1h_17_12_17_to_10_03_23.csv,BTC_USD,HOUR,102502.95,0.295,11/05/2019 19:00:00,11/05/2019 21:00:00,11/05/2019 21:00:00,EXPIRED,LONG,6956.0,7077.0,7132.79,0.0,0.02,2.48,0.0,52.15,2,0.0,35.7
22/12/2020 10:00:00,16/06/2023 15:50:27,Gemini_BTCUSD_1h_17_12_17_to_10_03_23.csv,BTC_USD,HOUR,102538.65,0.09,22/12/2020 11:00:00,22/12/2020 13:00:00,22/12/2020 13:00:00,EXPIRED,LONG,22719.0,23499.0,23629.21,0.0,0.02,3.85,0.0,81.92,2,0.0,70.2
26/10/2022 15:00:00,16/06/2023 15:50:27,Gemini_BTCUSD_1h_17_12_17_to_10_03_23.csv,BTC_USD,HOUR,102608.85,0.098,26/10/2022 16:00:00,26/10/2022 18:00:00,26/10/2022 18:00:00,EXPIRED,LONG,20846.0,20703.0,22162.87,0.0,0.02,5.94,0.0,129.05,2,0.1,-14.01
13/04/2021 11:00:00,16/06/2023 15:50:27,Gemini_BTCUSD_1h_17_12_17_to_10_03_23.csv,BTC_USD,HOUR,102594.84,0.033,13/04/2021 12:00:00,13/04/2021 14:00:00,13/04/2021 14:00:00,EXPIRED,LONG,62960.0,62985.0,66813.01,0.0,0.02,5.77,0.0,127.15,2,0.1,0.83
06/04/2020 08:00:00,16/06/2023 15:50:27,Gemini_BTCUSD_1h_17_12_17_to_10_03_23.csv,BTC_USD,HOUR,102595.67,0.291,06/04/2020 10:00:00,06/04/2020 11:00:00,06/04/2020 11:00:00,EXPIRED,LONG,7055.0,7108.0,7587.37,0.0,0.02,7.02,0.0,154.92,2,0.1,15.42
27/01/2023 11:00:00,16/06/2023 15:50:27,Gemini_BTCUSD_1h_17_12_17_to_10_03_23.csv,BTC_USD,HOUR,102611.09,0.089,27/01/2023 12:00:00,27/01/2023 14:00:00,27/01/2023 14:00:00,EXPIRED,LONG,22987.0,22958.0,23497.79,0.0,0.02,2.17,0.0,45.46,2,0.0,-2.58
09/11/2019 11:00:00,16/06/2023 15:50:27,Gemini_BTCUSD_1h_17_12_17_to_10_03_23.csv,BTC_USD,HOUR,102608.51,0.233,09/11/2019 14:00:00,09/11/2019 14:00:00,09/11/2019 14:00:00,EXPIRED,LONG,8812.0,8820.0,9422.96,0.0,0.02,6.48,0.0,142.35,2,0.1,1.86
16/07/2018 16:00:00,16/06/2023 15:50:27,Gemini_BTCUSD_1h_17_12_17_to_10_03_23.csv,BTC_USD,HOUR,102610.37,0.31,16/07/2018 17:00:00,16/07/2018 19:00:00,16/07/2018 19:00:00,EXPIRED,LONG,6615.0,6678.0,6776.13,0.0,0.02,2.38,0.0,49.95,2,0.0,19.53
23/12/2019 12:00:00,16/06/2023 15:50:27,Gemini_BTCUSD_1h_17_12_17_to_10_03_23.csv,BTC_USD,HOUR,102629.9,0.271,23/12/2019 13:00:00,23/12/2019 15:00:00,23/12/2019 15:00:00,EXPIRED,LONG,7561.0,7586.0,7730.41,0.0,0.02,2.19,0.0,45.91,2,0.0,6.78
03/10/2020 12:00:00,16/06/2023 15:50:27,Gemini_BTCUSD_1h_17_12_17_to_10_03_23.csv,BTC_USD,HOUR,102636.68,0.195,03/10/2020 16:00:00,03/10/2020 15:00:00,03/10/2020 15:00:00,EXPIRED,LONG,10541.0,10562.0,10811.62,0.0,0.02,2.5,0.0,52.77,2,0.0,4.1
30/03/2020 23:00:00,16/06/2023 15:50:27,Gemini_BTCUSD_1h_17_12_17_to_10_03_23.csv,BTC_USD,HOUR,102640.78,0.32,31/03/2020 01:00:00,31/03/2020 02:00:00,31/03/2020 02:00:00,EXPIRED,LONG,6407.0,6467.0,6554.28,0.0,0.02,2.25,0.0,47.13,2,0.0,19.2
04/12/2018 15:00:00,16/06/2023 15:50:27,Gemini_BTCUSD_1h_17_12_17_to_10_03_23.csv,BTC_USD,HOUR,102659.98,0.517,04/12/2018 17:00:00,04/12/2018 18:00:00,04/12/2018 18:00:00,EXPIRED,LONG,3972.0,3911.0,4306.33,0.0,0.02,7.76,0.0,172.85,2,0.1,-31.54
03/01/2023 07:00:00,16/06/2023 15:50:27,Gemini_BTCUSD_1h_17_12_17_to_10_03_23.csv,BTC_USD,HOUR,102628.44,0.123,03/01/2023 11:00:00,03/01/2023 10:00:00,03/01/2023 10:00:00,EXPIRED,LONG,16722.0,16723.0,17315.21,0.0,0.02,3.43,0.0,72.96,2,0.0,0.12
01/05/2018 23:00:00,16/06/2023 15:50:27,Gemini_BTCUSD_1h_17_12_17_to_10_03_23.csv,BTC_USD,HOUR,102628.56,0.227,02/05/2018 01:00:00,02/05/2018 02:00:00,02/05/2018 02:00:00,EXPIRED,LONG,9060.0,9035.0,9746.7,0.0,0.02,7.05,0.0,155.88,2,0.1,-5.67
24/07/2022 02:00:00,16/06/2023 15:50:27,Gemini_BTCUSD_1h_17_12_17_to_10_03_23.csv,BTC_USD,HOUR,102622.89,0.091,24/07/2022 03:00:00,24/07/2022 05:00:00,24/07/2022 05:00:00,EXPIRED,LONG,22479.0,22754.0,22967.33,0.0,0.02,2.13,0.0,44.44,2,0.0,25.03
04/11/2020 16:00:00,16/06/2023 15:50:27,Gemini_BTCUSD_1h_17_12_17_to_10_03_23.csv,BTC_USD,HOUR,102647.92,0.146,04/11/2020 17:00:00,04/11/2020 19:00:00,04/11/2020 19:00:00,EXPIRED,LONG,14045.0,14129.0,14459.19,0.0,0.02,2.86,0.0,60.47,2,0.0,12.26
29/06/2018 09:00:00,16/06/2023 15:50:27,Gemini_BTCUSD_1h_17_12_17_to_10_03_23.csv,BTC_USD,HOUR,102660.18,0.347,29/06/2018 10:00:00,29/06/2018 12:00:00,29/06/2018 12:00:00,EXPIRED,LONG,5912.0,5859.0,6263.65,0.0,0.02,5.61,0.0,122.02,2,0.1,-18.39
17/02/2020 03:00:00,16/06/2023 15:50:27,Gemini_BTCUSD_1h_17_12_17_to_10_03_23.csv,BTC_USD,HOUR,102641.79,0.209,17/02/2020 04:00:00,17/02/2020 06:00:00,17/02/2020 06:00:00,EXPIRED,LONG,9827.0,9787.0,10218.36,0.0,0.02,3.83,0.0,81.79,2,0.0,-8.36
18/05/2020 07:00:00,16/06/2023 15:50:27,Gemini_BTCUSD_1h_17_12_17_to_10_03_23.csv,BTC_USD,HOUR,102633.43,0.21,18/05/2020 10:00:00,18/05/2020 10:00:00,18/05/2020 10:00:00,EXPIRED,LONG,9768.0,9625.0,9993.87,0.0,0.02,2.26,0.0,47.43,2,0.0,-30.03
26/03/2022 22:00:00,16/06/2023 15:50:27,Gemini_BTCUSD_1h_17_12_17_to_10_03_23.csv,BTC_USD,HOUR,102603.4,0.046,26/03/2022 23:00:00,27/03/2022 01:00:00,27/03/2022 01:00:00,EXPIRED,LONG,44400.0,44754.0,45591.48,0.0,0.02,2.61,0.0,54.81,2,0.0,16.28
12/08/2021 21:00:00,16/06/2023 15:50:27,Gemini_BTCUSD_1h_17_12_17_to_10_03_23.csv,BTC_USD,HOUR,102619.68,0.046,12/08/2021 22:00:00,13/08/2021 00:00:00,13/08/2021 00:00:00,EXPIRED,LONG,44266.0,44519.0,46665.74,0.0,0.02,5.14,0.0,110.39,2,0.1,11.64
09/07/2021 05:00:00,16/06/2023 15:50:27,Gemini_BTCUSD_1h_17_12_17_to_10_03_23.csv,BTC_USD,HOUR,102631.32,0.062,09/07/2021 06:00:00,09/07/2021 08:00:00,09/07/2021 08:00:00,EXPIRED,LONG,32992.0,32838.0,35469.98,0.0,0.02,6.99,0.0,153.63,2,0.1,-9.55
07/01/2021 14:00:00,16/06/2023 15:50:27,Gemini_BTCUSD_1h_17_12_17_to_10_03_23.csv,BTC_USD,HOUR,102621.77,0.053,07/01/2021 15:00:00,07/01/2021 17:00:00,07/01/2021 17:00:00,EXPIRED,LONG,38524.0,39813.0,40434.36,0.0,0.02,4.72,0.0,101.25,2,0.0,68.32
30/11/2019 02:00:00,16/06/2023 15:50:27,Gemini_BTCUSD_1h_17_12_17_to_10_03_23.csv,BTC_USD,HOUR,102690.09,0.265,30/11/2019 03:00:00,30/11/2019 05:00:00,30/11/2019 05:00:00,EXPIRED,LONG,7748.0,7772.0,8419.69,0.0,0.02,7.98,0.0,178.0,2,0.1,6.36
20/07/2019 17:00:00,16/06/2023 15:50:27,Gemini_BTCUSD_1h_17_12_17_to_10_03_23.csv,BTC_USD,HOUR,102696.45,0.188,20/07/2019 18:00:00,20/07/2019 20:00:00,20/07/2019 20:00:00,EXPIRED,LONG,10926.0,10941.0,11914.95,0.0,0.02,8.3,0.0,185.92,2,0.1,2.82
28/08/2018 23:00:00,16/06/2023 15:50:27,Gemini_BTCUSD_1h_17_12_17_to_10_03_23.csv,BTC_USD,HOUR,102699.27,0.29,29/08/2018 00:00:00,29/08/2018 02:00:00,29/08/2018 02:00:00,EXPIRED,LONG,7075.0,7025.0,7371.66,0.0,0.02,4.02,0.0,86.03,2,0.0,-14.5
15/02/2021 19:00:00,16/06/2023 15:50:27,Gemini_BTCUSD_1h_17_12_17_to_10_03_23.csv,BTC_USD,HOUR,102684.77,0.042,15/02/2021 20:00:00,15/02/2021 22:00:00,15/02/2021 22:00:00,EXPIRED,LONG,48673.0,48346.0,52447.23,0.0,0.02,7.2,0.0,158.52,2,0.1,-13.73
06/01/2021 12:00:00,16/06/2023 15:50:28,Gemini_BTCUSD_1h_17_12_17_to_10_03_23.csv,BTC_USD,HOUR,102671.04,0.059,06/01/2021 16:00:00,06/01/2021 15:00:00,06/01/2021 15:00:00,EXPIRED,LONG,35023.0,34672.0,37812.78,0.0,0.02,7.38,0.0,164.6,2,0.1,-20.71
23/06/2019 02:00:00,16/06/2023 15:50:28,Gemini_BTCUSD_1h_17_12_17_to_10_03_23.csv,BTC_USD,HOUR,102650.33,0.192,23/06/2019 04:00:00,23/06/2019 05:00:00,23/06/2019 05:00:00,EXPIRED,LONG,10690.0,10753.0,11575.25,0.0,0.02,7.65,0.0,169.97,2,0.1,12.1
20/05/2020 15:00:00,16/06/2023 15:50:28,Gemini_BTCUSD_1h_17_12_17_to_10_03_23.csv,BTC_USD,HOUR,102662.43,0.218,20/05/2020 17:00:00,20/05/2020 18:00:00,20/05/2020 18:00:00,EXPIRED,LONG,9404.0,9540.0,10009.2,0.0,0.02,6.05,0.0,131.93,2,0.1,29.65
06/06/2022 01:00:00,16/06/2023 15:50:28,Gemini_BTCUSD_1h_17_12_17_to_10_03_23.csv,BTC_USD,HOUR,102692.08,0.067,06/06/2022 04:00:00,06/06/2022 04:00:00,06/06/2022 04:00:00,EXPIRED,LONG,30805.0,31195.0,32383.57,0.0,0.02,4.87,0.0,105.76,2,0.1,26.13
23/07/2018 21:00:00,16/06/2023 15:50:28,Gemini_BTCUSD_1h_17_12_17_to_10_03_23.csv,BTC_USD,HOUR,102718.21,0.265,23/07/2018 22:00:00,24/07/2018 00:00:00,24/07/2018 00:00:00,EXPIRED,LONG,7753.0,7714.0,8374.69,0.0,0.02,7.42,0.0,164.75,2,0.1,-10.33
17/09/2021 03:00:00,16/06/2023 15:50:28,Gemini_BTCUSD_1h_17_12_17_to_10_03_23.csv,BTC_USD,HOUR,102707.88,0.043,17/09/2021 06:00:00,17/09/2021 06:00:00,17/09/2021 06:00:00,EXPIRED,LONG,47907.0,48082.0,49066.75,0.0,0.02,2.36,0.0,49.87,2,0.0,7.53
24/10/2020 12:00:00,16/06/2023 15:50:28,Gemini_BTCUSD_1h_17_12_17_to_10_03_23.csv,BTC_USD,HOUR,102715.41,0.158,24/10/2020 13:00:00,24/10/2020 15:00:00,24/10/2020 15:00:00,EXPIRED,LONG,12994.0,13006.0,14147.91,0.0,0.02,8.16,0.0,182.32,2,0.1,1.9
18/09/2018 05:00:00,16/06/2023 15:50:28,Gemini_BTCUSD_1h_17_12_17_to_10_03_23.csv,BTC_USD,HOUR,102717.31,0.328,18/09/2018 06:00:00,18/09/2018 08:00:00,18/09/2018 06:00:00,TAKE_PROFIT_HIT,LONG,6263.0,6264.08,6264.08,0.0,0.02,0.02,0.0,0.35,2,0.0,0.35
15/07/2018 22:00:00,16/06/2023 15:50:28,Gemini_BTCUSD_1h_17_12_17_to_10_03_23.csv,BTC_USD,HOUR,102717.66,0.323,16/07/2018 00:00:00,16/07/2018 01:00:00,16/07/2018 01:00:00,EXPIRED,LONG,6366.0,6345.0,6813.49,0.0,0.02,6.57,0.0,144.54,2,0.1,-6.78
13/04/2021 00:00:00,16/06/2023 15:50:28,Gemini_BTCUSD_1h_17_12_17_to_10_03_23.csv,BTC_USD,HOUR,102710.88,0.034,13/04/2021 03:00:00,13/04/2021 03:00:00,13/04/2021 03:00:00,EXPIRED,LONG,60438.0,60416.0,63446.72,0.0,0.02,4.74,0.0,102.3,2,0.0,-0.75
15/02/2023 22:00:00,16/06/2023 15:50:28,Gemini_BTCUSD_1h_17_12_17_to_10_03_23.csv,BTC_USD,HOUR,102710.13,0.085,16/02/2023 00:00:00,16/02/2023 01:00:00,16/02/2023 00:00:00,TAKE_PROFIT_HIT,LONG,24166.0,24725.29,24725.29,0.0,0.02,2.26,0.0,47.54,2,0.0,47.54
16/12/2020 16:00:00,16/06/2023 15:50:28,Gemini_BTCUSD_1h_17_12_17_to_10_03_23.csv,BTC_USD,HOUR,102757.67,0.098,16/12/2020 18:00:00,16/12/2020 19:00:00,16/12/2020 19:00:00,EXPIRED,LONG,20891.0,20768.0,22308.29,0.0,0.02,6.35,0.0,138.89,2,0.1,-12.05
02/08/2018 03:00:00,16/06/2023 15:50:28,Gemini_BTCUSD_1h_17_12_17_to_10_03_23.csv,BTC_USD,HOUR,102745.62,0.269,02/08/2018 05:00:00,02/08/2018 06:00:00,02/08/2018 06:00:00,EXPIRED,LONG,7645.0,7638.0,7922.37,0.0,0.02,3.5,0.0,74.61,2,0.0,-1.88
29/11/2018 08:00:00,16/06/2023 15:50:28,Gemini_BTCUSD_1h_17_12_17_to_10_03_23.csv,BTC_USD,HOUR,102743.74,0.49,29/11/2018 10:00:00,29/11/2018 11:00:00,29/11/2018 11:00:00,EXPIRED,LONG,4197.0,4350.0,4419.89,0.0,0.02,5.04,0.0,109.22,2,0.1,74.97
25/01/2018 03:00:00,16/06/2023 15:50:28,Gemini_BTCUSD_1h_17_12_17_to_10_03_23.csv,BTC_USD,HOUR,102818.71,0.177,25/01/2018 04:00:00,25/01/2018 06:00:00,25/01/2018 06:00:00,EXPIRED,LONG,11645.0,11456.0,12601.54,0.0,0.02,7.59,0.0,169.31,2,0.1,-33.45
19/07/2021 09:00:00,16/06/2023 15:50:28,Gemini_BTCUSD_1h_17_12_17_to_10_03_23.csv,BTC_USD,HOUR,102785.26,0.066,19/07/2021 13:00:00,19/07/2021 12:00:00,19/07/2021 12:00:00,EXPIRED,LONG,31378.0,30712.0,32597.45,0.0,0.02,3.74,0.0,80.48,2,0.0,-43.96
05/10/2019 19:00:00,16/06/2023 15:50:28,Gemini_BTCUSD_1h_17_12_17_to_10_03_23.csv,BTC_USD,HOUR,102741.3,0.254,05/10/2019 20:00:00,05/10/2019 22:00:00,05/10/2019 22:00:00,EXPIRED,LONG,8090.0,8150.0,8276.68,0.0,0.02,2.26,0.0,47.42,2,0.0,15.24
27/09/2020 15:00:00,16/06/2023 15:50:28,Gemini_BTCUSD_1h_17_12_17_to_10_03_23.csv,BTC_USD,HOUR,102756.54,0.191,27/09/2020 16:00:00,27/09/2020 18:00:00,27/09/2020 18:00:00,EXPIRED,LONG,10756.0,10719.0,11383.81,0.0,0.02,5.51,0.0,119.91,2,0.1,-7.07
04/12/2021 14:00:00,16/06/2023 15:50:28,Gemini_BTCUSD_1h_17_12_17_to_10_03_23.csv,BTC_USD,HOUR,102749.47,0.043,04/12/2021 16:00:00,04/12/2021 17:00:00,04/12/2021 17:00:00,EXPIRED,LONG,47907.0,48332.0,50946.36,0.0,0.02,5.97,0.0,130.69,2,0.1,18.27
08/03/2018 13:00:00,16/06/2023 15:50:28,Gemini_BTCUSD_1h_17_12_17_to_10_03_23.csv,BTC_USD,HOUR,102767.74,0.207,08/03/2018 16:00:00,08/03/2018 16:00:00,08/03/2018 16:00:00,EXPIRED,LONG,9917.0,9411.0,10156.45,0.0,0.02,2.36,0.0,49.57,2,0.0,-104.74
03/07/2022 00:00:00,16/06/2023 15:50:28,Gemini_BTCUSD_1h_17_12_17_to_10_03_23.csv,BTC_USD,HOUR,102663.0,0.107,03/07/2022 01:00:00,03/07/2022 03:00:00,03/07/2022 03:00:00,EXPIRED,LONG,19220.0,19247.0,19723.28,0.0,0.02,2.55,0.0,53.85,2,0.0,2.89
29/10/2019 08:00:00,16/06/2023 15:50:28,Gemini_BTCUSD_1h_17_12_17_to_10_03_23.csv,BTC_USD,HOUR,102665.89,0.218,29/10/2019 09:00:00,29/10/2019 11:00:00,29/10/2019 11:00:00,EXPIRED,LONG,9430.0,9437.0,9897.99,0.0,0.02,4.73,0.0,102.02,2,0.0,1.53
24/11/2021 16:00:00,16/06/2023 15:50:28,Gemini_BTCUSD_1h_17_12_17_to_10_03_23.csv,BTC_USD,HOUR,102667.42,0.036,24/11/2021 20:00:00,24/11/2021 19:00:00,24/11/2021 19:00:00,EXPIRED,LONG,56652.0,56869.0,59911.03,0.0,0.02,5.44,0.0,117.33,2,0.1,7.81
26/02/2023 01:00:00,16/06/2023 15:50:28,Gemini_BTCUSD_1h_17_12_17_to_10_03_23.csv,BTC_USD,HOUR,102675.23,0.089,26/02/2023 02:00:00,26/02/2023 04:00:00,26/02/2023 04:00:00,EXPIRED,LONG,23120.0,23188.0,24560.97,0.0,0.02,5.87,0.0,128.25,2,0.1,6.05
13/03/2022 15:00:00,16/06/2023 15:50:28,Gemini_BTCUSD_1h_17_12_17_to_10_03_23.csv,BTC_USD,HOUR,102681.28,0.053,13/03/2022 17:00:00,13/03/2022 18:00:00,13/03/2022 18:00:00,EXPIRED,LONG,38948.0,39003.0,39996.89,0.0,0.02,2.62,0.0,55.59,2,0.0,2.92
20/10/2019 09:00:00,16/06/2023 15:50:28,Gemini_BTCUSD_1h_17_12_17_to_10_03_23.csv,BTC_USD,HOUR,102684.2,0.258,20/10/2019 10:00:00,20/10/2019 12:00:00,20/10/2019 12:00:00,EXPIRED,LONG,7950.0,7963.0,8251.33,0.0,0.02,3.65,0.0,77.74,2,0.0,3.35
18/08/2021 19:00:00,16/06/2023 15:50:28,Gemini_BTCUSD_1h_17_12_17_to_10_03_23.csv,BTC_USD,HOUR,102687.55,0.046,18/08/2021 23:00:00,18/08/2021 22:00:00,18/08/2021 22:00:00,EXPIRED,LONG,44884.0,44899.0,46989.12,0.0,0.02,4.48,0.0,96.84,2,0.0,0.69
03/09/2022 03:00:00,16/06/2023 15:50:28,Gemini_BTCUSD_1h_17_12_17_to_10_03_23.csv,BTC_USD,HOUR,102688.24,0.103,03/09/2022 04:00:00,03/09/2022 06:00:00,03/09/2022 06:00:00,EXPIRED,LONG,19898.0,19894.0,20379.31,0.0,0.02,2.36,0.0,49.57,2,0.0,-0.41
15/08/2021 16:00:00,16/06/2023 15:50:28,Gemini_BTCUSD_1h_17_12_17_to_10_03_23.csv,BTC_USD,HOUR,102687.83,0.045,15/08/2021 17:00:00,15/08/2021 19:00:00,15/08/2021 19:00:00,EXPIRED,LONG,45912.0,46361.0,47683.48,0.0,0.02,3.72,0.0,79.72,2,0.0,20.2
12/12/2021 22:00:00,16/06/2023 15:50:28,Gemini_BTCUSD_1h_17_12_17_to_10_03_23.csv,BTC_USD,HOUR,102708.03,0.041,12/12/2021 23:00:00,13/12/2021 01:00:00,13/12/2021 01:00:00,EXPIRED,LONG,50315.0,48634.0,51693.79,0.0,0.02,2.67,0.0,56.53,2,0.0,-68.92
06/04/2021 00:00:00,16/06/2023 15:50:28,Gemini_BTCUSD_1h_17_12_17_to_10_03_23.csv,BTC_USD,HOUR,102639.11,0.035,06/04/2021 02:00:00,06/04/2021 03:00:00,06/04/2021 03:00:00,EXPIRED,LONG,59343.0,58638.0,64080.94,0.0,0.02,7.39,0.0,165.83,2,0.1,-24.67
29/12/2022 20:00:00,16/06/2023 15:50:28,Gemini_BTCUSD_1h_17_12_17_to_10_03_23.csv,BTC_USD,HOUR,102614.44,0.124,29/12/2022 21:00:00,29/12/2022 23:00:00,29/12/2022 23:00:00,EXPIRED,LONG,16596.0,16635.0,17254.03,0.0,0.02,3.81,0.0,81.6,2,0.0,4.84
06/11/2018 10:00:00,16/06/2023 15:50:28,Gemini_BTCUSD_1h_17_12_17_to_10_03_23.csv,BTC_USD,HOUR,102619.28,0.32,06/11/2018 12:00:00,06/11/2018 13:00:00,06/11/2018 13:00:00,EXPIRED,LONG,6407.0,6406.0,6972.55,0.0,0.02,8.11,0.0,180.98,2,0.1,-0.32
17/06/2020 07:00:00,16/06/2023 15:50:28,Gemini_BTCUSD_1h_17_12_17_to_10_03_23.csv,BTC_USD,HOUR,102618.96,0.216,17/06/2020 11:00:00,17/06/2020 10:00:00,17/06/2020 10:00:00,EXPIRED,LONG,9499.0,9479.0,9935.94,0.0,0.02,4.4,0.0,94.38,2,0.0,-4.32
30/11/2022 21:00:00,16/06/2023 15:50:28,Gemini_BTCUSD_1h_17_12_17_to_10_03_23.csv,BTC_USD,HOUR,102614.64,0.12,30/11/2022 22:00:00,01/12/2022 00:00:00,01/12/2022 00:00:00,EXPIRED,LONG,17091.0,17160.0,18151.31,0.0,0.02,5.84,0.0,127.24,2,0.1,8.28
27/03/2018 01:00:00,16/06/2023 15:50:28,Gemini_BTCUSD_1h_17_12_17_to_10_03_23.csv,BTC_USD,HOUR,102622.92,0.255,27/03/2018 02:00:00,27/03/2018 04:00:00,27/03/2018 04:00:00,EXPIRED,LONG,8038.0,7772.0,8537.24,0.0,0.02,5.85,0.0,127.31,2,0.1,-67.83
04/03/2020 09:00:00,16/06/2023 15:50:28,Gemini_BTCUSD_1h_17_12_17_to_10_03_23.csv,BTC_USD,HOUR,102555.09,0.234,04/03/2020 11:00:00,04/03/2020 12:00:00,04/03/2020 12:00:00,EXPIRED,LONG,8753.0,8727.0,9152.82,0.0,0.02,4.37,0.0,93.56,2,0.0,-6.08
21/12/2017 05:00:00,16/06/2023 15:50:28,Gemini_BTCUSD_1h_17_12_17_to_10_03_23.csv,BTC_USD,HOUR,102549.01,0.122,21/12/2017 08:00:00,21/12/2017 08:00:00,21/12/2017 06:00:00,TAKE_PROFIT_HIT,LONG,16750.0,17130.52,17130.52,0.0,0.02,2.22,0.0,46.42,2,0.0,46.42
14/04/2018 06:00:00,16/06/2023 15:50:28,Gemini_BTCUSD_1h_17_12_17_to_10_03_23.csv,BTC_USD,HOUR,102595.43,0.256,14/04/2018 08:00:00,14/04/2018 09:00:00,14/04/2018 09:00:00,EXPIRED,LONG,8016.0,8037.0,8346.35,0.0,0.02,3.96,0.0,84.57,2,0.0,5.38
04/11/2019 13:00:00,16/06/2023 15:50:28,Gemini_BTCUSD_1h_17_12_17_to_10_03_23.csv,BTC_USD,HOUR,102600.81,0.222,04/11/2019 15:00:00,04/11/2019 16:00:00,04/11/2019 16:00:00,EXPIRED,LONG,9252.0,9307.0,9577.79,0.0,0.02,3.4,0.0,72.33,2,0.0,12.21
18/05/2022 01:00:00,16/06/2023 15:50:28,Gemini_BTCUSD_1h_17_12_17_to_10_03_23.csv,BTC_USD,HOUR,102613.02,0.068,18/05/2022 02:00:00,18/05/2022 04:00:00,18/05/2022 04:00:00,EXPIRED,LONG,30081.0,29799.0,30781.66,0.0,0.02,2.28,0.0,47.64,2,0.0,-19.18
21/09/2022 04:00:00,16/06/2023 15:50:28,Gemini_BTCUSD_1h_17_12_17_to_10_03_23.csv,BTC_USD,HOUR,102593.84,0.108,21/09/2022 05:00:00,21/09/2022 07:00:00,21/09/2022 07:00:00,EXPIRED,LONG,18999.0,18946.0,19750.94,0.0,0.02,3.81,0.0,81.21,2,0.0,-5.72
05/04/2018 06:00:00,16/06/2023 15:50:28,Gemini_BTCUSD_1h_17_12_17_to_10_03_23.csv,BTC_USD,HOUR,102588.12,0.304,05/04/2018 07:00:00,05/04/2018 09:00:00,05/04/2018 09:00:00,EXPIRED,LONG,6757.0,6852.0,7190.84,0.0,0.02,6.03,0.0,131.89,2,0.1,28.88
09/09/2022 05:00:00,16/06/2023 15:50:28,Gemini_BTCUSD_1h_17_12_17_to_10_03_23.csv,BTC_USD,HOUR,102617.0,0.1,09/09/2022 06:00:00,09/09/2022 08:00:00,09/09/2022 08:00:00,TAKE_PROFIT_HIT,LONG,20522.0,20952.49,20952.49,0.0,0.02,2.05,0.0,43.05,2,0.0,43.05
06/10/2020 03:00:00,16/06/2023 15:50:28,Gemini_BTCUSD_1h_17_12_17_to_10_03_23.csv,BTC_USD,HOUR,102660.05,0.191,06/10/2020 05:00:00,06/10/2020 06:00:00,06/10/2020 06:00:00,EXPIRED,LONG,10773.0,10750.0,11088.48,0.0,0.02,2.85,0.0,60.26,2,0.0,-4.39
15/05/2018 12:00:00,16/06/2023 15:50:28,Gemini_BTCUSD_1h_17_12_17_to_10_03_23.csv,BTC_USD,HOUR,102655.66,0.234,15/05/2018 14:00:00,15/05/2018 15:00:00,15/05/2018 15:00:00,EXPIRED,LONG,8766.0,8531.0,9100.74,0.0,0.02,3.68,0.0,78.33,2,0.0,-54.99
09/09/2022 00:00:00,16/06/2023 15:50:28,Gemini_BTCUSD_1h_17_12_17_to_10_03_23.csv,BTC_USD,HOUR,102600.67,0.106,09/09/2022 02:00:00,09/09/2022 03:00:00,09/09/2022 03:00:00,TAKE_PROFIT_HIT,LONG,19369.0,19847.71,19847.71,0.0,0.02,2.41,0.0,50.74,2,0.0,50.74
22/07/2020 18:00:00,16/06/2023 15:50:28,Gemini_BTCUSD_1h_17_12_17_to_10_03_23.csv,BTC_USD,HOUR,102651.41,0.219,22/07/2020 19:00:00,22/07/2020 21:00:00,22/07/2020 21:00:00,EXPIRED,LONG,9373.0,9389.0,9530.67,0.0,0.02,1.65,0.0,34.53,2,0.0,3.5
25/01/2022 14:00:00,16/06/2023 15:50:28,Gemini_BTCUSD_1h_17_12_17_to_10_03_23.csv,BTC_USD,HOUR,102654.91,0.057,25/01/2022 15:00:00,25/01/2022 17:00:00,25/01/2022 17:00:00,EXPIRED,LONG,36298.0,37326.0,37794.23,0.0,0.02,3.96,0.0,85.29,2,0.0,58.6
03/10/2020 11:00:00,16/06/2023 15:50:28,Gemini_BTCUSD_1h_17_12_17_to_10_03_23.csv,BTC_USD,HOUR,102713.51,0.195,03/10/2020 14:00:00,03/10/2020 14:00:00,03/10/2020 14:00:00,EXPIRED,LONG,10548.0,10544.0,11023.68,0.0,0.02,4.32,0.0,92.76,2,0.0,-0.78
30/05/2021 00:00:00,16/06/2023 15:50:28,Gemini_BTCUSD_1h_17_12_17_to_10_03_23.csv,BTC_USD,HOUR,102712.73,0.061,30/05/2021 01:00:00,30/05/2021 03:00:00,30/05/2021 03:00:00,EXPIRED,LONG,33901.0,34805.0,36779.54,0.0,0.02,7.83,0.0,175.59,2,0.1,55.14
19/08/2021 12:00:00,16/06/2023 15:50:28,Gemini_BTCUSD_1h_17_12_17_to_10_03_23.csv,BTC_USD,HOUR,102767.87,0.046,19/08/2021 16:00:00,19/08/2021 15:00:00,19/08/2021 15:00:00,EXPIRED,LONG,44567.0,45812.0,47021.99,0.0,0.02,5.22,0.0,112.93,2,0.1,57.27
07/02/2022 23:00:00,16/06/2023 15:50:28,Gemini_BTCUSD_1h_17_12_17_to_10_03_23.csv,BTC_USD,HOUR,102825.14,0.047,08/02/2022 00:00:00,08/02/2022 02:00:00,08/02/2022 02:00:00,EXPIRED,LONG,43872.0,44002.0,44950.28,0.0,0.02,2.4,0.0,50.68,2,0.0,6.11
25/02/2022 00:00:00,16/06/2023 15:50:28,Gemini_BTCUSD_1h_17_12_17_to_10_03_23.csv,BTC_USD,HOUR,102831.25,0.054,25/02/2022 01:00:00,25/02/2022 03:00:00,25/02/2022 03:00:00,EXPIRED,LONG,38249.0,38962.0,39885.57,0.0,0.02,4.1,0.0,88.37,2,0.0,38.5
17/01/2020 19:00:00,16/06/2023 15:50:28,Gemini_BTCUSD_1h_17_12_17_to_10_03_23.csv,BTC_USD,HOUR,102869.75,0.232,17/01/2020 20:00:00,17/01/2020 22:00:00,17/01/2020 22:00:00,EXPIRED,LONG,8853.0,8924.0,9609.89,0.0,0.02,7.88,0.0,175.6,2,0.1,16.47
08/06/2020 11:00:00,16/06/2023 15:50:28,Gemini_BTCUSD_1h_17_12_17_to_10_03_23.csv,BTC_USD,HOUR,102886.22,0.211,08/06/2020 13:00:00,08/06/2020 14:00:00,08/06/2020 14:00:00,EXPIRED,LONG,9746.0,9681.0,10114.15,0.0,0.02,3.64,0.0,77.68,2,0.0,-13.71
28/08/2019 07:00:00,16/06/2023 15:50:28,Gemini_BTCUSD_1h_17_12_17_to_10_03_23.csv,BTC_USD,HOUR,102872.51,0.203,28/08/2019 08:00:00,28/08/2019 10:00:00,28/08/2019 10:00:00,EXPIRED,LONG,10152.0,10116.0,10394.48,0.0,0.02,2.33,0.0,49.22,2,0.0,-7.31
04/12/2019 10:00:00,16/06/2023 15:50:28,Gemini_BTCUSD_1h_17_12_17_to_10_03_23.csv,BTC_USD,HOUR,102865.2,0.285,04/12/2019 11:00:00,04/12/2019 13:00:00,04/12/2019 13:00:00,TAKE_PROFIT_HIT,LONG,7228.0,7670.87,7670.87,0.0,0.02,5.77,0.0,126.22,2,0.1,126.22
28/10/2022 13:00:00,16/06/2023 15:50:28,Gemini_BTCUSD_1h_17_12_17_to_10_03_23.csv,BTC_USD,HOUR,102991.42,0.101,28/10/2022 14:00:00,28/10/2022 16:00:00,28/10/2022 16:00:00,EXPIRED,LONG,20476.0,20713.0,20966.78,0.0,0.02,2.34,0.0,49.57,2,0.0,23.94
25/07/2021 09:00:00,16/06/2023 15:50:28,Gemini_BTCUSD_1h_17_12_17_to_10_03_23.csv,BTC_USD,HOUR,103015.36,0.06,25/07/2021 11:00:00,25/07/2021 12:00:00,25/07/2021 12:00:00,EXPIRED,LONG,34549.0,34318.0,37456.3,0.0,0.02,7.76,0.0,174.44,2,0.1,-13.86
31/12/2017 15:00:00,16/06/2023 15:50:28,Gemini_BTCUSD_1h_17_12_17_to_10_03_23.csv,BTC_USD,HOUR,103001.5,0.155,31/12/2017 16:00:00,31/12/2017 18:00:00,31/12/2017 16:00:00,TAKE_PROFIT_HIT,LONG,13290.0,14087.12,14087.12,0.0,0.02,5.66,0.0,123.55,2,0.1,123.55
22/05/2022 05:00:00,16/06/2023 15:50:28,Gemini_BTCUSD_1h_17_12_17_to_10_03_23.csv,BTC_USD,HOUR,103125.05,0.07,22/05/2022 06:00:00,22/05/2022 08:00:00,22/05/2022 08:00:00,EXPIRED,LONG,29337.0,29521.0,30020.51,0.0,0.02,2.28,0.0,47.85,2,0.0,12.88
27/04/2022 09:00:00,16/06/2023 15:50:28,Gemini_BTCUSD_1h_17_12_17_to_10_03_23.csv,BTC_USD,HOUR,103137.93,0.053,27/04/2022 11:00:00,27/04/2022 12:00:00,27/04/2022 12:00:00,EXPIRED,LONG,39067.0,38888.0,40469.07,0.0,0.02,3.46,0.0,74.31,2,0.0,-9.49
03/09/2021 18:00:00,16/06/2023 15:50:28,Gemini_BTCUSD_1h_17_12_17_to_10_03_23.csv,BTC_USD,HOUR,103128.44,0.041,03/09/2021 19:00:00,03/09/2021 21:00:00,03/09/2021 21:00:00,EXPIRED,LONG,50485.0,50263.0,52522.56,0.0,0.02,3.88,0.0,83.54,2,0.0,-9.1
12/08/2020 17:00:00,16/06/2023 15:50:28,Gemini_BTCUSD_1h_17_12_17_to_10_03_23.csv,BTC_USD,HOUR,103119.34,0.179,12/08/2020 18:00:00,12/08/2020 20:00:00,12/08/2020 20:00:00,EXPIRED,LONG,11547.0,11582.0,11824.08,0.0,0.02,2.34,0.0,49.6,2,0.0,6.27
07/07/2021 13:00:00,16/06/2023 15:50:28,Gemini_BTCUSD_1h_17_12_17_to_10_03_23.csv,BTC_USD,HOUR,103125.61,0.059,07/07/2021 16:00:00,07/07/2021 16:00:00,07/07/2021 16:00:00,EXPIRED,LONG,34835.0,34580.0,37312.11,0.0,0.02,6.64,0.0,146.15,2,0.1,-15.04
28/12/2019 23:00:00,16/06/2023 15:50:28,Gemini_BTCUSD_1h_17_12_17_to_10_03_23.csv,BTC_USD,HOUR,103110.57,0.282,29/12/2019 00:00:00,29/12/2019 02:00:00,29/12/2019 02:00:00,EXPIRED,LONG,7301.0,7295.0,7502.26,0.0,0.02,2.68,0.0,56.76,2,0.0,-1.69
06/02/2023 21:00:00,16/06/2023 15:50:28,Gemini_BTCUSD_1h_17_12_17_to_10_03_23.csv,BTC_USD,HOUR,103108.88,0.09,07/02/2023 00:00:00,07/02/2023 00:00:00,07/02/2023 00:00:00,EXPIRED,LONG,22923.0,22793.0,23430.83,0.0,0.02,2.17,0.0,45.7,2,0.0,-11.7
24/09/2018 20:00:00,16/06/2023 15:50:28,Gemini_BTCUSD_1h_17_12_17_to_10_03_23.csv,BTC_USD,HOUR,103097.18,0.311,24/09/2018 21:00:00,24/09/2018 23:00:00,24/09/2018 23:00:00,EXPIRED,LONG,6623.0,6578.0,6902.86,0.0,0.02,4.05,0.0,87.04,2,0.0,-13.99
22/07/2021 11:00:00,16/06/2023 15:50:28,Gemini_BTCUSD_1h_17_12_17_to_10_03_23.csv,BTC_USD,HOUR,103083.19,0.065,22/07/2021 12:00:00,22/07/2021 14:00:00,22/07/2021 14:00:00,EXPIRED,LONG,31927.0,32294.0,33560.43,0.0,0.02,4.87,0.0,106.17,2,0.1,23.86
13/03/2021 22:00:00,16/06/2023 15:50:28,Gemini_BTCUSD_1h_17_12_17_to_10_03_23.csv,BTC_USD,HOUR,103107.05,0.034,14/03/2021 00:00:00,14/03/2021 01:00:00,14/03/2021 01:00:00,EXPIRED,LONG,61077.0,61087.0,65363.49,0.0,0.02,6.56,0.0,145.74,2,0.1,0.34
20/02/2018 20:00:00,16/06/2023 15:50:28,Gemini_BTCUSD_1h_17_12_17_to_10_03_23.csv,BTC_USD,HOUR,103107.39,0.176,20/02/2018 22:00:00,20/02/2018 23:00:00,20/02/2018 23:00:00,EXPIRED,LONG,11750.0,11206.0,12033.61,0.0,0.02,2.36,0.0,49.92,2,0.0,-95.74
18/02/2021 17:00:00,16/06/2023 15:50:28,Gemini_BTCUSD_1h_17_12_17_to_10_03_23.csv,BTC_USD,HOUR,103011.65,0.04,18/02/2021 18:00:00,18/02/2021 20:00:00,18/02/2021 20:00:00,EXPIRED,LONG,51850.0,52152.0,54089.03,0.0,0.02,4.14,0.0,89.56,2,0.0,12.08
11/07/2019 00:00:00,16/06/2023 15:50:28,Gemini_BTCUSD_1h_17_12_17_to_10_03_23.csv,BTC_USD,HOUR,103023.73,0.173,11/07/2019 01:00:00,11/07/2019 03:00:00,11/07/2019 03:00:00,EXPIRED,LONG,11923.0,11701.0,12438.22,0.0,0.02,4.14,0.0,89.13,2,0.0,-38.41
20/08/2021 03:00:00,16/06/2023 15:50:28,Gemini_BTCUSD_1h_17_12_17_to_10_03_23.csv,BTC_USD,HOUR,102985.32,0.044,20/08/2021 04:00:00,20/08/2021 06:00:00,20/08/2021 06:00:00,EXPIRED,LONG,47042.0,47160.0,50729.27,0.0,0.02,7.27,0.0,162.24,2,0.1,5.19
10/11/2021 12:00:00,16/06/2023 15:50:28,Gemini_BTCUSD_1h_17_12_17_to_10_03_23.csv,BTC_USD,HOUR,102990.51,0.031,10/11/2021 13:00:00,10/11/2021 15:00:00,10/11/2021 15:00:00,EXPIRED,LONG,66390.0,68361.0,72621.45,0.0,0.02,8.58,0.0,193.17,2,0.1,61.1
20/08/2020 15:00:00,16/06/2023 15:50:28,Gemini_BTCUSD_1h_17_12_17_to_10_03_23.csv,BTC_USD,HOUR,103051.61,0.174,20/08/2020 16:00:00,20/08/2020 18:00:00,20/08/2020 18:00:00,EXPIRED,LONG,11869.0,11878.0,12643.31,0.0,0.02,6.12,0.0,134.73,2,0.1,1.57
01/11/2018 13:00:00,16/06/2023 15:50:28,Gemini_BTCUSD_1h_17_12_17_to_10_03_23.csv,BTC_USD,HOUR,103053.18,0.327,01/11/2018 14:00:00,01/11/2018 16:00:00,01/11/2018 16:00:00,EXPIRED,LONG,6298.0,6305.0,6446.14,0.0,0.02,2.3,0.0,48.44,2,0.0,2.29
16/05/2021 04:00:00,16/06/2023 15:50:28,Gemini_BTCUSD_1h_17_12_17_to_10_03_23.csv,BTC_USD,HOUR,103055.47,0.043,16/05/2021 05:00:00,16/05/2021 07:00:00,16/05/2021 07:00:00,EXPIRED,LONG,48129.0,49355.0,51687.31,0.0,0.02,6.88,0.0,153.01,2,0.1,52.72
04/10/2018 12:00:00,16/06/2023 15:50:28,Gemini_BTCUSD_1h_17_12_17_to_10_03_23.csv,BTC_USD,HOUR,103108.19,0.316,04/10/2018 13:00:00,04/10/2018 15:00:00,04/10/2018 15:00:00,EXPIRED,LONG,6531.0,6540.0,6910.74,0.0,0.02,5.49,0.0,120.0,2,0.1,2.84
02/05/2020 11:00:00,16/06/2023 15:50:28,Gemini_BTCUSD_1h_17_12_17_to_10_03_23.csv,BTC_USD,HOUR,103111.03,0.233,02/05/2020 15:00:00,02/05/2020 14:00:00,02/05/2020 14:00:00,EXPIRED,LONG,8848.0,8926.0,9545.43,0.0,0.02,7.31,0.0,162.5,2,0.1,18.17
15/01/2021 10:00:00,16/06/2023 15:50:28,Gemini_BTCUSD_1h_17_12_17_to_10_03_23.csv,BTC_USD,HOUR,103129.2,0.054,15/01/2021 14:00:00,15/01/2021 13:00:00,15/01/2021 13:00:00,EXPIRED,LONG,38428.0,37645.0,40908.5,0.0,0.02,6.06,0.0,133.95,2,0.1,-42.28
03/02/2018 10:00:00,16/06/2023 15:50:28,Gemini_BTCUSD_1h_17_12_17_to_10_03_23.csv,BTC_USD,HOUR,103086.92,0.236,03/02/2018 11:00:00,03/02/2018 13:00:00,03/02/2018 13:00:00,TAKE_PROFIT_HIT,LONG,8747.0,9145.36,9145.36,0.0,0.02,4.36,0.0,94.01,2,0.0,94.01
06/06/2020 21:00:00,16/06/2023 15:50:28,Gemini_BTCUSD_1h_17_12_17_to_10_03_23.csv,BTC_USD,HOUR,103180.93,0.213,06/06/2020 22:00:00,07/06/2020 00:00:00,07/06/2020 00:00:00,EXPIRED,LONG,9700.0,9671.0,10421.04,0.0,0.02,6.92,0.0,153.58,2,0.1,-6.18
29/04/2020 11:00:00,16/06/2023 15:50:28,Gemini_BTCUSD_1h_17_12_17_to_10_03_23.csv,BTC_USD,HOUR,103174.75,0.253,29/04/2020 12:00:00,29/04/2020 14:00:00,29/04/2020 13:00:00,TAKE_PROFIT_HIT,LONG,8141.0,8324.74,8324.74,0.0,0.02,2.21,0.0,46.49,2,0.0,46.49
29/10/2020 20:00:00,16/06/2023 15:50:28,Gemini_BTCUSD_1h_17_12_17_to_10_03_23.csv,BTC_USD,HOUR,103221.24,0.153,29/10/2020 23:00:00,29/10/2020 23:00:00,29/10/2020 23:00:00,EXPIRED,LONG,13499.0,13474.0,13847.57,0.0,0.02,2.52,0.0,53.33,2,0.0,-3.82
05/01/2022 05:00:00,16/06/2023 15:50:28,Gemini_BTCUSD_1h_17_12_17_to_10_03_23.csv,BTC_USD,HOUR,103217.42,0.045,05/01/2022 07:00:00,05/01/2022 08:00:00,05/01/2022 08:00:00,EXPIRED,LONG,46327.0,46655.0,50366.54,0.0,0.02,8.02,0.0,181.78,2,0.1,14.76
23/08/2018 16:00:00,16/06/2023 15:50:28,Gemini_BTCUSD_1h_17_12_17_to_10_03_23.csv,BTC_USD,HOUR,103232.18,0.32,23/08/2018 18:00:00,23/08/2018 19:00:00,23/08/2018 19:00:00,EXPIRED,LONG,6452.0,6418.0,6814.43,0.0,0.02,5.32,0.0,115.98,2,0.1,-10.88
26/01/2021 18:00:00,16/06/2023 15:50:28,Gemini_BTCUSD_1h_17_12_17_to_10_03_23.csv,BTC_USD,HOUR,103221.3,0.064,26/01/2021 21:00:00,26/01/2021 21:00:00,26/01/2021 21:00:00,EXPIRED,LONG,32256.0,32041.0,33023.11,0.0,0.02,2.32,0.0,49.1,2,0.0,-13.76
27/04/2021 23:00:00,16/06/2023 15:50:28,Gemini_BTCUSD_1h_17_12_17_to_10_03_23.csv,BTC_USD,HOUR,103207.54,0.037,28/04/2021 01:00:00,28/04/2021 02:00:00,28/04/2021 02:00:00,EXPIRED,LONG,55084.0,55282.0,58869.09,0.0,0.02,6.43,0.0,140.05,2,0.1,7.33
18/08/2021 14:00:00,16/06/2023 15:50:28,Gemini_BTCUSD_1h_17_12_17_to_10_03_23.csv,BTC_USD,HOUR,103214.87,0.045,18/08/2021 18:00:00,18/08/2021 17:00:00,18/08/2021 17:00:00,EXPIRED,LONG,45434.0,45840.0,48792.38,0.0,0.02,6.88,0.0,151.13,2,0.1,18.27
11/11/2020 11:00:00,16/06/2023 15:50:28,Gemini_BTCUSD_1h_17_12_17_to_10_03_23.csv,BTC_USD,HOUR,103233.14,0.132,11/11/2020 12:00:00,11/11/2020 14:00:00,11/11/2020 14:00:00,EXPIRED,LONG,15599.0,15666.0,16539.13,0.0,0.02,5.68,0.0,124.1,2,0.1,8.84
18/11/2018 03:00:00,16/06/2023 15:50:28,Gemini_BTCUSD_1h_17_12_17_to_10_03_23.csv,BTC_USD,HOUR,103241.98,0.372,18/11/2018 04:00:00,18/11/2018 06:00:00,18/11/2018 06:00:00,EXPIRED,LONG,5550.0,5542.0,5782.59,0.0,0.02,4.02,0.0,86.52,2,0.0,-2.98
26/07/2021 17:00:00,16/06/2023 15:50:28,Gemini_BTCUSD_1h_17_12_17_to_10_03_23.csv,BTC_USD,HOUR,103239.0,0.053,26/07/2021 19:00:00,26/07/2021 20:00:00,26/07/2021 20:00:00,EXPIRED,LONG,39242.0,37751.0,40744.17,0.0,0.02,3.69,0.0,79.62,2,0.0,-79.02
29/08/2020 08:00:00,16/06/2023 15:50:28,Gemini_BTCUSD_1h_17_12_17_to_10_03_23.csv,BTC_USD,HOUR,103159.98,0.179,29/08/2020 09:00:00,29/08/2020 11:00:00,29/08/2020 11:00:00,EXPIRED,LONG,11540.0,11458.0,12608.9,0.0,0.02,8.48,0.0,191.33,2,0.1,-14.68
11/07/2021 19:00:00,16/06/2023 15:50:28,Gemini_BTCUSD_1h_17_12_17_to_10_03_23.csv,BTC_USD,HOUR,103145.3,0.061,11/07/2021 21:00:00,11/07/2021 22:00:00,11/07/2021 22:00:00,EXPIRED,LONG,33907.0,34396.0,34752.51,0.0,0.02,2.43,0.0,51.58,2,0.0,29.83
01/04/2019 06:00:00,16/06/2023 15:50:28,Gemini_BTCUSD_1h_17_12_17_to_10_03_23.csv,BTC_USD,HOUR,103175.13,0.5,01/04/2019 08:00:00,01/04/2019 09:00:00,01/04/2019 09:00:00,EXPIRED,LONG,4125.0,4122.0,4216.95,0.0,0.02,2.18,0.0,45.97,2,0.0,-1.5
03/11/2021 09:00:00,16/06/2023 15:50:28,Gemini_BTCUSD_1h_17_12_17_to_10_03_23.csv,BTC_USD,HOUR,103173.63,0.033,03/11/2021 10:00:00,03/11/2021 12:00:00,03/11/2021 12:00:00,EXPIRED,LONG,63376.0,62531.0,67056.68,0.0,0.02,5.49,0.0,121.46,2,0.1,-27.88
25/02/2018 02:00:00,16/06/2023 15:50:28,Gemini_BTCUSD_1h_17_12_17_to_10_03_23.csv,BTC_USD,HOUR,103145.75,0.215,25/02/2018 03:00:00,25/02/2018 05:00:00,25/02/2018 05:00:00,EXPIRED,LONG,9612.0,9735.0,10194.16,0.0,0.02,5.71,0.0,125.16,2,0.1,26.45
27/08/2018 17:00:00,16/06/2023 15:50:28,Gemini_BTCUSD_1h_17_12_17_to_10_03_23.csv,BTC_USD,HOUR,103172.2,0.306,27/08/2018 18:00:00,27/08/2018 20:00:00,27/08/2018 20:00:00,EXPIRED,LONG,6735.0,6722.0,7250.31,0.0,0.02,7.11,0.0,157.68,2,0.1,-3.98
12/08/2020 11:00:00,16/06/2023 15:50:28,Gemini_BTCUSD_1h_17_12_17_to_10_03_23.csv,BTC_USD,HOUR,103168.22,0.18,12/08/2020 15:00:00,12/08/2020 14:00:00,12/08/2020 14:00:00,EXPIRED,LONG,11472.0,11601.0,11738.32,0.0,0.02,2.27,0.0,47.94,2,0.0,23.22
23/05/2020 04:00:00,16/06/2023 15:50:28,Gemini_BTCUSD_1h_17_12_17_to_10_03_23.csv,BTC_USD,HOUR,103191.44,0.223,23/05/2020 05:00:00,23/05/2020 07:00:00,23/05/2020 07:00:00,EXPIRED,LONG,9260.0,9253.0,9612.87,0.0,0.02,3.67,0.0,78.69,2,0.0,-1.56
31/08/2022 00:00:00,16/06/2023 15:50:28,Gemini_BTCUSD_1h_17_12_17_to_10_03_23.csv,BTC_USD,HOUR,103189.88,0.103,31/08/2022 03:00:00,31/08/2022 03:00:00,31/08/2022 03:00:00,EXPIRED,LONG,19950.0,20414.0,20457.87,0.0,0.02,2.48,0.0,52.31,2,0.0,47.79
27/05/2020 14:00:00,16/06/2023 15:50:28,Gemini_BTCUSD_1h_17_12_17_to_10_03_23.csv,BTC_USD,HOUR,103237.67,0.226,27/05/2020 15:00:00,27/05/2020 17:00:00,27/05/2020 17:00:00,EXPIRED,LONG,9154.0,9193.0,9384.31,0.0,0.02,2.45,0.0,52.05,2,0.0,8.81
26/09/2020 19:00:00,16/06/2023 15:50:28,Gemini_BTCUSD_1h_17_12_17_to_10_03_23.csv,BTC_USD,HOUR,103246.48,0.192,26/09/2020 21:00:00,26/09/2020 22:00:00,26/09/2020 22:00:00,EXPIRED,LONG,10727.0,10738.0,11373.32,0.0,0.02,5.68,0.0,124.09,2,0.1,2.11
29/07/2019 19:00:00,16/06/2023 15:50:28,Gemini_BTCUSD_1h_17_12_17_to_10_03_23.csv,BTC_USD,HOUR,103248.59,0.218,29/07/2019 20:00:00,29/07/2019 22:00:00,29/07/2019 22:00:00,EXPIRED,LONG,9472.0,9509.0,10164.48,0.0,0.02,6.81,0.0,150.96,2,0.1,8.07
24/03/2022 03:00:00,16/06/2023 15:50:28,Gemini_BTCUSD_1h_17_12_17_to_10_03_23.csv,BTC_USD,HOUR,103256.66,0.048,24/03/2022 07:00:00,24/03/2022 06:00:00,24/03/2022 06:00:00,EXPIRED,LONG,42755.0,43234.0,44338.12,0.0,0.02,3.57,0.0,75.99,2,0.0,22.99
06/01/2020 04:00:00,16/06/2023 15:50:28,Gemini_BTCUSD_1h_17_12_17_to_10_03_23.csv,BTC_USD,HOUR,103279.65,0.274,06/01/2020 07:00:00,06/01/2020 07:00:00,06/01/2020 07:00:00,EXPIRED,LONG,7530.0,7506.0,7697.86,0.0,0.02,2.18,0.0,45.99,2,0.0,-6.58
17/10/2021 00:00:00,16/06/2023 15:50:28,Gemini_BTCUSD_1h_17_12_17_to_10_03_23.csv,BTC_USD,HOUR,103273.07,0.034,17/10/2021 03:00:00,17/10/2021 03:00:00,17/10/2021 03:00:00,EXPIRED,LONG,60944.0,61144.0,62345.76,0.0,0.02,2.25,0.0,47.66,2,0.0,6.8
01/09/2021 08:00:00,16/06/2023 15:50:28,Gemini_BTCUSD_1h_17_12_17_to_10_03_23.csv,BTC_USD,HOUR,103279.87,0.044,01/09/2021 12:00:00,01/09/2021 11:00:00,01/09/2021 11:00:00,EXPIRED,LONG,47357.0,47732.0,48393.69,0.0,0.02,2.14,0.0,45.61,2,0.0,16.5
06/01/2023 18:00:00,16/06/2023 15:50:28,Gemini_BTCUSD_1h_17_12_17_to_10_03_23.csv,BTC_USD,HOUR,103296.37,0.123,06/01/2023 20:00:00,06/01/2023 21:00:00,06/01/2023 21:00:00,EXPIRED,LONG,16844.0,16935.0,17195.0,0.0,0.02,2.04,0.0,43.17,2,0.0,11.19
02/06/2021 09:00:00,16/06/2023 15:50:28,Gemini_BTCUSD_1h_17_12_17_to_10_03_23.csv,BTC_USD,HOUR,103307.56,0.055,02/06/2021 11:00:00,02/06/2021 12:00:00,02/06/2021 12:00:00,EXPIRED,LONG,37272.0,37295.0,39135.03,0.0,0.02,4.76,0.0,102.47,2,0.0,1.26
22/04/2019 19:00:00,16/06/2023 15:50:28,Gemini_BTCUSD_1h_17_12_17_to_10_03_23.csv,BTC_USD,HOUR,103308.82,0.384,22/04/2019 20:00:00,22/04/2019 22:00:00,22/04/2019 22:00:00,EXPIRED,LONG,5386.0,5403.0,5578.23,0.0,0.02,3.45,0.0,73.82,2,0.0,6.53
21/03/2021 16:00:00,16/06/2023 15:50:28,Gemini_BTCUSD_1h_17_12_17_to_10_03_23.csv,BTC_USD,HOUR,103315.35,0.036,21/03/2021 17:00:00,21/03/2021 19:00:00,21/03/2021 19:00:00,EXPIRED,LONG,57303.0,57607.0,59582.31,0.0,0.02,3.83,0.0,82.06,2,0.0,10.94
14/05/2022 04:00:00,16/06/2023 15:50:28,Gemini_BTCUSD_1h_17_12_17_to_10_03_23.csv,BTC_USD,HOUR,103326.29,0.07,14/05/2022 05:00:00,14/05/2022 07:00:00,14/05/2022 07:00:00,EXPIRED,LONG,29327.0,29382.0,30575.01,0.0,0.02,4.08,0.0,87.36,2,0.0,3.85
27/03/2022 15:00:00,16/06/2023 15:50:28,Gemini_BTCUSD_1h_17_12_17_to_10_03_23.csv,BTC_USD,HOUR,103330.14,0.046,27/03/2022 18:00:00,27/03/2022 18:00:00,27/03/2022 18:00:00,EXPIRED,LONG,44889.0,44877.0,46587.34,0.0,0.02,3.65,0.0,78.12,2,0.0,-0.55
13/06/2020 15:00:00,16/06/2023 15:50:28,Gemini_BTCUSD_1h_17_12_17_to_10_03_23.csv,BTC_USD,HOUR,103329.59,0.219,13/06/2020 16:00:00,13/06/2020 18:00:00,13/06/2020 18:00:00,EXPIRED,LONG,9435.0,9445.0,10237.26,0.0,0.02,7.84,0.0,175.69,2,0.1,2.19
10/03/2020 10:00:00,16/06/2023 15:50:28,Gemini_BTCUSD_1h_17_12_17_to_10_03_23.csv,BTC_USD,HOUR,103331.78,0.257,10/03/2020 14:00:00,10/03/2020 13:00:00,10/03/2020 13:00:00,EXPIRED,LONG,8042.0,8062.0,8226.84,0.0,0.02,2.25,0.0,47.5,2,0.0,5.14
07/07/2021 16:00:00,16/06/2023 15:50:28,Gemini_BTCUSD_1h_17_12_17_to_10_03_23.csv,BTC_USD,HOUR,103336.92,0.06,07/07/2021 17:00:00,07/07/2021 19:00:00,07/07/2021 19:00:00,EXPIRED,LONG,34580.0,34641.0,36060.91,0.0,0.02,4.11,0.0,88.85,2,0.0,3.66
20/03/2018 17:00:00,16/06/2023 15:50:28,Gemini_BTCUSD_1h_17_12_17_to_10_03_23.csv,BTC_USD,HOUR,103340.58,0.233,20/03/2018 18:00:00,20/03/2018 20:00:00,20/03/2018 20:00:00,TAKE_PROFIT_HIT,LONG,8868.0,8999.82,8999.82,0.0,0.02,1.46,0.0,30.71,2,0.0,30.71
07/09/2022 17:00:00,16/06/2023 15:50:28,Gemini_BTCUSD_1h_17_12_17_to_10_03_23.csv,BTC_USD,HOUR,103371.29,0.109,07/09/2022 18:00:00,07/09/2022 20:00:00,07/09/2022 20:00:00,EXPIRED,LONG,18998.0,19386.0,19980.0,0.0,0.02,4.91,0.0,107.04,2,0.1,42.29
09/06/2022 20:00:00,16/06/2023 15:50:28,Gemini_BTCUSD_1h_17_12_17_to_10_03_23.csv,BTC_USD,HOUR,103413.58,0.069,09/06/2022 22:00:00,09/06/2022 23:00:00,09/06/2022 23:00:00,EXPIRED,LONG,30160.0,30079.0,30701.73,0.0,0.02,1.76,0.0,37.38,2,0.0,-5.59
04/04/2022 14:00:00,16/06/2023 15:50:28,Gemini_BTCUSD_1h_17_12_17_to_10_03_23.csv,BTC_USD,HOUR,103407.99,0.045,04/04/2022 15:00:00,04/04/2022 17:00:00,04/04/2022 17:00:00,EXPIRED,LONG,45917.0,45390.0,49610.44,0.0,0.02,7.44,0.0,166.2,2,0.1,-23.71
24/11/2018 01:00:00,16/06/2023 15:50:28,Gemini_BTCUSD_1h_17_12_17_to_10_03_23.csv,BTC_USD,HOUR,103384.28,0.476,24/11/2018 02:00:00,24/11/2018 04:00:00,24/11/2018 04:00:00,EXPIRED,LONG,4341.0,4304.0,4684.13,0.0,0.02,7.33,0.0,163.33,2,0.1,-17.61
20/03/2019 21:00:00,16/06/2023 15:50:28,Gemini_BTCUSD_1h_17_12_17_to_10_03_23.csv,BTC_USD,HOUR,103366.67,0.516,20/03/2019 23:00:00,21/03/2019 00:00:00,21/03/2019 00:00:00,EXPIRED,LONG,4010.0,4039.0,4285.66,0.0,0.02,6.43,0.0,142.24,2,0.1,14.96
25/01/2018 19:00:00,16/06/2023 15:50:28,Gemini_BTCUSD_1h_17_12_17_to_10_03_23.csv,BTC_USD,HOUR,103381.63,0.184,25/01/2018 21:00:00,25/01/2018 22:00:00,25/01/2018 22:00:00,EXPIRED,LONG,11233.0,11165.0,11519.57,0.0,0.02,2.49,0.0,52.73,2,0.0,-12.51
29/03/2019 10:00:00,16/06/2023 15:50:28,Gemini_BTCUSD_1h_17_12_17_to_10_03_23.csv,BTC_USD,HOUR,103369.12,0.507,29/03/2019 11:00:00,29/03/2019 13:00:00,29/03/2019 13:00:00,EXPIRED,LONG,4078.0,4081.0,4230.04,0.0,0.02,3.59,0.0,77.08,2,0.0,1.52
04/01/2020 21:00:00,16/06/2023 15:50:28,Gemini_BTCUSD_1h_17_12_17_to_10_03_23.csv,BTC_USD,HOUR,103370.64,0.281,05/01/2020 01:00:00,05/01/2020 00:00:00,05/01/2020 00:00:00,EXPIRED,LONG,7348.0,7370.0,7566.57,0.0,0.02,2.89,0.0,61.42,2,0.0,6.18
09/03/2021 13:00:00,16/06/2023 15:50:28,Gemini_BTCUSD_1h_17_12_17_to_10_03_23.csv,BTC_USD,HOUR,103376.82,0.038,09/03/2021 15:00:00,09/03/2021 16:00:00,09/03/2021 16:00:00,EXPIRED,LONG,54825.0,54122.0,56818.15,0.0,0.02,3.51,0.0,75.74,2,0.0,-26.71
28/01/2018 01:00:00,16/06/2023 15:50:28,Gemini_BTCUSD_1h_17_12_17_to_10_03_23.csv,BTC_USD,HOUR,103350.11,0.181,28/01/2018 04:00:00,28/01/2018 04:00:00,28/01/2018 04:00:00,EXPIRED,LONG,11395.0,11592.0,11688.37,0.0,0.02,2.51,0.0,53.1,2,0.0,35.66
01/11/2022 09:00:00,16/06/2023 15:50:28,Gemini_BTCUSD_1h_17_12_17_to_10_03_23.csv,BTC_USD,HOUR,103385.77,0.1,01/11/2022 10:00:00,01/11/2022 12:00:00,01/11/2022 12:00:00,EXPIRED,LONG,20600.0,20542.0,22219.92,0.0,0.02,7.29,0.0,161.99,2,0.1,-5.8
17/08/2018 18:00:00,16/06/2023 15:50:28,Gemini_BTCUSD_1h_17_12_17_to_10_03_23.csv,BTC_USD,HOUR,103379.97,0.317,17/08/2018 19:00:00,17/08/2018 21:00:00,17/08/2018 21:00:00,EXPIRED,LONG,6520.0,6521.0,7066.8,0.0,0.02,7.74,0.0,173.34,2,0.1,0.32
12/03/2018 11:00:00,16/06/2023 15:50:28,Gemini_BTCUSD_1h_17_12_17_to_10_03_23.csv,BTC_USD,HOUR,103380.29,0.21,12/03/2018 13:00:00,12/03/2018 14:00:00,12/03/2018 14:00:00,EXPIRED,LONG,9839.0,9239.0,10319.0,0.0,0.02,4.65,0.0,100.8,2,0.0,-126.0
22/05/2020 23:00:00,16/06/2023 15:50:28,Gemini_BTCUSD_1h_17_12_17_to_10_03_23.csv,BTC_USD,HOUR,103254.29,0.225,23/05/2020 00:00:00,23/05/2020 02:00:00,23/05/2020 02:00:00,EXPIRED,LONG,9165.0,9279.0,9515.74,0.0,0.02,3.69,0.0,78.92,2,0.0,25.65
04/03/2020 10:00:00,16/06/2023 15:50:28,Gemini_BTCUSD_1h_17_12_17_to_10_03_23.csv,BTC_USD,HOUR,103279.94,0.237,04/03/2020 13:00:00,04/03/2020 13:00:00,04/03/2020 11:00:00,TAKE_PROFIT_HIT,LONG,8729.0,8735.38,8735.38,0.0,0.02,0.07,0.0,1.51,2,0.0,1.51
17/07/2018 11:00:00,16/06/2023 15:50:28,Gemini_BTCUSD_1h_17_12_17_to_10_03_23.csv,BTC_USD,HOUR,103281.45,0.31,17/07/2018 12:00:00,17/07/2018 14:00:00,17/07/2018 14:00:00,EXPIRED,LONG,6662.0,6708.0,6850.22,0.0,0.02,2.75,0.0,58.35,2,0.0,14.26
09/10/2021 09:00:00,16/06/2023 15:50:28,Gemini_BTCUSD_1h_17_12_17_to_10_03_23.csv,BTC_USD,HOUR,103295.71,0.038,09/10/2021 10:00:00,09/10/2021 12:00:00,09/10/2021 12:00:00,EXPIRED,LONG,54905.0,54994.0,57523.64,0.0,0.02,4.55,0.0,99.51,2,0.0,3.38
07/03/2018 05:00:00,16/06/2023 15:50:28,Gemini_BTCUSD_1h_17_12_17_to_10_03_23.csv,BTC_USD,HOUR,103299.09,0.194,07/03/2018 09:00:00,07/03/2018 08:00:00,07/03/2018 08:00:00,EXPIRED,LONG,10640.0,10552.0,10905.18,0.0,0.02,2.43,0.0,51.44,2,0.0,-17.07
24/08/2020 05:00:00,16/06/2023 15:50:28,Gemini_BTCUSD_1h_17_12_17_to_10_03_23.csv,BTC_USD,HOUR,103282.02,0.177,24/08/2020 07:00:00,24/08/2020 08:00:00,24/08/2020 08:00:00,EXPIRED,LONG,11661.0,11792.0,12450.68,0.0,0.02,6.34,0.0,139.77,2,0.1,23.19
20/01/2021 19:00:00,16/06/2023 15:50:28,Gemini_BTCUSD_1h_17_12_17_to_10_03_23.csv,BTC_USD,HOUR,103305.21,0.059,20/01/2021 20:00:00,20/01/2021 22:00:00,20/01/2021 22:00:00,EXPIRED,LONG,35207.0,34999.0,37203.33,0.0,0.02,5.37,0.0,117.78,2,0.1,-12.27
17/02/2020 17:00:00,16/06/2023 15:50:28,Gemini_BTCUSD_1h_17_12_17_to_10_03_23.csv,BTC_USD,HOUR,103292.94,0.214,17/02/2020 19:00:00,17/02/2020 20:00:00,17/02/2020 20:00:00,EXPIRED,LONG,9649.0,9627.0,10333.73,0.0,0.02,6.63,0.0,146.53,2,0.1,-4.71
04/03/2020 08:00:00,16/06/2023 15:50:28,Gemini_BTCUSD_1h_17_12_17_to_10_03_23.csv,BTC_USD,HOUR,103288.23,0.234,04/03/2020 10:00:00,04/03/2020 11:00:00,04/03/2020 11:00:00,EXPIRED,LONG,8824.0,8720.0,9145.42,0.0,0.02,3.51,0.0,75.21,2,0.0,-24.34
04/11/2022 22:00:00,16/06/2023 15:50:28,Gemini_BTCUSD_1h_17_12_17_to_10_03_23.csv,BTC_USD,HOUR,103263.89,0.097,04/11/2022 23:00:00,05/11/2022 01:00:00,05/11/2022 01:00:00,EXPIRED,LONG,21184.0,21367.0,22260.93,0.0,0.02,4.84,0.0,104.46,2,0.1,17.75
16/01/2022 08:00:00,16/06/2023 15:50:28,Gemini_BTCUSD_1h_17_12_17_to_10_03_23.csv,BTC_USD,HOUR,103281.64,0.048,16/01/2022 09:00:00,16/01/2022 11:00:00,16/01/2022 11:00:00,EXPIRED,LONG,43115.0,43012.0,45556.04,0.0,0.02,5.36,0.0,117.17,2,0.1,-4.94
08/12/2022 12:00:00,16/06/2023 15:50:28,Gemini_BTCUSD_1h_17_12_17_to_10_03_23.csv,BTC_USD,HOUR,103276.7,0.123,08/12/2022 13:00:00,08/12/2022 15:00:00,08/12/2022 15:00:00,EXPIRED,LONG,16833.0,16925.0,17074.53,0.0,0.02,1.41,0.0,29.71,2,0.0,11.32
28/12/2019 00:00:00,16/06/2023 15:50:28,Gemini_BTCUSD_1h_17_12_17_to_10_03_23.csv,BTC_USD,HOUR,103288.02,0.283,28/12/2019 01:00:00,28/12/2019 03:00:00,28/12/2019 03:00:00,EXPIRED,LONG,7300.0,7277.0,7799.84,0.0,0.02,6.41,0.0,141.45,2,0.1,-6.51
07/11/2018 16:00:00,16/06/2023 15:50:28,Gemini_BTCUSD_1h_17_12_17_to_10_03_23.csv,BTC_USD,HOUR,103281.51,0.317,07/11/2018 17:00:00,07/11/2018 19:00:00,07/11/2018 19:00:00,EXPIRED,LONG,6506.0,6508.0,6641.12,0.0,0.02,2.03,0.0,42.83,2,0.0,0.63
28/02/2020 00:00:00,16/06/2023 15:50:28,Gemini_BTCUSD_1h_17_12_17_to_10_03_23.csv,BTC_USD,HOUR,103282.14,0.233,28/02/2020 04:00:00,28/02/2020 03:00:00,28/02/2020 03:00:00,EXPIRED,LONG,8858.0,8846.0,9171.74,0.0,0.02,3.42,0.0,73.1,2,0.0,-2.8
17/06/2022 07:00:00,16/06/2023 15:50:28,Gemini_BTCUSD_1h_17_12_17_to_10_03_23.csv,BTC_USD,HOUR,103279.34,0.098,17/06/2022 08:00:00,17/06/2022 10:00:00,17/06/2022 10:00:00,EXPIRED,LONG,21054.0,21066.0,22641.07,0.0,0.02,7.01,0.0,155.53,2,0.1,1.18
17/05/2022 04:00:00,16/06/2023 15:50:28,Gemini_BTCUSD_1h_17_12_17_to_10_03_23.csv,BTC_USD,HOUR,103280.52,0.068,17/05/2022 05:00:00,17/05/2022 07:00:00,17/05/2022 07:00:00,EXPIRED,LONG,30341.0,30372.0,32284.61,0.0,0.02,6.02,0.0,132.17,2,0.1,2.11
25/04/2022 12:00:00,16/06/2023 15:50:28,Gemini_BTCUSD_1h_17_12_17_to_10_03_23.csv,BTC_USD,HOUR,103282.63,0.053,25/04/2022 16:00:00,25/04/2022 15:00:00,25/04/2022 15:00:00,EXPIRED,LONG,38816.0,38986.0,39794.26,0.0,0.02,2.46,0.0,51.85,2,0.0,9.01
25/05/2022 22:00:00,16/06/2023 15:50:28,Gemini_BTCUSD_1h_17_12_17_to_10_03_23.csv,BTC_USD,HOUR,103291.64,0.069,25/05/2022 23:00:00,26/05/2022 01:00:00,26/05/2022 01:00:00,EXPIRED,LONG,29744.0,29650.0,30993.67,0.0,0.02,4.03,0.0,86.23,2,0.0,-6.49
30/03/2020 03:00:00,16/06/2023 15:50:28,Gemini_BTCUSD_1h_17_12_17_to_10_03_23.csv,BTC_USD,HOUR,103285.15,0.344,30/03/2020 07:00:00,30/03/2020 06:00:00,30/03/2020 06:00:00,EXPIRED,LONG,6012.0,6236.0,6385.9,0.0,0.02,5.86,0.0,128.62,2,0.1,77.06
13/08/2022 03:00:00,16/06/2023 15:50:28,Gemini_BTCUSD_1h_17_12_17_to_10_03_23.csv,BTC_USD,HOUR,103362.21,0.083,13/08/2022 04:00:00,13/08/2022 06:00:00,13/08/2022 06:00:00,EXPIRED,LONG,24815.0,24673.0,26463.81,0.0,0.02,6.23,0.0,136.85,2,0.1,-11.79
14/11/2019 16:00:00,16/06/2023 15:50:28,Gemini_BTCUSD_1h_17_12_17_to_10_03_23.csv,BTC_USD,HOUR,103350.42,0.24,14/11/2019 17:00:00,14/11/2019 19:00:00,14/11/2019 19:00:00,EXPIRED,LONG,8630.0,8629.0,9235.33,0.0,0.02,6.55,0.0,145.28,2,0.1,-0.24
15/05/2020 15:00:00,16/06/2023 15:50:28,Gemini_BTCUSD_1h_17_12_17_to_10_03_23.csv,BTC_USD,HOUR,103350.18,0.218,15/05/2020 19:00:00,15/05/2020 18:00:00,15/05/2020 18:00:00,EXPIRED,LONG,9474.0,9495.0,9707.98,0.0,0.02,2.41,0.0,51.01,2,0.0,4.58
17/09/2021 06:00:00,16/06/2023 15:50:28,Gemini_BTCUSD_1h_17_12_17_to_10_03_23.csv,BTC_USD,HOUR,103354.76,0.043,17/09/2021 07:00:00,17/09/2021 09:00:00,17/09/2021 09:00:00,EXPIRED,LONG,48082.0,47752.0,51849.78,0.0,0.02,7.27,0.0,162.01,2,0.1,-14.19
10/11/2022 13:00:00,16/06/2023 15:50:28,Gemini_BTCUSD_1h_17_12_17_to_10_03_23.csv,BTC_USD,HOUR,103340.57,0.118,10/11/2022 17:00:00,10/11/2022 16:00:00,10/11/2022 16:00:00,EXPIRED,LONG,17568.0,17792.0,17980.69,0.0,0.02,2.3,0.0,48.7,2,0.0,26.43
05/05/2019 03:00:00,16/06/2023 15:50:28,Gemini_BTCUSD_1h_17_12_17_to_10_03_23.csv,BTC_USD,HOUR,103367.0,0.359,05/05/2019 04:00:00,05/05/2019 06:00:00,05/05/2019 06:00:00,EXPIRED,LONG,5762.0,5741.0,5890.04,0.0,0.02,2.17,0.0,45.97,2,0.0,-7.54
02/06/2019 23:00:00,16/06/2023 15:50:28,Gemini_BTCUSD_1h_17_12_17_to_10_03_23.csv,BTC_USD,HOUR,103359.46,0.236,03/06/2019 00:00:00,03/06/2019 02:00:00,03/06/2019 02:00:00,EXPIRED,LONG,8746.0,8676.0,9558.14,0.0,0.02,8.5,0.0,191.67,2,0.1,-16.52
13/07/2020 02:00:00,16/06/2023 15:50:28,Gemini_BTCUSD_1h_17_12_17_to_10_03_23.csv,BTC_USD,HOUR,103342.94,0.223,13/07/2020 03:00:00,13/07/2020 05:00:00,13/07/2020 05:00:00,EXPIRED,LONG,9281.0,9286.0,9504.24,0.0,0.02,2.35,0.0,49.78,2,0.0,1.12
29/10/2022 05:00:00,16/06/2023 15:50:28,Gemini_BTCUSD_1h_17_12_17_to_10_03_23.csv,BTC_USD,HOUR,103344.06,0.1,29/10/2022 06:00:00,29/10/2022 08:00:00,29/10/2022 08:00:00,EXPIRED,LONG,20663.0,20917.0,22369.02,0.0,0.02,7.63,0.0,170.6,2,0.1,25.4
01/04/2018 23:00:00,16/06/2023 15:50:28,Gemini_BTCUSD_1h_17_12_17_to_10_03_23.csv,BTC_USD,HOUR,103369.46,0.304,02/04/2018 00:00:00,02/04/2018 02:00:00,02/04/2018 02:00:00,EXPIRED,LONG,6811.0,6975.0,7080.04,0.0,0.02,3.8,0.0,81.79,2,0.0,49.86
19/01/2023 23:00:00,16/06/2023 15:50:28,Gemini_BTCUSD_1h_17_12_17_to_10_03_23.csv,BTC_USD,HOUR,103419.32,0.098,20/01/2023 03:00:00,20/01/2023 02:00:00,20/01/2023 02:00:00,EXPIRED,LONG,21087.0,21095.0,21647.31,0.0,0.02,2.59,0.0,54.91,2,0.0,0.78
30/11/2019 02:00:00,16/06/2023 15:50:28,Gemini_BTCUSD_1h_17_12_17_to_10_03_23.csv,BTC_USD,HOUR,103420.1,0.267,30/11/2019 03:00:00,30/11/2019 05:00:00,30/11/2019 05:00:00,EXPIRED,LONG,7748.0,7772.0,8419.69,0.0,0.02,7.98,0.0,179.34,2,0.1,6.41
02/03/2023 20:00:00,16/06/2023 15:50:28,Gemini_BTCUSD_1h_17_12_17_to_10_03_23.csv,BTC_USD,HOUR,103426.51,0.088,02/03/2023 22:00:00,02/03/2023 23:00:00,02/03/2023 23:00:00,EXPIRED,LONG,23469.0,23468.0,24032.8,0.0,0.02,2.35,0.0,49.61,2,0.0,-0.09
13/11/2020 19:00:00,16/06/2023 15:50:28,Gemini_BTCUSD_1h_17_12_17_to_10_03_23.csv,BTC_USD,HOUR,103426.42,0.127,13/11/2020 20:00:00,13/11/2020 22:00:00,13/11/2020 22:00:00,EXPIRED,LONG,16318.0,16340.0,17506.08,0.0,0.02,6.79,0.0,150.89,2,0.1,2.79
14/10/2020 07:00:00,16/06/2023 15:50:28,Gemini_BTCUSD_1h_17_12_17_to_10_03_23.csv,BTC_USD,HOUR,103429.21,0.181,14/10/2020 09:00:00,14/10/2020 10:00:00,14/10/2020 10:00:00,EXPIRED,LONG,11424.0,11388.0,12156.37,0.0,0.02,6.02,0.0,132.56,2,0.1,-6.52
22/01/2021 05:00:00,16/06/2023 15:50:28,Gemini_BTCUSD_1h_17_12_17_to_10_03_23.csv,BTC_USD,HOUR,103422.69,0.065,22/01/2021 06:00:00,22/01/2021 08:00:00,22/01/2021 08:00:00,EXPIRED,LONG,31831.0,31492.0,33177.97,0.0,0.02,4.06,0.0,87.55,2,0.0,-22.03
20/07/2022 04:00:00,16/06/2023 15:50:28,Gemini_BTCUSD_1h_17_12_17_to_10_03_23.csv,BTC_USD,HOUR,103400.66,0.088,20/07/2022 06:00:00,20/07/2022 07:00:00,20/07/2022 07:00:00,EXPIRED,LONG,23390.0,23388.0,25094.36,0.0,0.02,6.79,0.0,149.98,2,0.1,-0.18
08/10/2021 14:00:00,16/06/2023 15:50:28,Gemini_BTCUSD_1h_17_12_17_to_10_03_23.csv,BTC_USD,HOUR,103400.48,0.038,08/10/2021 17:00:00,08/10/2021 17:00:00,08/10/2021 17:00:00,EXPIRED,LONG,54607.0,54324.0,55901.81,0.0,0.02,2.32,0.0,49.2,2,0.0,-10.75
27/02/2021 14:00:00,16/06/2023 15:50:28,Gemini_BTCUSD_1h_17_12_17_to_10_03_23.csv,BTC_USD,HOUR,103389.73,0.044,27/02/2021 15:00:00,27/02/2021 17:00:00,27/02/2021 17:00:00,EXPIRED,LONG,47094.0,47116.0,51199.69,0.0,0.02,8.02,0.0,180.65,2,0.1,0.97
05/04/2019 17:00:00,16/06/2023 15:50:28,Gemini_BTCUSD_1h_17_12_17_to_10_03_23.csv,BTC_USD,HOUR,103390.7,0.411,05/04/2019 18:00:00,05/04/2019 20:00:00,05/04/2019 20:00:00,EXPIRED,LONG,5029.0,5000.0,5275.96,0.0,0.02,4.68,0.0,101.5,2,0.0,-11.92
14/02/2023 23:00:00,16/06/2023 15:50:28,Gemini_BTCUSD_1h_17_12_17_to_10_03_23.csv,BTC_USD,HOUR,103378.78,0.093,15/02/2023 03:00:00,15/02/2023 02:00:00,15/02/2023 02:00:00,EXPIRED,LONG,22214.0,22082.0,22879.3,0.0,0.02,2.91,0.0,61.87,2,0.0,-12.28
02/05/2020 12:00:00,16/06/2023 15:50:28,Gemini_BTCUSD_1h_17_12_17_to_10_03_23.csv,BTC_USD,HOUR,103366.5,0.233,02/05/2020 15:00:00,02/05/2020 15:00:00,02/05/2020 15:00:00,EXPIRED,LONG,8881.0,8945.0,9527.75,0.0,0.02,6.79,0.0,150.69,2,0.1,14.91
25/03/2022 11:00:00,16/06/2023 15:50:28,Gemini_BTCUSD_1h_17_12_17_to_10_03_23.csv,BTC_USD,HOUR,103381.41,0.046,25/03/2022 12:00:00,25/03/2022 14:00:00,25/03/2022 14:00:00,EXPIRED,LONG,44635.0,44883.0,48277.56,0.0,0.02,7.55,0.0,167.56,2,0.1,11.41
24/02/2022 23:00:00,16/06/2023 15:50:28,Gemini_BTCUSD_1h_17_12_17_to_10_03_23.csv,BTC_USD,HOUR,103392.82,0.054,25/02/2022 00:00:00,25/02/2022 02:00:00,25/02/2022 02:00:00,EXPIRED,LONG,38347.0,38825.0,41327.04,0.0,0.02,7.21,0.0,160.92,2,0.1,25.81
27/12/2018 16:00:00,16/06/2023 15:50:28,Gemini_BTCUSD_1h_17_12_17_to_10_03_23.csv,BTC_USD,HOUR,103418.63,0.553,27/12/2018 18:00:00,27/12/2018 19:00:00,27/12/2018 19:00:00,EXPIRED,LONG,3743.0,3607.0,3828.48,0.0,0.02,2.23,0.0,47.27,2,0.0,-75.21
27/02/2018 02:00:00,16/06/2023 15:50:28,Gemini_BTCUSD_1h_17_12_17_to_10_03_23.csv,BTC_USD,HOUR,103343.42,0.203,27/02/2018 06:00:00,27/02/2018 05:00:00,27/02/2018 05:00:00,EXPIRED,LONG,10165.0,10320.0,10589.17,0.0,0.02,4.01,0.0,86.11,2,0.0,31.47
22/07/2020 05:00:00,16/06/2023 15:50:28,Gemini_BTCUSD_1h_17_12_17_to_10_03_23.csv,BTC_USD,HOUR,103374.89,0.221,22/07/2020 06:00:00,22/07/2020 08:00:00,22/07/2020 08:00:00,EXPIRED,LONG,9355.0,9319.0,9717.84,0.0,0.02,3.73,0.0,80.19,2,0.0,-7.96
28/05/2022 12:00:00,16/06/2023 15:50:28,Gemini_BTCUSD_1h_17_12_17_to_10_03_23.csv,BTC_USD,HOUR,103366.93,0.071,28/05/2022 16:00:00,28/05/2022 15:00:00,28/05/2022 15:00:00,EXPIRED,LONG,28944.0,28971.0,30098.87,0.0,0.02,3.84,0.0,82.0,2,0.0,1.92
22/12/2020 15:00:00,16/06/2023 15:50:28,Gemini_BTCUSD_1h_17_12_17_to_10_03_23.csv,BTC_USD,HOUR,103368.85,0.088,22/12/2020 16:00:00,22/12/2020 18:00:00,22/12/2020 18:00:00,EXPIRED,LONG,23370.0,23438.0,23943.46,0.0,0.02,2.4,0.0,50.46,2,0.0,5.98
05/02/2020 12:00:00,16/06/2023 15:50:28,Gemini_BTCUSD_1h_17_12_17_to_10_03_23.csv,BTC_USD,HOUR,103374.83,0.219,05/02/2020 13:00:00,05/02/2020 15:00:00,05/02/2020 15:00:00,EXPIRED,LONG,9440.0,9477.0,9656.97,0.0,0.02,2.25,0.0,47.52,2,0.0,8.1
31/08/2018 05:00:00,16/06/2023 15:50:28,Gemini_BTCUSD_1h_17_12_17_to_10_03_23.csv,BTC_USD,HOUR,103382.93,0.296,31/08/2018 06:00:00,31/08/2018 08:00:00,31/08/2018 08:00:00,EXPIRED,LONG,6986.0,6948.0,7512.32,0.0,0.02,7.01,0.0,155.79,2,0.1,-11.25
08/09/2020 16:00:00,16/06/2023 15:50:28,Gemini_BTCUSD_1h_17_12_17_to_10_03_23.csv,BTC_USD,HOUR,103371.68,0.204,08/09/2020 20:00:00,08/09/2020 19:00:00,08/09/2020 19:00:00,EXPIRED,LONG,10150.0,9990.0,10401.59,0.0,0.02,2.42,0.0,51.32,2,0.0,-32.64
15/07/2022 21:00:00,16/06/2023 15:50:28,Gemini_BTCUSD_1h_17_12_17_to_10_03_23.csv,BTC_USD,HOUR,103339.04,0.099,15/07/2022 22:00:00,16/07/2022 00:00:00,16/07/2022 00:00:00,EXPIRED,LONG,20971.0,20689.0,21952.35,0.0,0.02,4.47,0.0,97.15,2,0.0,-27.92
17/07/2020 19:00:00,16/06/2023 15:50:28,Gemini_BTCUSD_1h_17_12_17_to_10_03_23.csv,BTC_USD,HOUR,103311.12,0.225,17/07/2020 20:00:00,17/07/2020 22:00:00,17/07/2020 22:00:00,EXPIRED,LONG,9167.0,9165.0,9399.01,0.0,0.02,2.47,0.0,52.2,2,0.0,-0.45
28/02/2021 21:00:00,16/06/2023 15:50:28,Gemini_BTCUSD_1h_17_12_17_to_10_03_23.csv,BTC_USD,HOUR,103310.67,0.046,28/02/2021 22:00:00,01/03/2021 00:00:00,01/03/2021 00:00:00,EXPIRED,LONG,45253.0,46331.0,47752.28,0.0,0.02,5.23,0.0,114.97,2,0.1,49.59
28/06/2019 14:00:00,16/06/2023 15:50:28,Gemini_BTCUSD_1h_17_12_17_to_10_03_23.csv,BTC_USD,HOUR,103360.26,0.177,28/06/2019 16:00:00,28/06/2019 17:00:00,28/06/2019 17:00:00,EXPIRED,LONG,11705.0,11826.0,12284.47,0.0,0.02,4.72,0.0,102.57,2,0.0,21.42
10/09/2022 20:00:00,16/06/2023 15:50:28,Gemini_BTCUSD_1h_17_12_17_to_10_03_23.csv,BTC_USD,HOUR,103381.68,0.096,10/09/2022 21:00:00,10/09/2022 23:00:00,10/09/2022 23:00:00,EXPIRED,LONG,21429.0,21649.0,23196.99,0.0,0.02,7.62,0.0,169.73,2,0.1,21.12
13/11/2019 12:00:00,16/06/2023 15:50:28,Gemini_BTCUSD_1h_17_12_17_to_10_03_23.csv,BTC_USD,HOUR,103402.8,0.237,13/11/2019 13:00:00,13/11/2019 15:00:00,13/11/2019 15:00:00,EXPIRED,LONG,8738.0,8733.0,9214.47,0.0,0.02,5.17,0.0,112.92,2,0.1,-1.18
25/12/2017 00:00:00,16/06/2023 15:50:28,Gemini_BTCUSD_1h_17_12_17_to_10_03_23.csv,BTC_USD,HOUR,103401.62,0.148,25/12/2017 01:00:00,25/12/2017 03:00:00,25/12/2017 03:00:00,EXPIRED,LONG,14000.0,13550.0,14852.89,0.0,0.02,5.74,0.0,126.23,2,0.1,-66.6
22/02/2019 14:00:00,16/06/2023 15:50:28,Gemini_BTCUSD_1h_17_12_17_to_10_03_23.csv,BTC_USD,HOUR,103335.02,0.524,22/02/2019 15:00:00,22/02/2019 17:00:00,22/02/2019 17:00:00,EXPIRED,LONG,3943.0,3941.0,4212.06,0.0,0.02,6.39,0.0,140.99,2,0.1,-1.05
26/10/2020 05:00:00,16/06/2023 15:50:28,Gemini_BTCUSD_1h_17_12_17_to_10_03_23.csv,BTC_USD,HOUR,103333.97,0.158,26/10/2020 06:00:00,26/10/2020 08:00:00,26/10/2020 08:00:00,EXPIRED,LONG,13105.0,13065.0,13928.36,0.0,0.02,5.91,0.0,130.09,2,0.1,-6.32
26/10/2020 20:00:00,16/06/2023 15:50:28,Gemini_BTCUSD_1h_17_12_17_to_10_03_23.csv,BTC_USD,HOUR,103327.65,0.159,26/10/2020 22:00:00,26/10/2020 23:00:00,26/10/2020 23:00:00,EXPIRED,LONG,13023.0,13072.0,13685.43,0.0,0.02,4.84,0.0,105.33,2,0.1,7.79
01/08/2019 19:00:00,16/06/2023 15:50:29,Gemini_BTCUSD_1h_17_12_17_to_10_03_23.csv,BTC_USD,HOUR,103335.44,0.201,01/08/2019 20:00:00,01/08/2019 22:00:00,01/08/2019 22:00:00,EXPIRED,LONG,10294.0,10402.0,11176.23,0.0,0.02,7.89,0.0,177.33,2,0.1,21.71
27/10/2021 19:00:00,16/06/2023 15:50:29,Gemini_BTCUSD_1h_17_12_17_to_10_03_23.csv,BTC_USD,HOUR,103357.15,0.035,27/10/2021 20:00:00,27/10/2021 22:00:00,27/10/2021 22:00:00,EXPIRED,LONG,59117.0,58797.0,60514.79,0.0,0.02,2.31,0.0,48.92,2,0.0,-11.2
02/01/2019 12:00:00,16/06/2023 15:50:29,Gemini_BTCUSD_1h_17_12_17_to_10_03_23.csv,BTC_USD,HOUR,103345.95,0.543,02/01/2019 13:00:00,02/01/2019 15:00:00,02/01/2019 15:00:00,EXPIRED,LONG,3808.0,3818.0,3987.72,0.0,0.02,4.51,0.0,97.59,2,0.0,5.43
09/02/2022 11:00:00,16/06/2023 15:50:29,Gemini_BTCUSD_1h_17_12_17_to_10_03_23.csv,BTC_USD,HOUR,103351.38,0.047,09/02/2022 15:00:00,09/02/2022 14:00:00,09/02/2022 14:00:00,EXPIRED,LONG,43762.0,44166.0,46428.45,0.0,0.02,5.74,0.0,125.32,2,0.1,18.99
01/12/2021 14:00:00,16/06/2023 15:50:29,Gemini_BTCUSD_1h_17_12_17_to_10_03_23.csv,BTC_USD,HOUR,103370.37,0.035,01/12/2021 15:00:00,01/12/2021 17:00:00,01/12/2021 17:00:00,EXPIRED,LONG,58628.0,58035.0,59712.15,0.0,0.02,1.82,0.0,37.95,2,0.0,-20.76
06/05/2020 12:00:00,16/06/2023 15:50:29,Gemini_BTCUSD_1h_17_12_17_to_10_03_23.csv,BTC_USD,HOUR,103349.61,0.224,06/05/2020 13:00:00,06/05/2020 15:00:00,06/05/2020 15:00:00,EXPIRED,LONG,9241.0,9284.0,9970.51,0.0,0.02,7.32,0.0,163.41,2,0.1,9.63
12/10/2021 08:00:00,16/06/2023 15:50:29,Gemini_BTCUSD_1h_17_12_17_to_10_03_23.csv,BTC_USD,HOUR,103359.24,0.036,12/10/2021 09:00:00,12/10/2021 11:00:00,12/10/2021 11:00:00,EXPIRED,LONG,57502.0,57276.0,62330.13,0.0,0.02,7.75,0.0,173.81,2,0.1,-8.14
24/03/2022 05:00:00,16/06/2023 15:50:29,Gemini_BTCUSD_1h_17_12_17_to_10_03_23.csv,BTC_USD,HOUR,103351.1,0.048,24/03/2022 07:00:00,24/03/2022 08:00:00,24/03/2022 08:00:00,EXPIRED,LONG,43051.0,43084.0,44111.71,0.0,0.02,2.4,0.0,50.91,2,0.0,1.58
29/09/2020 23:00:00,16/06/2023 15:50:29,Gemini_BTCUSD_1h_17_12_17_to_10_03_23.csv,BTC_USD,HOUR,103352.68,0.191,30/09/2020 01:00:00,30/09/2020 02:00:00,30/09/2020 02:00:00,EXPIRED,LONG,10846.0,10778.0,11254.7,0.0,0.02,3.63,0.0,78.06,2,0.0,-12.99
04/05/2019 11:00:00,16/06/2023 15:50:29,Gemini_BTCUSD_1h_17_12_17_to_10_03_23.csv,BTC_USD,HOUR,103339.69,0.361,04/05/2019 12:00:00,04/05/2019 14:00:00,04/05/2019 14:00:00,EXPIRED,LONG,5728.0,5578.0,5872.11,0.0,0.02,2.45,0.0,52.02,2,0.0,-54.15
19/05/2022 05:00:00,16/06/2023 15:50:29,Gemini_BTCUSD_1h_17_12_17_to_10_03_23.csv,BTC_USD,HOUR,103285.54,0.071,19/05/2022 06:00:00,19/05/2022 08:00:00,19/05/2022 08:00:00,EXPIRED,LONG,29030.0,28938.0,30672.35,0.0,0.02,5.35,0.0,116.61,2,0.1,-6.53
12/12/2018 08:00:00,16/06/2023 15:50:29,Gemini_BTCUSD_1h_17_12_17_to_10_03_23.csv,BTC_USD,HOUR,103279.01,0.612,12/12/2018 09:00:00,12/12/2018 11:00:00,12/12/2018 11:00:00,EXPIRED,LONG,3375.0,3419.0,3656.34,0.0,0.02,7.69,0.0,172.18,2,0.1,26.93
02/01/2018 18:00:00,16/06/2023 15:50:29,Gemini_BTCUSD_1h_17_12_17_to_10_03_23.csv,BTC_USD,HOUR,103305.94,0.143,02/01/2018 19:00:00,02/01/2018 21:00:00,02/01/2018 19:00:00,TAKE_PROFIT_HIT,LONG,14417.0,15084.72,15084.72,0.0,0.02,4.43,0.0,95.48,2,0.0,95.48
19/04/2022 11:00:00,16/06/2023 15:50:29,Gemini_BTCUSD_1h_17_12_17_to_10_03_23.csv,BTC_USD,HOUR,103401.42,0.051,19/04/2022 12:00:00,19/04/2022 14:00:00,19/04/2022 14:00:00,EXPIRED,LONG,40710.0,41592.0,43256.64,0.0,0.02,5.89,0.0,129.88,2,0.1,44.98
26/07/2019 21:00:00,16/06/2023 15:50:29,Gemini_BTCUSD_1h_17_12_17_to_10_03_23.csv,BTC_USD,HOUR,103446.4,0.21,26/07/2019 23:00:00,27/07/2019 00:00:00,27/07/2019 00:00:00,EXPIRED,LONG,9840.0,10155.0,10663.57,0.0,0.02,7.72,0.0,172.95,2,0.1,66.15
10/04/2022 16:00:00,16/06/2023 15:50:29,Gemini_BTCUSD_1h_17_12_17_to_10_03_23.csv,BTC_USD,HOUR,103512.55,0.048,10/04/2022 17:00:00,10/04/2022 19:00:00,10/04/2022 19:00:00,EXPIRED,LONG,42796.0,43274.0,44837.69,0.0,0.02,4.55,0.0,98.0,2,0.0,22.94
23/11/2019 15:00:00,16/06/2023 15:50:29,Gemini_BTCUSD_1h_17_12_17_to_10_03_23.csv,BTC_USD,HOUR,103535.49,0.283,23/11/2019 16:00:00,23/11/2019 18:00:00,23/11/2019 18:00:00,EXPIRED,LONG,7305.0,7317.0,7471.39,0.0,0.02,2.23,0.0,47.09,2,0.0,3.4
27/02/2018 08:00:00,16/06/2023 15:50:29,Gemini_BTCUSD_1h_17_12_17_to_10_03_23.csv,BTC_USD,HOUR,103538.89,0.194,27/02/2018 09:00:00,27/02/2018 11:00:00,27/02/2018 11:00:00,EXPIRED,LONG,10686.0,10688.0,11327.68,0.0,0.02,5.66,0.0,124.49,2,0.1,0.39
09/03/2019 17:00:00,16/06/2023 15:50:29,Gemini_BTCUSD_1h_17_12_17_to_10_03_23.csv,BTC_USD,HOUR,103539.28,0.532,09/03/2019 18:00:00,09/03/2019 20:00:00,09/03/2019 20:00:00,EXPIRED,LONG,3896.0,3893.0,4153.51,0.0,0.02,6.2,0.0,137.0,2,0.1,-1.6
28/05/2020 12:00:00,16/06/2023 15:50:29,Gemini_BTCUSD_1h_17_12_17_to_10_03_23.csv,BTC_USD,HOUR,103537.68,0.22,28/05/2020 13:00:00,28/05/2020 15:00:00,28/05/2020 15:00:00,EXPIRED,LONG,9431.0,9498.0,9939.45,0.0,0.02,5.12,0.0,111.86,2,0.1,14.74
08/05/2020 17:00:00,16/06/2023 15:50:29,Gemini_BTCUSD_1h_17_12_17_to_10_03_23.csv,BTC_USD,HOUR,103552.42,0.207,08/05/2020 18:00:00,08/05/2020 20:00:00,08/05/2020 20:00:00,EXPIRED,LONG,9992.0,10001.0,10811.2,0.0,0.02,7.58,0.0,169.57,2,0.1,1.86
14/11/2020 00:00:00,16/06/2023 15:50:29,Gemini_BTCUSD_1h_17_12_17_to_10_03_23.csv,BTC_USD,HOUR,103554.28,0.127,14/11/2020 01:00:00,14/11/2020 03:00:00,14/11/2020 03:00:00,EXPIRED,LONG,16314.0,16201.0,16674.19,0.0,0.02,2.16,0.0,45.74,2,0.0,-14.35
29/10/2018 02:00:00,16/06/2023 15:50:29,Gemini_BTCUSD_1h_17_12_17_to_10_03_23.csv,BTC_USD,HOUR,103539.93,0.323,29/10/2018 03:00:00,29/10/2018 05:00:00,29/10/2018 05:00:00,EXPIRED,LONG,6410.0,6402.0,6837.15,0.0,0.02,6.25,0.0,137.97,2,0.1,-2.58
29/12/2019 15:00:00,16/06/2023 15:50:29,Gemini_BTCUSD_1h_17_12_17_to_10_03_23.csv,BTC_USD,HOUR,103537.35,0.281,29/12/2019 16:00:00,29/12/2019 18:00:00,29/12/2019 18:00:00,EXPIRED,LONG,7378.0,7416.0,7932.66,0.0,0.02,6.99,0.0,155.86,2,0.1,10.68
30/10/2020 15:00:00,16/06/2023 15:50:29,Gemini_BTCUSD_1h_17_12_17_to_10_03_23.csv,BTC_USD,HOUR,103548.03,0.153,30/10/2020 18:00:00,30/10/2020 18:00:00,30/10/2020 18:00:00,EXPIRED,LONG,13569.0,13555.0,14276.96,0.0,0.02,4.96,0.0,108.32,2,0.1,-2.14
01/08/2021 07:00:00,16/06/2023 15:50:29,Gemini_BTCUSD_1h_17_12_17_to_10_03_23.csv,BTC_USD,HOUR,103545.89,0.05,01/08/2021 11:00:00,01/08/2021 10:00:00,01/08/2021 10:00:00,EXPIRED,LONG,41688.0,41537.0,42631.76,0.0,0.02,2.21,0.0,47.19,2,0.0,-7.55
23/08/2020 20:00:00,16/06/2023 15:50:29,Gemini_BTCUSD_1h_17_12_17_to_10_03_23.csv,BTC_USD,HOUR,103538.34,0.177,23/08/2020 21:00:00,23/08/2020 23:00:00,23/08/2020 23:00:00,EXPIRED,LONG,11681.0,11657.0,11946.05,0.0,0.02,2.22,0.0,46.91,2,0.0,-4.25
17/04/2021 22:00:00,16/06/2023 15:50:29,Gemini_BTCUSD_1h_17_12_17_to_10_03_23.csv,BTC_USD,HOUR,103534.09,0.034,17/04/2021 23:00:00,18/04/2021 01:00:00,18/04/2021 01:00:00,EXPIRED,LONG,60743.0,59308.0,62960.5,0.0,0.02,3.52,0.0,75.4,2,0.0,-48.79
09/12/2019 09:00:00,16/06/2023 15:50:29,Gemini_BTCUSD_1h_17_12_17_to_10_03_23.csv,BTC_USD,HOUR,103485.3,0.277,09/12/2019 10:00:00,09/12/2019 12:00:00,09/12/2019 12:00:00,EXPIRED,LONG,7460.0,7495.0,7772.38,0.0,0.02,4.02,0.0,86.53,2,0.0,9.7
24/01/2019 09:00:00,16/06/2023 15:50:29,Gemini_BTCUSD_1h_17_12_17_to_10_03_23.csv,BTC_USD,HOUR,103495.0,0.584,24/01/2019 13:00:00,24/01/2019 12:00:00,24/01/2019 12:00:00,EXPIRED,LONG,3544.0,3568.0,3661.03,0.0,0.02,3.2,0.0,68.35,2,0.0,14.02
18/03/2018 21:00:00,16/06/2023 15:50:29,Gemini_BTCUSD_1h_17_12_17_to_10_03_23.csv,BTC_USD,HOUR,103509.02,0.252,18/03/2018 22:00:00,19/03/2018 00:00:00,19/03/2018 00:00:00,EXPIRED,LONG,8226.0,8290.0,8928.9,0.0,0.02,7.87,0.0,177.13,2,0.1,16.13
12/04/2018 09:00:00,16/06/2023 15:50:29,Gemini_BTCUSD_1h_17_12_17_to_10_03_23.csv,BTC_USD,HOUR,103525.15,0.302,12/04/2018 12:00:00,12/04/2018 12:00:00,12/04/2018 11:00:00,TAKE_PROFIT_HIT,LONG,6857.0,7176.82,7176.82,0.0,0.02,4.46,0.0,96.59,2,0.0,96.59
05/09/2018 07:00:00,16/06/2023 15:50:29,Gemini_BTCUSD_1h_17_12_17_to_10_03_23.csv,BTC_USD,HOUR,103621.74,0.282,05/09/2018 09:00:00,05/09/2018 10:00:00,05/09/2018 10:00:00,EXPIRED,LONG,7350.0,6980.0,7838.72,0.0,0.02,6.23,0.0,137.82,2,0.1,-104.34
04/11/2021 05:00:00,16/06/2023 15:50:29,Gemini_BTCUSD_1h_17_12_17_to_10_03_23.csv,BTC_USD,HOUR,103517.4,0.033,04/11/2021 09:00:00,04/11/2021 08:00:00,04/11/2021 08:00:00,EXPIRED,LONG,62402.0,61661.0,64816.5,0.0,0.02,3.73,0.0,79.68,2,0.0,-24.45
20/03/2018 15:00:00,16/06/2023 15:50:29,Gemini_BTCUSD_1h_17_12_17_to_10_03_23.csv,BTC_USD,HOUR,103492.95,0.243,20/03/2018 19:00:00,20/03/2018 18:00:00,20/03/2018 18:00:00,EXPIRED,LONG,8526.0,8818.0,9144.74,0.0,0.02,6.77,0.0,150.35,2,0.1,70.96
16/03/2022 21:00:00,16/06/2023 15:50:29,Gemini_BTCUSD_1h_17_12_17_to_10_03_23.csv,BTC_USD,HOUR,103563.91,0.05,16/03/2022 23:00:00,17/03/2022 00:00:00,17/03/2022 00:00:00,EXPIRED,LONG,41125.0,41027.0,42819.45,0.0,0.02,3.96,0.0,84.72,2,0.0,-4.9
12/03/2018 08:00:00,16/06/2023 15:50:29,Gemini_BTCUSD_1h_17_12_17_to_10_03_23.csv,BTC_USD,HOUR,103559.01,0.217,12/03/2018 09:00:00,12/03/2018 11:00:00,12/03/2018 11:00:00,EXPIRED,LONG,9530.0,9839.0,10458.66,0.0,0.02,8.88,0.0,201.52,2,0.1,67.05
26/02/2023 01:00:00,16/06/2023 15:50:29,Gemini_BTCUSD_1h_17_12_17_to_10_03_23.csv,BTC_USD,HOUR,103626.06,0.09,26/02/2023 02:00:00,26/02/2023 04:00:00,26/02/2023 04:00:00,EXPIRED,LONG,23120.0,23188.0,24560.97,0.0,0.02,5.87,0.0,129.69,2,0.1,6.12
01/08/2020 22:00:00,16/06/2023 15:50:29,Gemini_BTCUSD_1h_17_12_17_to_10_03_23.csv,BTC_USD,HOUR,103632.18,0.176,01/08/2020 23:00:00,02/08/2020 01:00:00,02/08/2020 01:00:00,EXPIRED,LONG,11794.0,11950.0,12649.92,0.0,0.02,6.77,0.0,150.64,2,0.1,27.46
20/11/2018 16:00:00,16/06/2023 15:50:29,Gemini_BTCUSD_1h_17_12_17_to_10_03_23.csv,BTC_USD,HOUR,103659.64,0.444,20/11/2018 17:00:00,20/11/2018 19:00:00,20/11/2018 19:00:00,EXPIRED,LONG,4667.0,4491.0,4930.75,0.0,0.02,5.35,0.0,117.11,2,0.1,-78.14
17/06/2021 04:00:00,16/06/2023 15:50:29,Gemini_BTCUSD_1h_17_12_17_to_10_03_23.csv,BTC_USD,HOUR,103581.5,0.053,17/06/2021 05:00:00,17/06/2021 07:00:00,17/06/2021 07:00:00,EXPIRED,LONG,38823.0,39238.0,41165.18,0.0,0.02,5.69,0.0,124.14,2,0.1,22.0
21/11/2021 16:00:00,16/06/2023 15:50:29,Gemini_BTCUSD_1h_17_12_17_to_10_03_23.csv,BTC_USD,HOUR,103603.5,0.035,21/11/2021 17:00:00,21/11/2021 19:00:00,21/11/2021 19:00:00,EXPIRED,LONG,59919.0,59363.0,65293.3,0.0,0.02,8.23,0.0,188.1,2,0.1,-19.46
25/08/2019 08:00:00,16/06/2023 15:50:29,Gemini_BTCUSD_1h_17_12_17_to_10_03_23.csv,BTC_USD,HOUR,103584.04,0.205,25/08/2019 12:00:00,25/08/2019 11:00:00,25/08/2019 11:00:00,EXPIRED,LONG,10095.0,10119.0,11042.78,0.0,0.02,8.58,0.0,194.29,2,0.1,4.92
10/11/2022 06:00:00,16/06/2023 15:50:29,Gemini_BTCUSD_1h_17_12_17_to_10_03_23.csv,BTC_USD,HOUR,103588.96,0.124,10/11/2022 07:00:00,10/11/2022 09:00:00,10/11/2022 09:00:00,EXPIRED,LONG,16657.0,16634.0,17788.04,0.0,0.02,6.36,0.0,140.25,2,0.1,-2.85
14/04/2018 09:00:00,16/06/2023 15:50:29,Gemini_BTCUSD_1h_17_12_17_to_10_03_23.csv,BTC_USD,HOUR,103586.11,0.258,14/04/2018 11:00:00,14/04/2018 12:00:00,14/04/2018 12:00:00,EXPIRED,LONG,8037.0,7899.0,8245.06,0.0,0.02,2.52,0.0,53.68,2,0.0,-35.6
25/12/2019 23:00:00,16/06/2023 15:50:29,Gemini_BTCUSD_1h_17_12_17_to_10_03_23.csv,BTC_USD,HOUR,103550.51,0.288,26/12/2019 00:00:00,26/12/2019 02:00:00,26/12/2019 02:00:00,EXPIRED,LONG,7193.0,7191.0,7468.17,0.0,0.02,3.68,0.0,79.25,2,0.0,-0.58
30/04/2018 12:00:00,16/06/2023 15:50:29,Gemini_BTCUSD_1h_17_12_17_to_10_03_23.csv,BTC_USD,HOUR,103549.93,0.223,30/04/2018 13:00:00,30/04/2018 15:00:00,30/04/2018 15:00:00,EXPIRED,LONG,9288.0,9280.0,9770.61,0.0,0.02,4.94,0.0,107.62,2,0.1,-1.78
21/05/2022 11:00:00,16/06/2023 15:50:29,Gemini_BTCUSD_1h_17_12_17_to_10_03_23.csv,BTC_USD,HOUR,103548.15,0.071,21/05/2022 12:00:00,21/05/2022 14:00:00,21/05/2022 14:00:00,EXPIRED,LONG,29253.0,29365.0,30093.51,0.0,0.02,2.79,0.0,59.68,2,0.0,7.95
07/09/2019 15:00:00,16/06/2023 15:50:29,Gemini_BTCUSD_1h_17_12_17_to_10_03_23.csv,BTC_USD,HOUR,103556.1,0.198,07/09/2019 18:00:00,07/09/2019 18:00:00,07/09/2019 18:00:00,EXPIRED,LONG,10485.0,10479.0,10753.71,0.0,0.02,2.5,0.0,53.2,2,0.0,-1.19
28/04/2021 12:00:00,16/06/2023 15:50:29,Gemini_BTCUSD_1h_17_12_17_to_10_03_23.csv,BTC_USD,HOUR,103554.91,0.038,28/04/2021 13:00:00,28/04/2021 15:00:00,28/04/2021 15:00:00,EXPIRED,LONG,55224.0,54371.0,59722.55,0.0,0.02,7.53,0.0,170.94,2,0.1,-32.41
04/05/2019 13:00:00,16/06/2023 15:50:29,Gemini_BTCUSD_1h_17_12_17_to_10_03_23.csv,BTC_USD,HOUR,103522.5,0.372,04/05/2019 14:00:00,04/05/2019 16:00:00,04/05/2019 16:00:00,EXPIRED,LONG,5571.0,5580.0,5700.8,0.0,0.02,2.28,0.0,48.29,2,0.0,3.35
03/07/2019 00:00:00,16/06/2023 15:50:29,Gemini_BTCUSD_1h_17_12_17_to_10_03_23.csv,BTC_USD,HOUR,103525.85,0.184,03/07/2019 02:00:00,03/07/2019 03:00:00,03/07/2019 03:00:00,EXPIRED,LONG,11254.0,11320.0,11534.62,0.0,0.02,2.43,0.0,51.63,2,0.0,12.14
19/07/2018 13:00:00,16/06/2023 15:50:29,Gemini_BTCUSD_1h_17_12_17_to_10_03_23.csv,BTC_USD,HOUR,103537.99,0.277,19/07/2018 14:00:00,19/07/2018 16:00:00,19/07/2018 16:00:00,EXPIRED,LONG,7475.0,7359.0,8016.03,0.0,0.02,6.75,0.0,149.87,2,0.1,-32.13
29/05/2022 00:00:00,16/06/2023 15:50:29,Gemini_BTCUSD_1h_17_12_17_to_10_03_23.csv,BTC_USD,HOUR,103505.86,0.071,29/05/2022 02:00:00,29/05/2022 03:00:00,29/05/2022 03:00:00,EXPIRED,LONG,29001.0,28960.0,29685.65,0.0,0.02,2.31,0.0,48.61,2,0.0,-2.91
19/08/2019 09:00:00,16/06/2023 15:50:29,Gemini_BTCUSD_1h_17_12_17_to_10_03_23.csv,BTC_USD,HOUR,103502.95,0.194,19/08/2019 11:00:00,19/08/2019 12:00:00,19/08/2019 12:00:00,EXPIRED,LONG,10674.0,10695.0,10895.69,0.0,0.02,2.03,0.0,43.01,2,0.0,4.07
24/06/2022 13:00:00,16/06/2023 15:50:29,Gemini_BTCUSD_1h_17_12_17_to_10_03_23.csv,BTC_USD,HOUR,103507.02,0.098,24/06/2022 16:00:00,24/06/2022 16:00:00,24/06/2022 16:00:00,EXPIRED,LONG,21176.0,21030.0,22550.82,0.0,0.02,6.1,0.0,134.73,2,0.1,-14.31
28/02/2018 04:00:00,16/06/2023 15:50:29,Gemini_BTCUSD_1h_17_12_17_to_10_03_23.csv,BTC_USD,HOUR,103492.71,0.19,28/02/2018 05:00:00,28/02/2018 07:00:00,28/02/2018 07:00:00,EXPIRED,LONG,10889.0,10740.0,11262.16,0.0,0.02,3.31,0.0,70.9,2,0.0,-28.31
28/11/2021 09:00:00,16/06/2023 15:50:29,Gemini_BTCUSD_1h_17_12_17_to_10_03_23.csv,BTC_USD,HOUR,103464.4,0.038,28/11/2021 11:00:00,28/11/2021 12:00:00,28/11/2021 12:00:00,EXPIRED,LONG,54362.0,54386.0,55577.68,0.0,0.02,2.19,0.0,46.2,2,0.0,0.91
24/11/2021 17:00:00,16/06/2023 15:50:29,Gemini_BTCUSD_1h_17_12_17_to_10_03_23.csv,BTC_USD,HOUR,103465.31,0.037,24/11/2021 21:00:00,24/11/2021 20:00:00,24/11/2021 20:00:00,EXPIRED,LONG,56548.0,57443.0,60028.01,0.0,0.02,5.8,0.0,128.76,2,0.1,33.11
09/02/2018 05:00:00,16/06/2023 15:50:29,Gemini_BTCUSD_1h_17_12_17_to_10_03_23.csv,BTC_USD,HOUR,103498.42,0.263,09/02/2018 06:00:00,09/02/2018 08:00:00,09/02/2018 08:00:00,EXPIRED,LONG,7873.0,8066.0,8165.18,0.0,0.02,3.58,0.0,76.84,2,0.0,50.76
28/02/2019 17:00:00,16/06/2023 15:50:29,Gemini_BTCUSD_1h_17_12_17_to_10_03_23.csv,BTC_USD,HOUR,103549.18,0.545,28/02/2019 19:00:00,28/02/2019 20:00:00,28/02/2019 20:00:00,EXPIRED,LONG,3799.0,3803.0,3943.67,0.0,0.02,3.67,0.0,78.85,2,0.0,2.18
03/02/2021 09:00:00,16/06/2023 15:50:29,Gemini_BTCUSD_1h_17_12_17_to_10_03_23.csv,BTC_USD,HOUR,103551.36,0.058,03/02/2021 11:00:00,03/02/2021 12:00:00,03/02/2021 12:00:00,EXPIRED,LONG,35905.0,36240.0,36769.33,0.0,0.02,2.35,0.0,50.13,2,0.0,19.43
01/09/2020 20:00:00,16/06/2023 15:50:29,Gemini_BTCUSD_1h_17_12_17_to_10_03_23.csv,BTC_USD,HOUR,103570.79,0.172,02/09/2020 00:00:00,01/09/2020 23:00:00,01/09/2020 23:00:00,EXPIRED,LONG,12012.0,11929.0,12395.23,0.0,0.02,3.09,0.0,65.92,2,0.0,-14.28
03/02/2018 00:00:00,16/06/2023 15:50:29,Gemini_BTCUSD_1h_17_12_17_to_10_03_23.csv,BTC_USD,HOUR,103556.51,0.237,03/02/2018 02:00:00,03/02/2018 03:00:00,03/02/2018 03:00:00,EXPIRED,LONG,8751.0,8286.0,9320.89,0.0,0.02,6.11,0.0,135.06,2,0.1,-110.2
09/07/2021 14:00:00,16/06/2023 15:50:29,Gemini_BTCUSD_1h_17_12_17_to_10_03_23.csv,BTC_USD,HOUR,103446.31,0.062,09/07/2021 15:00:00,09/07/2021 17:00:00,09/07/2021 17:00:00,EXPIRED,LONG,33546.0,33494.0,34567.66,0.0,0.02,2.96,0.0,63.34,2,0.0,-3.22
14/08/2020 11:00:00,16/06/2023 15:50:29,Gemini_BTCUSD_1h_17_12_17_to_10_03_23.csv,BTC_USD,HOUR,103443.09,0.176,14/08/2020 12:00:00,14/08/2020 14:00:00,14/08/2020 14:00:00,EXPIRED,LONG,11772.0,11724.0,12736.2,0.0,0.02,7.57,0.0,169.7,2,0.1,-8.45
07/11/2019 04:00:00,16/06/2023 15:50:29,Gemini_BTCUSD_1h_17_12_17_to_10_03_23.csv,BTC_USD,HOUR,103434.64,0.222,07/11/2019 05:00:00,07/11/2019 07:00:00,07/11/2019 07:00:00,EXPIRED,LONG,9300.0,9243.0,9516.33,0.0,0.02,2.27,0.0,48.03,2,0.0,-12.65
21/03/2018 02:00:00,16/06/2023 15:50:29,Gemini_BTCUSD_1h_17_12_17_to_10_03_23.csv,BTC_USD,HOUR,103421.99,0.231,21/03/2018 03:00:00,21/03/2018 05:00:00,21/03/2018 05:00:00,EXPIRED,LONG,8964.0,9056.0,9368.19,0.0,0.02,4.31,0.0,93.37,2,0.0,21.25
07/08/2018 17:00:00,16/06/2023 15:50:29,Gemini_BTCUSD_1h_17_12_17_to_10_03_23.csv,BTC_USD,HOUR,103443.24,0.291,07/08/2018 20:00:00,07/08/2018 20:00:00,07/08/2018 20:00:00,EXPIRED,LONG,7111.0,6878.0,7277.59,0.0,0.02,2.29,0.0,48.48,2,0.0,-67.8
07/04/2020 02:00:00,16/06/2023 15:50:29,Gemini_BTCUSD_1h_17_12_17_to_10_03_23.csv,BTC_USD,HOUR,103375.44,0.283,07/04/2020 03:00:00,07/04/2020 05:00:00,07/04/2020 05:00:00,EXPIRED,LONG,7318.0,7284.0,7755.74,0.0,0.02,5.64,0.0,123.88,2,0.1,-9.62
04/06/2020 14:00:00,16/06/2023 15:50:29,Gemini_BTCUSD_1h_17_12_17_to_10_03_23.csv,BTC_USD,HOUR,103365.82,0.212,04/06/2020 15:00:00,04/06/2020 17:00:00,04/06/2020 17:00:00,EXPIRED,LONG,9753.0,9821.0,10580.11,0.0,0.02,7.82,0.0,175.35,2,0.1,14.42
10/11/2019 19:00:00,16/06/2023 15:50:29,Gemini_BTCUSD_1h_17_12_17_to_10_03_23.csv,BTC_USD,HOUR,103380.24,0.228,10/11/2019 20:00:00,10/11/2019 22:00:00,10/11/2019 22:00:00,EXPIRED,LONG,9049.0,9080.0,9678.58,0.0,0.02,6.5,0.0,143.54,2,0.1,7.07
20/12/2022 14:00:00,16/06/2023 15:50:29,Gemini_BTCUSD_1h_17_12_17_to_10_03_23.csv,BTC_USD,HOUR,103387.31,0.122,20/12/2022 15:00:00,20/12/2022 17:00:00,20/12/2022 17:00:00,EXPIRED,LONG,16905.0,16905.0,17343.88,0.0,0.02,2.53,0.0,53.54,2,0.0,0.0
06/08/2021 02:00:00,16/06/2023 15:50:29,Gemini_BTCUSD_1h_17_12_17_to_10_03_23.csv,BTC_USD,HOUR,103387.31,0.051,06/08/2021 06:00:00,06/08/2021 05:00:00,06/08/2021 05:00:00,EXPIRED,LONG,40348.0,40565.0,41295.81,0.0,0.02,2.3,0.0,48.34,2,0.0,11.07
13/02/2021 22:00:00,16/06/2023 15:50:29,Gemini_BTCUSD_1h_17_12_17_to_10_03_23.csv,BTC_USD,HOUR,103398.38,0.044,14/02/2021 02:00:00,14/02/2021 01:00:00,14/02/2021 01:00:00,EXPIRED,LONG,47151.0,47544.0,51655.15,0.0,0.02,8.72,0.0,198.18,2,0.1,17.29
19/02/2022 09:00:00,16/06/2023 15:50:29,Gemini_BTCUSD_1h_17_12_17_to_10_03_23.csv,BTC_USD,HOUR,103415.67,0.052,19/02/2022 13:00:00,19/02/2022 12:00:00,19/02/2022 12:00:00,EXPIRED,LONG,39935.0,39767.0,40788.36,0.0,0.02,2.09,0.0,44.37,2,0.0,-8.74
29/05/2018 11:00:00,16/06/2023 15:50:29,Gemini_BTCUSD_1h_17_12_17_to_10_03_23.csv,BTC_USD,HOUR,103406.93,0.28,29/05/2018 12:00:00,29/05/2018 14:00:00,29/05/2018 14:00:00,EXPIRED,LONG,7397.0,7421.0,8015.63,0.0,0.02,7.72,0.0,173.22,2,0.1,6.72
03/10/2020 23:00:00,16/06/2023 15:50:29,Gemini_BTCUSD_1h_17_12_17_to_10_03_23.csv,BTC_USD,HOUR,103413.65,0.196,04/10/2020 02:00:00,04/10/2020 02:00:00,04/10/2020 02:00:00,EXPIRED,LONG,10557.0,10563.0,10817.89,0.0,0.02,2.41,0.0,51.13,2,0.0,1.18
10/09/2022 05:00:00,16/06/2023 15:50:29,Gemini_BTCUSD_1h_17_12_17_to_10_03_23.csv,BTC_USD,HOUR,103414.83,0.096,10/09/2022 08:00:00,10/09/2022 08:00:00,10/09/2022 08:00:00,EXPIRED,LONG,21539.0,21341.0,22471.59,0.0,0.02,4.15,0.0,89.53,2,0.0,-19.01
15/07/2019 16:00:00,16/06/2023 15:50:29,Gemini_BTCUSD_1h_17_12_17_to_10_03_23.csv,BTC_USD,HOUR,103395.82,0.194,15/07/2019 18:00:00,15/07/2019 19:00:00,15/07/2019 19:00:00,EXPIRED,LONG,10647.0,10860.0,11252.95,0.0,0.02,5.38,0.0,117.55,2,0.1,41.32
24/11/2019 10:00:00,16/06/2023 15:50:29,Gemini_BTCUSD_1h_17_12_17_to_10_03_23.csv,BTC_USD,HOUR,103437.14,0.29,24/11/2019 14:00:00,24/11/2019 13:00:00,24/11/2019 13:00:00,EXPIRED,LONG,7126.0,7152.0,7417.25,0.0,0.02,3.93,0.0,84.46,2,0.0,7.54
15/04/2019 05:00:00,16/06/2023 15:50:29,Gemini_BTCUSD_1h_17_12_17_to_10_03_23.csv,BTC_USD,HOUR,103444.68,0.4,15/04/2019 06:00:00,15/04/2019 08:00:00,15/04/2019 08:00:00,EXPIRED,LONG,5170.0,5152.0,5324.42,0.0,0.02,2.9,0.0,61.77,2,0.0,-7.2
08/11/2021 12:00:00,16/06/2023 15:50:29,Gemini_BTCUSD_1h_17_12_17_to_10_03_23.csv,BTC_USD,HOUR,103437.48,0.031,08/11/2021 15:00:00,08/11/2021 15:00:00,08/11/2021 15:00:00,EXPIRED,LONG,65845.0,66419.0,67650.87,0.0,0.02,2.67,0.0,55.98,2,0.0,17.79
30/08/2019 10:00:00,16/06/2023 15:50:29,Gemini_BTCUSD_1h_17_12_17_to_10_03_23.csv,BTC_USD,HOUR,103455.27,0.216,30/08/2019 11:00:00,30/08/2019 13:00:00,30/08/2019 13:00:00,EXPIRED,LONG,9574.0,9608.0,10303.11,0.0,0.02,7.08,0.0,157.49,2,0.1,7.34
08/07/2018 12:00:00,16/06/2023 15:50:29,Gemini_BTCUSD_1h_17_12_17_to_10_03_23.csv,BTC_USD,HOUR,103462.61,0.308,08/07/2018 13:00:00,08/07/2018 15:00:00,08/07/2018 15:00:00,EXPIRED,LONG,6729.0,6738.0,7229.36,0.0,0.02,6.92,0.0,154.11,2,0.1,2.77
19/07/2022 20:00:00,16/06/2023 15:50:29,Gemini_BTCUSD_1h_17_12_17_to_10_03_23.csv,BTC_USD,HOUR,103465.38,0.089,20/07/2022 00:00:00,19/07/2022 23:00:00,19/07/2022 23:00:00,EXPIRED,LONG,23308.0,23399.0,24189.38,0.0,0.02,3.64,0.0,78.44,2,0.0,8.1
26/08/2018 01:00:00,16/06/2023 15:50:29,Gemini_BTCUSD_1h_17_12_17_to_10_03_23.csv,BTC_USD,HOUR,103473.48,0.307,26/08/2018 03:00:00,26/08/2018 04:00:00,26/08/2018 04:00:00,EXPIRED,LONG,6741.0,6622.0,7348.77,0.0,0.02,8.27,0.0,186.59,2,0.1,-36.53
15/05/2019 05:00:00,16/06/2023 15:50:29,Gemini_BTCUSD_1h_17_12_17_to_10_03_23.csv,BTC_USD,HOUR,103436.95,0.258,15/05/2019 06:00:00,15/05/2019 08:00:00,15/05/2019 08:00:00,EXPIRED,LONG,8026.0,7890.0,8208.7,0.0,0.02,2.23,0.0,47.14,2,0.0,-35.09
28/08/2020 23:00:00,16/06/2023 15:50:29,Gemini_BTCUSD_1h_17_12_17_to_10_03_23.csv,BTC_USD,HOUR,103401.86,0.179,29/08/2020 00:00:00,29/08/2020 02:00:00,29/08/2020 02:00:00,EXPIRED,LONG,11549.0,11487.0,11819.25,0.0,0.02,2.29,0.0,48.37,2,0.0,-11.1
27/11/2022 19:00:00,16/06/2023 15:50:29,Gemini_BTCUSD_1h_17_12_17_to_10_03_23.csv,BTC_USD,HOUR,103390.76,0.125,27/11/2022 22:00:00,27/11/2022 22:00:00,27/11/2022 22:00:00,EXPIRED,LONG,16552.0,16574.0,17155.74,0.0,0.02,3.52,0.0,75.47,2,0.0,2.75
25/02/2022 13:00:00,16/06/2023 15:50:29,Gemini_BTCUSD_1h_17_12_17_to_10_03_23.csv,BTC_USD,HOUR,103393.51,0.052,25/02/2022 14:00:00,25/02/2022 16:00:00,25/02/2022 16:00:00,EXPIRED,LONG,39394.0,39401.0,42880.94,0.0,0.02,8.13,0.0,181.32,2,0.1,0.36
08/05/2018 20:00:00,16/06/2023 15:50:29,Gemini_BTCUSD_1h_17_12_17_to_10_03_23.csv,BTC_USD,HOUR,103393.87,0.226,08/05/2018 22:00:00,08/05/2018 23:00:00,08/05/2018 23:00:00,EXPIRED,LONG,9155.0,9181.0,9367.96,0.0,0.02,2.27,0.0,48.13,2,0.0,5.88
03/03/2021 01:00:00,16/06/2023 15:50:29,Gemini_BTCUSD_1h_17_12_17_to_10_03_23.csv,BTC_USD,HOUR,103399.75,0.042,03/03/2021 03:00:00,03/03/2021 04:00:00,03/03/2021 04:00:00,EXPIRED,LONG,48879.0,49170.0,52058.72,0.0,0.02,6.11,0.0,133.55,2,0.1,12.22
01/12/2021 17:00:00,16/06/2023 15:50:29,Gemini_BTCUSD_1h_17_12_17_to_10_03_23.csv,BTC_USD,HOUR,103411.97,0.036,01/12/2021 18:00:00,01/12/2021 20:00:00,01/12/2021 20:00:00,EXPIRED,LONG,58035.0,56772.0,62295.47,0.0,0.02,6.84,0.0,153.38,2,0.1,-45.47
28/01/2021 09:00:00,16/06/2023 15:50:29,Gemini_BTCUSD_1h_17_12_17_to_10_03_23.csv,BTC_USD,HOUR,103366.5,0.066,28/01/2021 12:00:00,28/01/2021 12:00:00,28/01/2021 12:00:00,EXPIRED,LONG,31500.0,31516.0,32224.02,0.0,0.02,2.25,0.0,47.79,2,0.0,1.06
30/01/2020 14:00:00,16/06/2023 15:50:29,Gemini_BTCUSD_1h_17_12_17_to_10_03_23.csv,BTC_USD,HOUR,103367.56,0.221,30/01/2020 15:00:00,30/01/2020 17:00:00,30/01/2020 17:00:00,EXPIRED,LONG,9336.0,9466.0,10095.3,0.0,0.02,7.52,0.0,167.81,2,0.1,28.73
26/10/2022 17:00:00,16/06/2023 15:50:29,Gemini_BTCUSD_1h_17_12_17_to_10_03_23.csv,BTC_USD,HOUR,103396.29,0.099,26/10/2022 19:00:00,26/10/2022 20:00:00,26/10/2022 20:00:00,EXPIRED,LONG,20823.0,20762.0,22407.9,0.0,0.02,7.07,0.0,156.91,2,0.1,-6.04
13/07/2018 13:00:00,16/06/2023 15:50:29,Gemini_BTCUSD_1h_17_12_17_to_10_03_23.csv,BTC_USD,HOUR,103390.25,0.332,13/07/2018 15:00:00,13/07/2018 16:00:00,13/07/2018 16:00:00,EXPIRED,LONG,6237.0,6252.0,6378.25,0.0,0.02,2.21,0.0,46.9,2,0.0,4.98
25/06/2018 06:00:00,16/06/2023 15:50:29,Gemini_BTCUSD_1h_17_12_17_to_10_03_23.csv,BTC_USD,HOUR,103395.23,0.336,25/06/2018 08:00:00,25/06/2018 09:00:00,25/06/2018 09:00:00,EXPIRED,LONG,6163.0,6160.0,6646.3,0.0,0.02,7.27,0.0,162.39,2,0.1,-1.01
26/07/2018 00:00:00,16/06/2023 15:50:29,Gemini_BTCUSD_1h_17_12_17_to_10_03_23.csv,BTC_USD,HOUR,103394.22,0.251,26/07/2018 02:00:00,26/07/2018 03:00:00,26/07/2018 03:00:00,EXPIRED,LONG,8224.0,8221.0,8531.17,0.0,0.02,3.6,0.0,77.1,2,0.0,-0.75
10/01/2022 21:00:00,16/06/2023 15:50:29,Gemini_BTCUSD_1h_17_12_17_to_10_03_23.csv,BTC_USD,HOUR,103393.47,0.05,10/01/2022 23:00:00,11/01/2022 00:00:00,11/01/2022 00:00:00,EXPIRED,LONG,41735.0,41626.0,42827.7,0.0,0.02,2.55,0.0,54.63,2,0.0,-5.45
01/12/2021 16:00:00,16/06/2023 15:50:29,Gemini_BTCUSD_1h_17_12_17_to_10_03_23.csv,BTC_USD,HOUR,103388.02,0.035,01/12/2021 19:00:00,01/12/2021 19:00:00,01/12/2021 19:00:00,EXPIRED,LONG,58482.0,57460.0,60711.25,0.0,0.02,3.67,0.0,78.02,2,0.0,-35.77
04/10/2018 07:00:00,16/06/2023 15:50:29,Gemini_BTCUSD_1h_17_12_17_to_10_03_23.csv,BTC_USD,HOUR,103352.25,0.317,04/10/2018 08:00:00,04/10/2018 10:00:00,04/10/2018 10:00:00,EXPIRED,LONG,6530.0,6526.0,6681.9,0.0,0.02,2.27,0.0,48.15,2,0.0,-1.27
14/09/2021 09:00:00,16/06/2023 15:50:29,Gemini_BTCUSD_1h_17_12_17_to_10_03_23.csv,BTC_USD,HOUR,103350.98,0.045,14/09/2021 10:00:00,14/09/2021 12:00:00,14/09/2021 12:00:00,EXPIRED,LONG,45860.0,46545.0,49568.53,0.0,0.02,7.48,0.0,166.88,2,0.1,30.83
30/06/2020 12:00:00,16/06/2023 15:50:29,Gemini_BTCUSD_1h_17_12_17_to_10_03_23.csv,BTC_USD,HOUR,103381.81,0.227,30/06/2020 13:00:00,30/06/2020 15:00:00,30/06/2020 15:00:00,EXPIRED,LONG,9115.0,9168.0,9752.65,0.0,0.02,6.54,0.0,144.75,2,0.1,12.03
23/10/2022 00:00:00,16/06/2023 15:50:29,Gemini_BTCUSD_1h_17_12_17_to_10_03_23.csv,BTC_USD,HOUR,103393.84,0.108,23/10/2022 01:00:00,23/10/2022 03:00:00,23/10/2022 03:00:00,EXPIRED,LONG,19200.0,19199.0,19736.1,0.0,0.02,2.72,0.0,57.9,2,0.0,-0.11
04/02/2019 10:00:00,16/06/2023 15:50:29,Gemini_BTCUSD_1h_17_12_17_to_10_03_23.csv,BTC_USD,HOUR,103393.73,0.606,04/02/2019 11:00:00,04/02/2019 13:00:00,04/02/2019 13:00:00,EXPIRED,LONG,3411.0,3407.0,3598.17,0.0,0.02,5.2,0.0,113.43,2,0.1,-2.42
13/02/2021 14:00:00,16/06/2023 15:50:29,Gemini_BTCUSD_1h_17_12_17_to_10_03_23.csv,BTC_USD,HOUR,103391.31,0.044,13/02/2021 18:00:00,13/02/2021 17:00:00,13/02/2021 17:00:00,EXPIRED,LONG,47038.0,46928.0,50582.61,0.0,0.02,7.01,0.0,155.96,2,0.1,-4.84
22/03/2018 21:00:00,16/06/2023 15:50:29,Gemini_BTCUSD_1h_17_12_17_to_10_03_23.csv,BTC_USD,HOUR,103386.47,0.24,23/03/2018 01:00:00,23/03/2018 00:00:00,23/03/2018 00:00:00,EXPIRED,LONG,8616.0,8647.0,8849.45,0.0,0.02,2.64,0.0,56.03,2,0.0,7.44
31/01/2018 13:00:00,16/06/2023 15:50:29,Gemini_BTCUSD_1h_17_12_17_to_10_03_23.csv,BTC_USD,HOUR,103393.91,0.206,31/01/2018 14:00:00,31/01/2018 16:00:00,31/01/2018 16:00:00,EXPIRED,LONG,10025.0,9952.0,10661.77,0.0,0.02,5.97,0.0,131.17,2,0.1,-15.04
17/12/2020 16:00:00,16/06/2023 15:50:29,Gemini_BTCUSD_1h_17_12_17_to_10_03_23.csv,BTC_USD,HOUR,103378.87,0.087,17/12/2020 19:00:00,17/12/2020 19:00:00,17/12/2020 19:00:00,EXPIRED,LONG,23642.0,22902.0,24237.78,0.0,0.02,2.46,0.0,51.83,2,0.0,-64.38
31/07/2018 00:00:00,16/06/2023 15:50:29,Gemini_BTCUSD_1h_17_12_17_to_10_03_23.csv,BTC_USD,HOUR,103314.49,0.254,31/07/2018 01:00:00,31/07/2018 03:00:00,31/07/2018 03:00:00,EXPIRED,LONG,8123.0,8110.0,8323.34,0.0,0.02,2.41,0.0,50.89,2,0.0,-3.3
04/02/2018 07:00:00,16/06/2023 15:50:29,Gemini_BTCUSD_1h_17_12_17_to_10_03_23.csv,BTC_USD,HOUR,103311.19,0.225,04/02/2018 08:00:00,04/02/2018 10:00:00,04/02/2018 10:00:00,EXPIRED,LONG,9189.0,8767.0,9469.68,0.0,0.02,2.96,0.0,63.15,2,0.0,-94.95
18/02/2019 17:00:00,16/06/2023 15:50:29,Gemini_BTCUSD_1h_17_12_17_to_10_03_23.csv,BTC_USD,HOUR,103216.24,0.535,18/02/2019 18:00:00,18/02/2019 20:00:00,18/02/2019 20:00:00,EXPIRED,LONG,3860.0,3865.0,4124.72,0.0,0.02,6.42,0.0,141.63,2,0.1,2.68
21/07/2019 12:00:00,16/06/2023 15:50:29,Gemini_BTCUSD_1h_17_12_17_to_10_03_23.csv,BTC_USD,HOUR,103218.92,0.195,21/07/2019 16:00:00,21/07/2019 15:00:00,21/07/2019 15:00:00,EXPIRED,LONG,10565.0,10472.0,11010.71,0.0,0.02,4.05,0.0,86.91,2,0.0,-18.14
22/07/2020 14:00:00,16/06/2023 15:50:29,Gemini_BTCUSD_1h_17_12_17_to_10_03_23.csv,BTC_USD,HOUR,103200.78,0.221,22/07/2020 18:00:00,22/07/2020 17:00:00,22/07/2020 17:00:00,EXPIRED,LONG,9348.0,9369.0,9915.3,0.0,0.02,5.72,0.0,125.37,2,0.1,4.64
22/03/2021 13:00:00,16/06/2023 15:50:29,Gemini_BTCUSD_1h_17_12_17_to_10_03_23.csv,BTC_USD,HOUR,103205.42,0.036,22/03/2021 14:00:00,22/03/2021 16:00:00,22/03/2021 16:00:00,EXPIRED,LONG,56991.0,56787.0,61471.16,0.0,0.02,7.29,0.0,161.29,2,0.1,-7.34
13/07/2022 05:00:00,16/06/2023 15:50:29,Gemini_BTCUSD_1h_17_12_17_to_10_03_23.csv,BTC_USD,HOUR,103198.08,0.106,13/07/2022 09:00:00,13/07/2022 08:00:00,13/07/2022 08:00:00,EXPIRED,LONG,19509.0,19832.0,19946.66,0.0,0.02,2.19,0.0,46.39,2,0.0,34.24
07/07/2018 23:00:00,16/06/2023 15:50:29,Gemini_BTCUSD_1h_17_12_17_to_10_03_23.csv,BTC_USD,HOUR,103232.32,0.306,08/07/2018 03:00:00,08/07/2018 02:00:00,08/07/2018 02:00:00,EXPIRED,LONG,6754.0,6741.0,7073.29,0.0,0.02,4.51,0.0,97.7,2,0.0,-3.98
06/07/2019 17:00:00,16/06/2023 15:50:29,Gemini_BTCUSD_1h_17_12_17_to_10_03_23.csv,BTC_USD,HOUR,103228.34,0.178,06/07/2019 19:00:00,06/07/2019 20:00:00,06/07/2019 20:00:00,EXPIRED,LONG,11589.0,11471.0,11872.19,0.0,0.02,2.39,0.0,50.41,2,0.0,-21.0
22/07/2018 16:00:00,16/06/2023 15:50:29,Gemini_BTCUSD_1h_17_12_17_to_10_03_23.csv,BTC_USD,HOUR,103207.34,0.275,22/07/2018 17:00:00,22/07/2018 19:00:00,22/07/2018 19:00:00,EXPIRED,LONG,7506.0,7517.0,8139.16,0.0,0.02,7.78,0.0,174.12,2,0.1,3.03
31/01/2023 10:00:00,16/06/2023 15:50:29,Gemini_BTCUSD_1h_17_12_17_to_10_03_23.csv,BTC_USD,HOUR,103210.37,0.09,31/01/2023 11:00:00,31/01/2023 13:00:00,31/01/2023 13:00:00,EXPIRED,LONG,22823.0,23121.0,24324.68,0.0,0.02,6.17,0.0,135.15,2,0.1,26.82
15/06/2021 04:00:00,16/06/2023 15:50:29,Gemini_BTCUSD_1h_17_12_17_to_10_03_23.csv,BTC_USD,HOUR,103237.19,0.051,15/06/2021 06:00:00,15/06/2021 07:00:00,15/06/2021 07:00:00,EXPIRED,LONG,40521.0,40388.0,41410.28,0.0,0.02,2.15,0.0,45.35,2,0.0,-6.78
26/04/2021 10:00:00,16/06/2023 15:50:29,Gemini_BTCUSD_1h_17_12_17_to_10_03_23.csv,BTC_USD,HOUR,103230.41,0.039,26/04/2021 11:00:00,26/04/2021 13:00:00,26/04/2021 13:00:00,EXPIRED,LONG,53333.0,53784.0,55694.93,0.0,0.02,4.24,0.0,92.12,2,0.0,17.59
03/09/2021 14:00:00,16/06/2023 15:50:29,Gemini_BTCUSD_1h_17_12_17_to_10_03_23.csv,BTC_USD,HOUR,103248.0,0.041,03/09/2021 16:00:00,03/09/2021 17:00:00,03/09/2021 17:00:00,EXPIRED,LONG,50721.0,50415.0,54492.55,0.0,0.02,6.92,0.0,154.63,2,0.1,-12.55
07/05/2020 03:00:00,16/06/2023 15:50:29,Gemini_BTCUSD_1h_17_12_17_to_10_03_23.csv,BTC_USD,HOUR,103235.45,0.222,07/05/2020 04:00:00,07/05/2020 06:00:00,07/05/2020 06:00:00,EXPIRED,LONG,9303.0,9255.0,9936.01,0.0,0.02,6.37,0.0,140.53,2,0.1,-10.66
13/06/2019 09:00:00,16/06/2023 15:50:29,Gemini_BTCUSD_1h_17_12_17_to_10_03_23.csv,BTC_USD,HOUR,103224.79,0.255,13/06/2019 13:00:00,13/06/2019 12:00:00,13/06/2019 12:00:00,EXPIRED,LONG,8111.0,8114.0,8289.74,0.0,0.02,2.16,0.0,45.58,2,0.0,0.77
12/11/2018 10:00:00,16/06/2023 15:50:29,Gemini_BTCUSD_1h_17_12_17_to_10_03_23.csv,BTC_USD,HOUR,103225.56,0.325,12/11/2018 11:00:00,12/11/2018 13:00:00,12/11/2018 13:00:00,EXPIRED,LONG,6355.0,6365.0,6514.45,0.0,0.02,2.45,0.0,51.82,2,0.0,3.25
29/11/2019 15:00:00,16/06/2023 15:50:29,Gemini_BTCUSD_1h_17_12_17_to_10_03_23.csv,BTC_USD,HOUR,103228.81,0.264,29/11/2019 16:00:00,29/11/2019 18:00:00,29/11/2019 18:00:00,EXPIRED,LONG,7817.0,7750.0,8346.75,0.0,0.02,6.35,0.0,139.85,2,0.1,-17.69
19/03/2021 11:00:00,16/06/2023 15:50:29,Gemini_BTCUSD_1h_17_12_17_to_10_03_23.csv,BTC_USD,HOUR,103211.12,0.035,19/03/2021 12:00:00,19/03/2021 14:00:00,19/03/2021 14:00:00,EXPIRED,LONG,58850.0,58719.0,62126.37,0.0,0.02,5.27,0.0,114.67,2,0.1,-4.59
29/01/2018 22:00:00,16/06/2023 15:50:29,Gemini_BTCUSD_1h_17_12_17_to_10_03_23.csv,BTC_USD,HOUR,103206.53,0.187,30/01/2018 01:00:00,30/01/2018 01:00:00,30/01/2018 01:00:00,EXPIRED,LONG,11042.0,10870.0,11806.68,0.0,0.02,6.48,0.0,143.0,2,0.1,-32.16
11/03/2022 08:00:00,16/06/2023 15:50:29,Gemini_BTCUSD_1h_17_12_17_to_10_03_23.csv,BTC_USD,HOUR,103174.37,0.053,11/03/2022 09:00:00,11/03/2022 11:00:00,11/03/2022 11:00:00,EXPIRED,LONG,39067.0,39938.0,41341.0,0.0,0.02,5.5,0.0,120.52,2,0.1,46.16
15/04/2022 05:00:00,16/06/2023 15:50:29,Gemini_BTCUSD_1h_17_12_17_to_10_03_23.csv,BTC_USD,HOUR,103220.53,0.051,15/04/2022 06:00:00,15/04/2022 08:00:00,15/04/2022 08:00:00,EXPIRED,LONG,40150.0,40155.0,43157.2,0.0,0.02,6.97,0.0,153.37,2,0.1,0.26
22/02/2020 02:00:00,16/06/2023 15:50:29,Gemini_BTCUSD_1h_17_12_17_to_10_03_23.csv,BTC_USD,HOUR,103220.79,0.213,22/02/2020 03:00:00,22/02/2020 05:00:00,22/02/2020 05:00:00,EXPIRED,LONG,9671.0,9627.0,9890.7,0.0,0.02,2.22,0.0,46.8,2,0.0,-9.37
26/03/2021 18:00:00,16/06/2023 15:50:29,Gemini_BTCUSD_1h_17_12_17_to_10_03_23.csv,BTC_USD,HOUR,103211.42,0.038,26/03/2021 20:00:00,26/03/2021 21:00:00,26/03/2021 21:00:00,EXPIRED,LONG,53731.0,54642.0,56948.56,0.0,0.02,5.65,0.0,122.27,2,0.1,34.62
13/11/2020 00:00:00,16/06/2023 15:50:29,Gemini_BTCUSD_1h_17_12_17_to_10_03_23.csv,BTC_USD,HOUR,103246.04,0.126,13/11/2020 01:00:00,13/11/2020 03:00:00,13/11/2020 03:00:00,EXPIRED,LONG,16417.0,16455.0,17654.33,0.0,0.02,7.01,0.0,155.9,2,0.1,4.79
31/01/2018 12:00:00,16/06/2023 15:50:29,Gemini_BTCUSD_1h_17_12_17_to_10_03_23.csv,BTC_USD,HOUR,103250.83,0.201,31/01/2018 13:00:00,31/01/2018 15:00:00,31/01/2018 15:00:00,EXPIRED,LONG,10275.0,9930.0,10513.63,0.0,0.02,2.27,0.0,47.96,2,0.0,-69.34
14/08/2019 14:00:00,16/06/2023 15:50:29,Gemini_BTCUSD_1h_17_12_17_to_10_03_23.csv,BTC_USD,HOUR,103181.49,0.197,14/08/2019 15:00:00,14/08/2019 17:00:00,14/08/2019 17:00:00,EXPIRED,LONG,10475.0,10215.0,11373.33,0.0,0.02,7.9,0.0,176.97,2,0.1,-51.22
23/12/2018 01:00:00,16/06/2023 15:50:29,Gemini_BTCUSD_1h_17_12_17_to_10_03_23.csv,BTC_USD,HOUR,103130.27,0.517,23/12/2018 04:00:00,23/12/2018 04:00:00,23/12/2018 04:00:00,EXPIRED,LONG,3993.0,3993.0,4154.49,0.0,0.02,3.89,0.0,83.49,2,0.0,0.0
17/12/2021 19:00:00,16/06/2023 15:50:29,Gemini_BTCUSD_1h_17_12_17_to_10_03_23.csv,BTC_USD,HOUR,103130.27,0.044,17/12/2021 20:00:00,17/12/2021 22:00:00,17/12/2021 22:00:00,EXPIRED,LONG,46776.0,46569.0,48729.83,0.0,0.02,4.01,0.0,85.97,2,0.0,-9.11
27/11/2022 07:00:00,16/06/2023 15:50:29,Gemini_BTCUSD_1h_17_12_17_to_10_03_23.csv,BTC_USD,HOUR,103121.16,0.125,27/11/2022 08:00:00,27/11/2022 10:00:00,27/11/2022 10:00:00,EXPIRED,LONG,16563.0,16543.0,17216.6,0.0,0.02,3.8,0.0,81.7,2,0.0,-2.5
18/10/2020 01:00:00,16/06/2023 15:50:29,Gemini_BTCUSD_1h_17_12_17_to_10_03_23.csv,BTC_USD,HOUR,103118.66,0.181,18/10/2020 02:00:00,18/10/2020 04:00:00,18/10/2020 04:00:00,EXPIRED,LONG,11401.0,11379.0,12349.23,0.0,0.02,7.68,0.0,171.63,2,0.1,-3.98
08/09/2021 19:00:00,16/06/2023 15:50:29,Gemini_BTCUSD_1h_17_12_17_to_10_03_23.csv,BTC_USD,HOUR,103114.68,0.044,08/09/2021 20:00:00,08/09/2021 22:00:00,08/09/2021 22:00:00,EXPIRED,LONG,46453.0,46609.0,50682.22,0.0,0.02,8.34,0.0,186.09,2,0.1,6.86
17/02/2023 23:00:00,16/06/2023 15:50:29,Gemini_BTCUSD_1h_17_12_17_to_10_03_23.csv,BTC_USD,HOUR,103121.54,0.084,18/02/2023 02:00:00,18/02/2023 02:00:00,18/02/2023 02:00:00,EXPIRED,LONG,24584.0,24569.0,25123.95,0.0,0.02,2.15,0.0,45.36,2,0.0,-1.26
30/08/2022 22:00:00,16/06/2023 15:50:29,Gemini_BTCUSD_1h_17_12_17_to_10_03_23.csv,BTC_USD,HOUR,103120.28,0.104,30/08/2022 23:00:00,31/08/2022 01:00:00,31/08/2022 01:00:00,EXPIRED,LONG,19888.0,20236.0,21161.19,0.0,0.02,6.02,0.0,132.41,2,0.1,36.19
30/06/2019 04:00:00,16/06/2023 15:50:29,Gemini_BTCUSD_1h_17_12_17_to_10_03_23.csv,BTC_USD,HOUR,103156.47,0.171,30/06/2019 07:00:00,30/06/2019 07:00:00,30/06/2019 07:00:00,EXPIRED,LONG,12034.0,11694.0,12563.32,0.0,0.02,4.21,0.0,90.51,2,0.0,-58.14
01/06/2020 02:00:00,16/06/2023 15:50:29,Gemini_BTCUSD_1h_17_12_17_to_10_03_23.csv,BTC_USD,HOUR,103098.33,0.216,01/06/2020 03:00:00,01/06/2020 05:00:00,01/06/2020 05:00:00,EXPIRED,LONG,9530.0,9532.0,10370.36,0.0,0.02,8.1,0.0,181.52,2,0.1,0.43
05/11/2019 00:00:00,16/06/2023 15:50:29,Gemini_BTCUSD_1h_17_12_17_to_10_03_23.csv,BTC_USD,HOUR,103098.76,0.219,05/11/2019 01:00:00,05/11/2019 03:00:00,05/11/2019 03:00:00,EXPIRED,LONG,9394.0,9424.0,9809.48,0.0,0.02,4.24,0.0,90.99,2,0.0,6.57
27/10/2021 16:00:00,16/06/2023 15:50:29,Gemini_BTCUSD_1h_17_12_17_to_10_03_23.csv,BTC_USD,HOUR,103105.33,0.035,27/10/2021 17:00:00,27/10/2021 19:00:00,27/10/2021 19:00:00,EXPIRED,LONG,58916.0,59117.0,60385.83,0.0,0.02,2.43,0.0,51.44,2,0.0,7.04
14/09/2021 18:00:00,16/06/2023 15:50:29,Gemini_BTCUSD_1h_17_12_17_to_10_03_23.csv,BTC_USD,HOUR,103112.37,0.044,14/09/2021 21:00:00,14/09/2021 21:00:00,14/09/2021 21:00:00,EXPIRED,LONG,46511.0,46674.0,47895.6,0.0,0.02,2.89,0.0,60.92,2,0.0,7.17
17/04/2021 06:00:00,16/06/2023 15:50:29,Gemini_BTCUSD_1h_17_12_17_to_10_03_23.csv,BTC_USD,HOUR,103119.54,0.033,17/04/2021 10:00:00,17/04/2021 09:00:00,17/04/2021 09:00:00,EXPIRED,LONG,62094.0,61761.0,65995.86,0.0,0.02,5.91,0.0,128.76,2,0.1,-10.99
12/12/2019 20:00:00,16/06/2023 15:50:29,Gemini_BTCUSD_1h_17_12_17_to_10_03_23.csv,BTC_USD,HOUR,103108.55,0.285,12/12/2019 22:00:00,12/12/2019 23:00:00,12/12/2019 23:00:00,EXPIRED,LONG,7245.0,7193.0,7356.19,0.0,0.02,1.51,0.0,31.69,2,0.0,-14.82
25/09/2019 18:00:00,16/06/2023 15:50:29,Gemini_BTCUSD_1h_17_12_17_to_10_03_23.csv,BTC_USD,HOUR,103093.73,0.247,25/09/2019 22:00:00,25/09/2019 21:00:00,25/09/2019 21:00:00,EXPIRED,LONG,8345.0,8589.0,8860.31,0.0,0.02,5.82,0.0,127.28,2,0.1,60.27
21/02/2020 14:00:00,16/06/2023 15:50:29,Gemini_BTCUSD_1h_17_12_17_to_10_03_23.csv,BTC_USD,HOUR,103154.0,0.213,21/02/2020 16:00:00,21/02/2020 17:00:00,21/02/2020 17:00:00,EXPIRED,LONG,9690.0,9729.0,10435.71,0.0,0.02,7.15,0.0,158.84,2,0.1,8.31
21/08/2022 09:00:00,16/06/2023 15:50:29,Gemini_BTCUSD_1h_17_12_17_to_10_03_23.csv,BTC_USD,HOUR,103162.31,0.096,21/08/2022 12:00:00,21/08/2022 12:00:00,21/08/2022 12:00:00,EXPIRED,LONG,21435.0,21483.0,22591.04,0.0,0.02,5.12,0.0,110.98,2,0.1,4.61
15/06/2022 12:00:00,16/06/2023 15:50:29,Gemini_BTCUSD_1h_17_12_17_to_10_03_23.csv,BTC_USD,HOUR,103166.92,0.098,15/06/2022 16:00:00,15/06/2022 15:00:00,15/06/2022 15:00:00,EXPIRED,LONG,21162.0,21382.0,22354.77,0.0,0.02,5.34,0.0,116.89,2,0.1,21.56
12/09/2021 11:00:00,16/06/2023 15:50:29,Gemini_BTCUSD_1h_17_12_17_to_10_03_23.csv,BTC_USD,HOUR,103188.48,0.045,12/09/2021 12:00:00,12/09/2021 14:00:00,12/09/2021 14:00:00,EXPIRED,LONG,46090.0,45891.0,48823.17,0.0,0.02,5.6,0.0,122.99,2,0.1,-8.95
05/04/2019 20:00:00,16/06/2023 15:50:29,Gemini_BTCUSD_1h_17_12_17_to_10_03_23.csv,BTC_USD,HOUR,103179.53,0.413,05/04/2019 21:00:00,05/04/2019 23:00:00,05/04/2019 23:00:00,EXPIRED,LONG,5000.0,5041.0,5224.27,0.0,0.02,4.29,0.0,92.62,2,0.0,16.93
04/01/2020 17:00:00,16/06/2023 15:50:29,Gemini_BTCUSD_1h_17_12_17_to_10_03_23.csv,BTC_USD,HOUR,103196.46,0.281,04/01/2020 21:00:00,04/01/2020 20:00:00,04/01/2020 20:00:00,EXPIRED,LONG,7338.0,7330.0,7546.09,0.0,0.02,2.76,0.0,58.47,2,0.0,-2.25
31/12/2019 06:00:00,16/06/2023 15:50:29,Gemini_BTCUSD_1h_17_12_17_to_10_03_23.csv,BTC_USD,HOUR,103194.21,0.286,31/12/2019 08:00:00,31/12/2019 09:00:00,31/12/2019 09:00:00,EXPIRED,LONG,7222.0,7207.0,7408.0,0.0,0.02,2.51,0.0,53.2,2,0.0,-4.29
15/08/2022 19:00:00,16/06/2023 15:50:29,Gemini_BTCUSD_1h_17_12_17_to_10_03_23.csv,BTC_USD,HOUR,103189.92,0.086,15/08/2022 23:00:00,15/08/2022 22:00:00,15/08/2022 22:00:00,EXPIRED,LONG,23985.0,24027.0,24664.04,0.0,0.02,2.75,0.0,58.4,2,0.0,3.61
25/12/2022 17:00:00,16/06/2023 15:50:29,Gemini_BTCUSD_1h_17_12_17_to_10_03_23.csv,BTC_USD,HOUR,103193.53,0.123,25/12/2022 20:00:00,25/12/2022 20:00:00,25/12/2022 20:00:00,EXPIRED,LONG,16798.0,16772.0,17277.32,0.0,0.02,2.77,0.0,58.96,2,0.0,-3.2
21/02/2022 06:00:00,16/06/2023 15:50:29,Gemini_BTCUSD_1h_17_12_17_to_10_03_23.csv,BTC_USD,HOUR,103190.33,0.053,21/02/2022 10:00:00,21/02/2022 09:00:00,21/02/2022 09:00:00,EXPIRED,LONG,39239.0,38937.0,40859.09,0.0,0.02,3.97,0.0,85.86,2,0.0,-16.01
14/07/2018 22:00:00,16/06/2023 15:50:29,Gemini_BTCUSD_1h_17_12_17_to_10_03_23.csv,BTC_USD,HOUR,103174.32,0.33,14/07/2018 23:00:00,15/07/2018 01:00:00,15/07/2018 01:00:00,EXPIRED,LONG,6255.0,6250.0,6690.15,0.0,0.02,6.5,0.0,143.6,2,0.1,-1.65
10/03/2021 22:00:00,16/06/2023 15:50:29,Gemini_BTCUSD_1h_17_12_17_to_10_03_23.csv,BTC_USD,HOUR,103172.67,0.036,10/03/2021 23:00:00,11/03/2021 01:00:00,10/03/2021 23:00:00,TAKE_PROFIT_HIT,LONG,56958.0,57011.86,57011.86,0.0,0.02,0.09,0.0,1.94,2,0.0,1.94
13/05/2019 03:00:00,16/06/2023 15:50:29,Gemini_BTCUSD_1h_17_12_17_to_10_03_23.csv,BTC_USD,HOUR,103174.61,0.294,13/05/2019 04:00:00,13/05/2019 06:00:00,13/05/2019 06:00:00,EXPIRED,LONG,7009.0,7075.0,7185.34,0.0,0.02,2.45,0.0,51.84,2,0.0,19.4
10/11/2022 05:00:00,16/06/2023 15:50:29,Gemini_BTCUSD_1h_17_12_17_to_10_03_23.csv,BTC_USD,HOUR,103194.01,0.124,10/11/2022 06:00:00,10/11/2022 08:00:00,10/11/2022 08:00:00,EXPIRED,LONG,16689.0,16776.0,17490.27,0.0,0.02,4.58,0.0,99.36,2,0.0,10.79
31/03/2021 22:00:00,16/06/2023 15:50:29,Gemini_BTCUSD_1h_17_12_17_to_10_03_23.csv,BTC_USD,HOUR,103204.8,0.035,31/03/2021 23:00:00,01/04/2021 01:00:00,01/04/2021 01:00:00,EXPIRED,LONG,58655.0,59217.0,60096.61,0.0,0.02,2.4,0.0,50.46,2,0.0,19.67
20/10/2018 10:00:00,16/06/2023 15:50:29,Gemini_BTCUSD_1h_17_12_17_to_10_03_23.csv,BTC_USD,HOUR,103224.47,0.322,20/10/2018 11:00:00,20/10/2018 13:00:00,20/10/2018 13:00:00,EXPIRED,LONG,6402.0,6415.0,6667.61,0.0,0.02,3.98,0.0,85.53,2,0.0,4.19
30/01/2021 13:00:00,16/06/2023 15:50:29,Gemini_BTCUSD_1h_17_12_17_to_10_03_23.csv,BTC_USD,HOUR,103228.66,0.06,30/01/2021 16:00:00,30/01/2021 16:00:00,30/01/2021 16:00:00,EXPIRED,LONG,34290.0,33981.0,35265.8,0.0,0.02,2.77,0.0,58.55,2,0.0,-18.54
04/04/2020 01:00:00,16/06/2023 15:50:29,Gemini_BTCUSD_1h_17_12_17_to_10_03_23.csv,BTC_USD,HOUR,103210.12,0.305,04/04/2020 02:00:00,04/04/2020 04:00:00,04/04/2020 04:00:00,EXPIRED,LONG,6763.0,6723.0,7275.28,0.0,0.02,7.04,0.0,156.25,2,0.1,-12.2
28/04/2022 00:00:00,16/06/2023 15:50:29,Gemini_BTCUSD_1h_17_12_17_to_10_03_23.csv,BTC_USD,HOUR,103197.92,0.052,28/04/2022 01:00:00,28/04/2022 03:00:00,28/04/2022 03:00:00,EXPIRED,LONG,39400.0,39352.0,41543.52,0.0,0.02,5.16,0.0,111.46,2,0.1,-2.5
13/06/2021 20:00:00,16/06/2023 15:50:29,Gemini_BTCUSD_1h_17_12_17_to_10_03_23.csv,BTC_USD,HOUR,103195.42,0.053,13/06/2021 21:00:00,13/06/2021 23:00:00,13/06/2021 23:00:00,EXPIRED,LONG,39248.0,39043.0,40756.48,0.0,0.02,3.7,0.0,79.95,2,0.0,-10.86
06/10/2021 07:00:00,16/06/2023 15:50:29,Gemini_BTCUSD_1h_17_12_17_to_10_03_23.csv,BTC_USD,HOUR,103184.56,0.04,06/10/2021 08:00:00,06/10/2021 10:00:00,06/10/2021 10:00:00,EXPIRED,LONG,51469.0,51206.0,53543.2,0.0,0.02,3.87,0.0,82.97,2,0.0,-10.52
11/09/2021 16:00:00,16/06/2023 15:50:29,Gemini_BTCUSD_1h_17_12_17_to_10_03_23.csv,BTC_USD,HOUR,103174.04,0.045,11/09/2021 17:00:00,11/09/2021 19:00:00,11/09/2021 19:00:00,EXPIRED,LONG,45884.0,45390.0,47592.23,0.0,0.02,3.59,0.0,76.87,2,0.0,-22.23
05/07/2020 18:00:00,16/06/2023 15:50:29,Gemini_BTCUSD_1h_17_12_17_to_10_03_23.csv,BTC_USD,HOUR,103151.81,0.228,05/07/2020 19:00:00,05/07/2020 21:00:00,05/07/2020 21:00:00,EXPIRED,LONG,9041.0,9041.0,9263.24,0.0,0.02,2.4,0.0,50.67,2,0.0,0.0
31/10/2019 13:00:00,16/06/2023 15:50:29,Gemini_BTCUSD_1h_17_12_17_to_10_03_23.csv,BTC_USD,HOUR,103151.81,0.221,31/10/2019 15:00:00,31/10/2019 16:00:00,31/10/2019 16:00:00,EXPIRED,LONG,9315.0,9263.0,9542.43,0.0,0.02,2.38,0.0,50.26,2,0.0,-11.49
04/11/2020 11:00:00,16/06/2023 15:50:29,Gemini_BTCUSD_1h_17_12_17_to_10_03_23.csv,BTC_USD,HOUR,103140.32,0.15,04/11/2020 15:00:00,04/11/2020 14:00:00,04/11/2020 14:00:00,EXPIRED,LONG,13745.0,13864.0,14294.88,0.0,0.02,3.85,0.0,82.48,2,0.0,17.85
03/08/2018 17:00:00,16/06/2023 15:50:29,Gemini_BTCUSD_1h_17_12_17_to_10_03_23.csv,BTC_USD,HOUR,103158.17,0.274,03/08/2018 18:00:00,03/08/2018 20:00:00,03/08/2018 20:00:00,EXPIRED,LONG,7533.0,7384.0,7709.27,0.0,0.02,2.29,0.0,48.3,2,0.0,-40.83
16/08/2019 15:00:00,16/06/2023 15:50:29,Gemini_BTCUSD_1h_17_12_17_to_10_03_23.csv,BTC_USD,HOUR,103117.34,0.199,16/08/2019 16:00:00,16/08/2019 18:00:00,16/08/2019 18:00:00,EXPIRED,LONG,10383.0,10432.0,10800.36,0.0,0.02,3.86,0.0,83.05,2,0.0,9.75
25/05/2020 21:00:00,16/06/2023 15:50:29,Gemini_BTCUSD_1h_17_12_17_to_10_03_23.csv,BTC_USD,HOUR,103127.09,0.232,25/05/2020 22:00:00,26/05/2020 00:00:00,26/05/2020 00:00:00,EXPIRED,LONG,8898.0,8863.0,9534.03,0.0,0.02,6.67,0.0,147.56,2,0.1,-8.12
22/03/2018 02:00:00,16/06/2023 15:50:29,Gemini_BTCUSD_1h_17_12_17_to_10_03_23.csv,BTC_USD,HOUR,103118.97,0.228,22/03/2018 04:00:00,22/03/2018 05:00:00,22/03/2018 05:00:00,EXPIRED,LONG,9061.0,9010.0,9656.97,0.0,0.02,6.17,0.0,135.88,2,0.1,-11.63
